....................................................................................................
. ..   .   .        ..      . ...        .    . .     .   .  .  ..  ..    . .     ....   .        ..
.    ..   . .   .    .   .    . .      .  .     ..     ..  . ..       ..     .. ..... . .  .  . .  .
.   . . .. .   ..  .     ..           ..  ...  ..  .        ..      .        ...    .  .   . .    ..
...    ..   ..    . ....    . .  .           .   . .   .  ..... .  .  . .. .    ..             .   .
.   . ..      .         . .     .          .    . .  ..      .  .      .. .  . . ...              ..
..  . ... . .    .   ...   .    .       .           .  .  . ...    .  ..    . .   .      .     .   .
.              .  .       .    .. ..        ..      ..      . ..   .. .     .  .  ... ..  .      . .
.  .       ....   .  .    ..    ..  .   ...   .     . .         .. .   .  .      ..  ..  .   ...   .
. .  .   .       .  . .       .        . .. .           ..   . .. . ..    ..        ..... ...  .   .
......  ..    .  .  .   .  ... ..    . . ..    ..         . ...  .        .. . ..        ...       .
. .  . ..            .    .. .....         ..           .         ..      . . . . ..     .  .      .
.     ..          . . . .     .  .      .    .  ..    .. . .     . .. . .     ..  .  . . .. .    . .
.  .        ..     .   .. ..     .   ..  .  .   .   .            ....         .    .              ..
. . ..   .     .. . ..     .     .  .      ...            . ..     ..  .   .   ..   .    ..   .  . .
.  .    .      . .  ..      .             .  ..  .     ..  .  .  .  . . .       ..   . .  . .  .   .
.     .     ..  .   .      .  .      .   .   . .      .     .  .      .. . . . .      ..  . .   .  .
..  . .    . .  .   .    .        ....           .  .. .    .       .  .. ..    .     .     .   ....
.        . .        . ..   ..       . ..             . . . .   .   .. .   ..  .  .    .. .  .....  .
..  ..       .. ..   . . . .    ..   . .         .  .  .   ..  .    ..  .    .  ..         .    ....
.  .. .   .    ..    .  .  ..   .      . . .  .    .  .       . ..       . .       .   .   ..      .
. .  .  ..   ..   .   . .   ..  .     .   .. . .  .   .. .   . ... .   . .      ..      . .   .. . .
.     ..    . .       .  ...  .   .   ..      . .    . . .     . .. .   . ..         .  .  . .  .  .
.    . .  . .   .   ..    . ...   .            . .   X. .  .      . .   . . . .    .. ...   .    ...
. .   .  .  . . . ..   ..      . .   ...   ..   . .  .            .       .  .     .    .   . .  . .
. ..   .. .   . .   ...  . .  .   .    ...  . .. .     .   ..    ... . .   ..             . ... .  .
.  .  .   ... .         . ...    .   . ..  . .   .  .    .     ..   .    .       .    ... ..  ..   .
..  .          ..       .. ..  ..  ...   . .      .   .   . .  .     .   .  .  .. .  .     .  ..  ..
..          . .   .   .....   .           .    .    .    .    .   .            .    ... ...  .   . .
..  .  .   ..  . ..    . . ..   .        .     ...    ..  .         .    . .. .  r     . .    ...  .
...     ..  .      .      ...     . .   .  .....        .        .                             .  ..
.   .   .. ..   . ..    . .      .  .  ..  .    .  .    .   . .   ....     .. .    ..    .     . . .
.        .    . ... .... .         ..           ..      .   ..          ....   .     ..  ..  . ..  .
.       ..     . .  ..  .  . .          . .  .     .        . .        .   .    . .  .....    .   ..
..      .     .  .       .  . .   ..  ..  . .    . .  .     ..  . . . . .         ..      ...    . .
.                 .  .   . .    ... .    . .       .     .        ..  .     .   .  . .  .. ..   .  .
. .    .   ..  .       .    ..  .. ..       .  ...    ...    ..   .    .   .  .  .    .  ...    .  .
..   . .  .        ..  .           . .        .   .  .   ... .      .    .  .. ..    .       .    ..
.    ..   .  ..      .  ..        .  ..       .   ....      ... . . .  ....  . .    . ...   ....  ..
. .. .    .      .  .     .  . .      .    .  .  .  .  ..    .  .  .   .   .. .. ... ....  .  .  ...
.   .        .    .            .          ...   .   . ..   ..  ....      .    ... .    .           .
...          .    . .. .       .   . .       .        .     .   .   .. .....      .     ..   .  .  .
.      ..   .   ..  ..   .    . . .   .   ... .      ..  .  . .  .  .  ..  .  ..      .     .      .
. ... .   . ..  .        . .      . .          . . .  .          .. .   .   .. .       .   . .     .
.  .     ...  .   .      .    ..    . ..    .    .  ..    . .      .  .      ..    . .. .  ....  . .
.... .      ...    .   ..      . .                . . .  .           . .            .      ..   . ..
.   ..  ..      .     ..  .  .    .             ..         ..         .    .. .  ..  .   .   ... . .
.. .    .  .     .   .  .   . . .      . . . ... ..    .  ..    .         ... .   .     .   ..     .
...  .    .           ..   .  ...   .    . .    .. ..    .    .    .    .          .  ...       .  .
. .     . .   ..  ...  ...  .     .. ..  . .         .      .   . . .      .      .    .   .    .. .
.     .    .   ..   .  ..   ..     .  . .   .. .   .      . .     .    .     . . . .....  .  . ..  .
.  .. .. .. .  .  .    ..      ...        . .   .    ..     ....  ...       .     . .     ..    . ..
.   .    .. .   . .   .    ..  ....  . ...    .. ..   . .. .   ...  . ..   .  ....  . . .         ..
.  .         . .  .   .   .    .   .   .         .           .     ..   . .  ..   ..    ..    .   ..
..  . ..  ..   .  ..   .  ..   . .      .. .   .   . .     ..      . .. .   ..    ..  .  . . . .   .
. .     .    . ...  .          .  ...  .     .. .. .. .    ..  .. .  . .     .    .   . .   .. ..  .
.  .   .        . .      .       ..  . . .   .      .     .  ..          . .. .    .  .   .    ... .
.     . ... .    .    .  .. . ..   ..    ..   ...     .        . .             ..    ..  . . .  ....
.    ... .    ..   .  ..   . . .     . .. . ...    . .   ... .      .  .. ... .   .  ..  .    ..  ..
. . .. ......    . . .   .     .        .     .   .  ...    .  .   .       ...         ... ...    ..
..         ...        .  . .. . . ..   ..    .     . .. .  .  . ..   .     . .... ..  .  . .  . .  .
.  . . . .       ..    .  . .  ... .       .  . .   .   .      .. .    .    .        .. .   .      .
.                .       . ..  .             .     ..   .   . .        .        .    ..  . ..... . .
. .                 . .      . ..        .  . ..... .. .             . ..      .     ..   .  . ... .
..         .              .  .   . . .   .  .  ..       ..... . .  .  .   .. .  ..     .  ..    ....
.    .    .        . .     .        .. .  ..         .    ...  .   ..   .   .    ..    .   .      ..
..       ..      .      .      ....      . .    .   .      .... . . . . . ..   .     .  .       . ..
. . .... . .     ..  .. .. . .  . .              .          .  .      ..   ..   .    .           . .
. ..         . ...  .  ...    ..  .. .            .. ...  . ..  ...       .  ...  .. .    .        .
.      ..    . ... .  . . .. .. . ..        .    ..  ...     .    . .  .  .      .  .     .  .  .. .
.  ..       .  .    . .          ...   . .. .    .     ...     ....         . .    ..    .    . .  .
.. ...     . .   . ..    .. .        . .           .  .. . ... .  .  . . ..... ..    . .   ..   .  .
.  ..   .  .  .     ... .  .   ..        .. ..     ..  .  .   ..     .     .. .    . ...   ..    . .
.      .        .. .       . . .   .   ..  .. .. .    .  .  .         .. .    . ..   ..  .  . . .  .
.. .   .        . . . ...     .   .  ..                  ......    ...       .   .  .  ..  .  . ....
.    ..    . ..     ..  ..   .  . . .  ..    .       .. .. .. .   .   . ..   .  .  . .   .. .. .  ..
.     .          .  . ..   .  .    .        .. ..     .  ...  .. ..    . .  ..  .       .        . .
.   .        .   .. . .   . ..  .   ....      ..               . . ..   .     .   . .           . ..
.    .               .   .    .  .               .    .     .. . .  ...    .      .   .   . .  . . .
.   ..      .    . .       .  . .   .      . .    . .    .      ....         . ... .  .   .   . .  .
..  . .       . . .      .   .      ..  .      .     . .    . ....     .    .    ..      . .  . .. .
. . .  . . .   . . .    .  .. ... ...   .  ...  ... . .     . .     ....     ....       .   ..  .  .
. . . .... ..  .       ..       .      . .       .  .  .   .. .   .  .   .    .  ..        .       .
.   .     .                  .  ..  .  .           . . ..  . .  .. ...    .               .   . .  .
.    .         .          ..    .    . . ..   .      ..  ..    .. . . .... ..        . ..    . ..  .
. ..   . ..        .    ... .. . .   . . .  . . .  .  ...   .        .    ..   .       ..  ..      .
.      ...    .           .    .  .         .  .    .         .  ..   .      . .  ..    . . ..   ...
. ..        .  .   ... .     . .   .  ... ...         .    .. . ..  ...  .  .          .  . ..  .  .
.    . .    .. ..    .  .   .    . .     ... .    ..        .   ..      .. ..        ...     . . . .
.    . .      .  . . .    ..   ..  . ..  ...  ..   .. . .    .. .    .     .   .. ..    . ..  .    .
.  ..              .... . . .   .     . .  .. . ..    . . ..   .   .   .. .   .  ..    ..     .  ...
. .               .  . .   ..  .    .    .    . .  .         .  .  .   .   .       .       .       .
. . . ..  . . .    . .     ..      . ..            .      .. .  .         .              .   ...   .
..    .   . ... .  .    .     .   .   . .  .  . .  . .  .    .   ... .     .  .   .  .   ..   . .. .
.  .       .. ...  .   ...   .     ....    .     .     .       ..   .. ..   ... .  .. .      .     .
. . ...     .     ....... .   ..   . .    .       ..      .  .       .   ...       .   ... .      ..
..     .       .  ..  ..       .. . ....  .     .. .  .   .    .  .    .. .   ....   .  .   ..  . ..
.       ..                      .    . . ..  ... .        . . ..      .   . . .             ... .. .
.    .   .. . ... ..   .. .  .  ..                . .   .    ... .     .     .. .  . ..  .         .
....................................................................................................
