.....................................................................................................
..    . .  . ...       ..      .                    .     . . ..  .    .. ..    .  ...        . ... .
.    ..  .       . . .. .    .... ....     .        .  .    ..          .....       .      .        .
..  ..         .   .  .. . . ..          ..        .  .     . .      .    .   . .  .    ..        ...
.     .. ...            .   ..      . . ..         ...... .    .. .. . .  .    ...   .  .     .. .  .
... .  . . .  .           .   .            . .    .       .   . ... .. .      .    . .   .   ...    .
.       .     .  .    .  .     . ... .   ..          .. .  .      ..        .   ... .      .  .  .  .
...            .. . ...  ..      .    .     ..   . . .    .      .    .. .      .  . . . ..    ..  ..
.   ..             .  . .            . .  .    .. ..   .. . .   .  .   . .           .. .     . .  ..
.         .        ..   .  .  ..  .. ..           ..    .    .    .. .. .     .      .  .   ....    .
...  ..    .  ...  . .  .       . .  ..    . ... ..   .. .  . .. .. .  .     .    ..     .     .  ...
.  .  ...  ... .....    .    .    .. ..    .  . ..    .    .    ..   . ..     ..        .  ..  .    .
..   . .    .    .. .        .   .            ..   .  . ..    .  . .  .    .     . ....   ..   .  ...
.  .. . .   ..   . ...     ..... .   ..   ..       .      .          . .      ..   . ..    .. .   . .
.     .       .       ..  .   .  .    . ..       ..    .    . .. . . ..  .  .. ..       .     .  .  .
. .   ..    .  .       ....    ..     .     ..  .    .    .....          .       . .     .   . ..   .
.       ...          .   .  ..             .    ..    ...  .    .      .   . .  .  ....   ..        .
..         . ..    . . .    .  .    .          ... .   .    .     .  ..  ...  .  ..     .      .    .
.  .      .. .            .  . .       .      .  ...     .  .. . ..    .  ..    .           .   .....
.  .      .   . ..   . .    .  . .    .   ..  .    . .   . ..  ...    .   .  .   ..  .   .     .. . .
.   .     .  .     .        ..    ..  .      ..  ..       . .  .   .   .. .  ..   .    . . . ..  .  .
. . .            . . ...... .... . . .   .    .. .     ..    . .   .  .  . ..   ..   .   .     . .  .
.  .       .      .. .  .     ..      . .         ..   .           .. ..      ..               .  . .
.   .. . ...     ...   . ..  ...   . .   .       .       ..   ..   .    .  .    .   ..    .   .     .
.      .     .. .. .  .      ..  .       .      .      ..  .  .     ..     .           .  . .  . . ..
.   .  .     ...  .. ..     .. .   .         .    ..  . .. . .      .....   .  . ...   .   ..  .  . .
. . ..  ... .  .. ..   ..  . .   ...    .   .   .        . . . . . .     .   ..     .  . .   .   .  .
...     .        ...                  . .  . .       .    ..   . .  .    . ...      . .     .  .  . .
.       .     .    .  .   .    ..    ..       ..  ... .      .  ..  .        . .. .  ..   .         .
.  ..   . ... ..   .      .    .. .    .  .  ..         . .     .   . .. ..  ..   .   .     . .   . .
. .      . . . .   ..  .         . . .              .   .  .      ..  .  .    .      ....    . ...  .
.  .   .    ..     .  .   .     ... ...       .  . .   .. .        ..  .     .  .    .  ..   . .  . .
. .  ...          ..   .   . ..   .  .   . .            ... .     ..      ..  ...  ..      .  .    ..
..     .. .  ..  .   .     ..   .  .   .  .. .   . .  .                .          . . ..  .  .   .  .
. ...    ...          .. . .  ...   .. . .  . .   ..  . .. .  ..    .   ..     . ..  .         .    .
.      .         . .   .. ..   . ..   . .     .. ..        .    .         .  ... . .  .   .  .   .. .
. .   .. ..       .       . ..    .     . .    ...  .     .    .  .  .     ..   ..    .    .        .
.  .  .   .  ..      . .  ... . .      . ..     .  ..  ..  .  . .   . .       .  .    .     .  .. ...
. .   .  . .. ..          .     .     .. .  .  . .    . ..  . .  ....  . . .....      . . .     .   .
. .      .   .    .      .        .    .  .    .   ......       ..  .    .    . .    . .    . .     .
.. ..    .  .. .  .      ...   .    . .   ... ..    . .. . .. ..  . .   ..    .  ..       .       . .
.     ..      . .   ...  .  . . .    .   ..   . ...   . .   .  .  . .     ..    ...    .    .. ..  ..
.    ..    .. ..    .  . .  .   ...         ..    .  .. .    .    . .  .   .    .. .   .     .      .
..   .      .  .. ...  .   .     .  .          . ..    .   .  .   .. .  .    ... .  .       ..   .. .
..   . ..  .              . .      . . .     . .     .    .     .. .      ...   .  .      .  .  ..  .
.     ..  .      . .   .. .  .. . .  ..  .  .  .  .. .         . .  .   .    ..         .  .. . ..  .
..   ....   ..  .   . . .  .. .  .. .            .         ...     .   .  . .    ..  .   ..    .. . .
.     .  .  . . .   .    . ..  ..   . .   .     .     ..  .  ..         .       .. . .    ..   .  . .
.       .           .. .    .  . . .. ..   .         .      .. .   .     .   . ..     .  ..    ..  ..
. .           .    . . .  .  .  ..    ..  .  ...   . . . . ..... . . .       .     .        ...  .  .
..  ... .. . . .. . .. . .        ..      ..         . .. .      . ..  .   . .   . . .     .  . . ...
. .      ..   .                  ..       .... .      . ..  .  . .    .   . .    .    .   .      .. .
.     . ..  ..   .. ..         . . . . . . ...       . ..  .  ...  ...    . ..  .       . .    .. . .
...       .        . .    ..   ..   ..  .  ..  .  .    .  .  ..           ..           .  . .      ..
. .     .    ...   ...          ..   .   .     .        .  .      .       .. .    .. .       ..  .  .
.. . ..      .. ..        . ..  .            .....  . ..  .      .    ..  .   . .    .  .    . .. . .
...  .  .     .      .    .  ..     . .    .   ..  ..  .      .  . ..         .    ...    ..    ... .
.         .   .   . .      .           ..     .... .        ....       .  ...    ..  .   ...  ...   .
..  .      .       . ..   ..    ..  ..  . .    .  . ..  .   .   .. .  ..    ..     .. ..   ..   .....
. .      ..  ...     .   .       .       . .  ..         .        . ..... .            .. . .       .
.          . .   .  .  .. .  .    .              .  .    .   . ...         .  .    .. . ..      . ...
. .          .           .      .     .  ...   ..  ....   . ..               .  .  .    . .    . .  .
.  ...  ...    .  . ..     .. .         .   .   .  . . .       . ..              .  .    ..         .
.     . .  .  .           .  .       . . ..    . .    .  .   ..   . ... . .       ..  .  . .    .   .
. . ... . .    ..  . ..  ..   . ..   ...   ...   .  . ..     .   .    . . .   . .   ...    . .    . .
.             .      ..  ..   ....   . .   .  . . ... .   .      X .   . . ...      ..     .     .  .
.   ..    .   .  ..  . .  . .   ..   ..    ..      . .   . .     . .   .. .   ...  .. .      .   ....
. ..   ..  .      . .. .    ...  .  .  .      . .  .       .     .    . .      .   . . .      . .   .
.  . .        ..    .  .  .  .. .    .         ..       .     .  ..      .     .    .    .     .    .
.       .         .      .        ..  ..    .  ..   ..          .   .   . .   .   .     ..  .   . . .
.   .    .        .   .    .        .   . .. . .      .     ..   . .   ...       ..  .    . ..  .   .
.   ..   . .   .      . .     ..  .         .  ..  ..      .....   .                          .   . .
.      .. . .. .      . . .  .  .. .     ... .    .   .    .  .  .   .      .     . . .       ..  ...
.   .  .   .   ..  . .  . .   ...          . ...          ...      . ..     .       .            . ..
.  .. .    . . ...   .   ..  . . .         .    .. .      .      .   r ..       .       . .     .   .
.  .. ..    ..         . .  .   .    ...  .  .  .  .  .            . ...   .  . . .    . ...        .
. .  . ....    ..       ...  . .....     .   . .    .  ..     ..       .    . ..  .    .    .    .  .
. . . ..     ..        . . . .    .  . .  .  ..    .. .  .     . ...     .  . . . . .   ... .     . .
..  .  .  .   ..  ..       .. ...    . . . .        ..    .    . .   ..  .  ..  .   .   ...    ...  .
..  . ..... . ..  . ...... . ..  ..  ..    .      .    . .  .     .     ..... . .     ..    .  . ....
...   .... .      . .    .                .   ..    .  . ...  ...   .   ..  .    .    ..  .      .  .
.   . .     .  . .  .   .  .  .. . .         .       . .  .. ...  ..    . .. ..  . ...  ..  ...  .  .
..     .    . .          . .  .  .   .. .        ..    .   ..   ..   .  .  . .  ..   ..   ......   ..
.    .     . . . .   ...     ..  .. .     .  .       .   ...    .. . .      .  ..      ....        ..
.. ..    ..  .       .  ..            ..         .  .      . .  .           ..  .     .       ..    .
.. .. .. .     ..     .  ..    .  . .    .  . ..   .  .. ..  .        .        .. .       .         .
.. .      .   .   .  .  . .  . .   .      ..... .  .   .  . .   .     ..    ..  .     .      .  .  ..
.    . .     . .      .      .  . .           . ...  . ..         .  .    .         .    .    ..    .
... .         .  . .     ..                 ...  ..   ... .. .   .  .  .   . .        .   . ..      .
.      .. .. .      .. .     . ..    .     . ... .   .     ..... . .  .   .            ..   ..    . .
. ..   .       .   .      .... .      .     .  .      ...    ..        . ..        .. ..       ..  ..
. . .     .. ..    ..  ...     . .    ..     .   .  . . . . ..    . .    .  . . . .. ..  . . .. . ...
.      ..   .      . .   . .    .   .  .  ..       .. .       ...       .   ..    .  .  .       .   .
.  .     .  . ... .       . . .. .   .   .   .    .  . .  ..  ..    ...      .    . .. ..        .  .
.  .            .  .      . ...    .. .    .  .        .    .              .     . .  ..      .    ..
.. .  .... .     .   .. .   .          .           ... . .    .  ... .     .       .   ..    ..  .. .
..   ...    .         .   . .  ...  ...    .  ...  .        .      ..       ....   .    . .  ...    .
.  . .  .     .    . ..   .      .      .. . .   .    .   .    .   .     .. ..         ..      ..  ..
.   ..    .  .   . .   . .  . . .    .   ..    ..  ... . .   ..          ...     .  .         ....  .
.  . ....    .            .. .  .     . ..  . .   ..             . .   .         ..           .     .
.....................................................................................................
