......................................................................................................
..      .    .  .   .        .   .  .       ..  ..        ...       .. .     .  .     .     .  .  .  .
.   .     .             . . ..          . ..    .      .     ...   .  ..  ..   .   . ... . .. .. .   .
..    ...     ..       .   ..    .. .  .  .  . ..  . ..    .  . . .   ..      . .   .     .      . ...
. .     . ...   . . .     .    .. ..     .      .      .      .  .      .  .            ..       .   .
.      . .  .  .   . .  ...        ..     .      . . . . . .            ..  ..   .  .  .  ..   .  .  .
..       .  . ..     .                    .   ..       .  . .              . . ...   . . .       .  ..
.      ..      ... . .  .  .    ...   ... .    .            ..    . .       .  .. .   ..  .    .. .  .
...     .   .         .  .X .   .      .  .   . . .   .   ... .     .        .  . .   .  . .     .   .
.  ..   .        ...   .. ..    .     ..  .        .    ... .  ..   .   .     .      .         ..   ..
.  .     . ..  .. ...     ..  .     .     .       .    . .  .   .       . .  ..      . .. .  .   . . .
. .     .   .  ... .   .  . .    .            .. . .   .  ..     . .   . .     ...   .               .
. ...    .  .    .  ... ..  ..  ..    .        ...  . . ..  ...   . ..  . . . . .              .   ...
.          .            . . .   ....  ..    ....     ..    ..  .       ..  .. .     .         .      .
.   .       . .    . .  .  . .   .   ..  .     ...     .....   . .  .  .         .  .    . .        ..
.. . ... .   .  . . .  .      .              . . .    . ...  ..      . .  . .    ..  . ..   ..    .  .
.     ... . .          ..    ..  ..   . .       . .. . ...  .  .  . .     .     ..    .   .  .. .    .
...    .. .  ....        ..  .  .  .   .    . . .  .     ...     .        .     .    .  .  ...       .
.  .  .      .  .   .   . .   .          . . .  .                . ..  .  ..   . .  ...    .  .      .
...  . ...   . .           . .   . ..  ..             . .  .       .   .   .. . .     . ..  .. .  ....
...  ..    .     ...     .. ...  ...  ..   . .       .. .. .     .       . .  .            ..  .   . .
.  ..        .. .     .                         .....      .   ..   .  ..   .      .    ..      .   ..
.  . ..  .             .    .   .. .   .       .  .   ..   . ..      .   ...   .  .   .    . .   . . .
... . .  . . . .. ...   ..  . .    ....   .. .      .       ..            .   . . .      .      ...  .
. .    .     ..     . . .       ... . . .    ..  .   ..  ...   . .. ..       .       . ...  .. . ... .
..     .  .. .    .      . .. ... .  .   .     .   .       . ... ... ...     .  . .  .   ..     .    .
..   .. .   ... .     .     .    .. .   ....       .  .. .     . ..   .     . .         . .     .. . .
.   .              ..    ...  . .  ..     .       .   . .      ..  . .      .        ..   .   ..   ...
. .          . . . .  .  . .   .    .    .  ..   .      .  .        ..     .             .  .  . . . .
...  .   .  .  .  .   ...    .    . . .  .  .  ... .  . ... .  .    ..   ..       .     .   .    .   .
.  ..   .. ....  .. ..    .        .    . .. .  .  .    .   ..    .  ..  .          .    .    . ...  .
.  ..   .   . .   .   ...        .      .    .       .   .     .   .. .    .  . . . .   ....       ...
..   .   .   .  . .       .  .      ....    .       .  ..  . .   .      .   .    . .    .     . .   ..
.    ..  .       .         .  ..    .  .  ..  .   . .   .. .  .      .    ..  .    .  ..       ....  .
. .  . .... .          .   .     . .    .   .     .  .        .    .  .    . ....          .     .  ..
. .   ...      ...  .. .     .. .      . . . .  . . .. .  .     .   .     . .   .. .  . ..   .  . . ..
.. ..   . .  ..  ..    ..      . .  ..   . .        . .   . ..       . ..           .    .  .   . .  .
..    . ..    ....  . .  ..    ... . ..        .   ...  .     .        .  .   ...       . . .     . ..
. .         .. . .  .    .  .. .  . .  .. . ...  ..      .      .     . .. .         .      .   . .. .
.             ...  . .   .    . ..   ..         . .  . .      . .  .  .  .         .   .  ..   .  .. .
. .  ...         .  .   .  .  .   . .  .   . . . ..      .    .  .  ..   ..... .        .   ..   .  ..
.  .  .    ....   .   .         . .   .         .       .    ... .       .  .. ..      .  .  .       .
.   .. .       .    . .  ..  . .. ..    ...  .      ..  .  .  ...  ..   . .  .    ..     . ..   ..   .
.  ..  .. ..   .  .         .  . .. .  ..  .  .. .    .. ...    . .. .     ..        .    .  .      ..
.  .   .   .          . . ..   .  ..   . . ..   ..   ..    .       ..  .   .  . . .    ... . .    ....
...   ..          .  .  .   .     .       ..     ...      .    ...   .   .      ..    .           .  .
.   .   .       .      .  . ..   . .....     . ..     .      .   .    ..       .   .          ...    .
.. .  .      .     .   . .    .  .   .    .   .       ..     . .. .  ... .  ..      .  .  . .      . .
.     .     . ...  .  .. .   .   .     . .     . .. .    .      .   ..   . .       .    . . ... . . ..
..   .     ..        ..     . .    .    .          .     ..  .  . .. . ..  .         ..      . .     .
..          .         .  . .       .    .        .    . .  .  ..      . .  ..    ... .    .   .     ..
. ...  .  .. ..     . ..     ..     . . . .   .. . ..  .    ....     . . . .  .   .. . . ..    .  . ..
.         .  ... .  .  .      .   . .  .   ..          .      ..    .   . .   .      .   .  . ... .  .
.... ....    ..  . ..   . .      .  .. .    . .      .  ..  . ..  . .. .  .  ..           .   .     ..
.            .        . .     ..          ....  .            ..   .     . . .  .     . .  . . . . .  .
..     ... .        .  ..     .   .     .. .      ..       ..  . ..   ... ..  .  ..      .      . .  .
.   ...  . .    . . .   ..  .       . . . .   ....    ..     . . .. . ..                . . .    ..  .
..              ..          .       .. . .  .. .       .  .   .       .       ..    .   .  .   .  . ..
.    .  .  .  .. ..           ....      .  .            ..    ..  . ..     . . .      . .    .  ...  .
...   .. ..    .     .  .    .   .   .    .  . . .    .          . . .  .        ..             .    .
. . . .         . .     . ..  .    . .    ..                 .     .     .           .       .     . .
.. .  .       .. .        .    .      ... ...  . .. .  .  . .  . .  ..     ..   .   . . ..  . . .  . .
. ...  . . .  . . . . .   . ... . . .   ... ... . .      .     .  .    .  .       ..    ..    . .   ..
.. .    ...   ...  .   ... .   . . .    . ...       ..     . .       .   ..  ...  . ..  . ... . .    .
. .  .  . . .  ....  ...    . . ...   .    .  .  . ... . .        . . ..      . .   .  ..     .. . . .
.. .  .  . ....    . .    .   .  . .. .. ...  .   . .           ......     .   ..   . ..  . .  ..  . .
.     .  .          . ...  .         .    . .. .  .. . .    . ..       ...   ..     ...            . .
. ..  .    .....    .   ..      ..    .          .  .     ..  .   .    ..  . .. .            .   .  ..
. .            . . .. .  . .    .  .   .  . ...   ..  . .    .     .             ..   .     . .     ..
.. . . .  .  .          .  .      .  .  ..         . .       .  .        .    .      .  ..    . .    .
.           ..  .        ..  .... ..    . .. ..  .     . .  . .    .   .    .   . ...         .   . ..
... ..  .  . . . . ...  . .   ... .   ......  ..     .           .     .  .      . . .   ..        . .
. .. ... . ..         .    .           .        .   ..   .           ...      .   .      .... .    ...
...    .    ..   ..  . . .    ..    ..   .  .       .  .   .   .   .      . ..  .  . .         .  .  .
.... . .  ..     ..  .  . . .    .      ... ...  ..   .  .... .     .    . . .  .    .  .  .  . . .. .
. .     .  . . .  . .  . . ..     .   . .     . .  .     .      . ..     . . .  . ..   . .      .   ..
.     ..  .......           .  ....  . . .   .           .    ..  . .                   .   ....   ...
....  .   .  ..    .  . .  .     .    .                .  .   ..      .... .  .     ..           .   .
.  .         .     .  ..  .        .  .          ..  .. .   .  .    .  .  .  . . .    .   .     ..  ..
.   .  .       .   .           .   . ..    .  .    .  .  .    ..      . .. . .  . ..    ..     .    ..
.        .    ... .   . .. .. . . ..  .       .     . .. .  .....     .     . ..   .     .   .      ..
. ..  .            .          .     .. . ...      . .... .   ..  .... .       .        . .  .        .
.    .    . .   .      .     .   .. ..    .      .   ....    .    .  .   . . . ...  .  .    .  ..    .
...       .  .  ..  .. . .   .    . .          . .           ..   . ... . ..      .   .   . .  ..... .
.   .   .  .    .  ..  ..           . .        .  ..   .      .  .. .    .       .  . . .          . .
.. .       .   ...   .  .   .      .       .      ..   .    .      .       ..       ... .    .  .    .
.... . .  .. .  ...     .       .  . . ..   ....          . . . .. ...   . .          . .          ...
..     .   . .       .  . .   .    ....       ..   . .       .    ..   .     .  .. .   .      ...   ..
.     .       .  . .  .    . ..  .  .       .     r .   .. . .  . .        .  ...  . .      . ..     .
.   . . . .     .  .. ..  .     . .   .     ..       . . ..            .   .  ..  .   .    ...    . ..
..    .   .   . . .    .   . .        .. .      .         .        .     ..     .    .. .    . ..  . .
. .  . .   .       .. . . .   .  .  .   .  .  .   .. . .   ...  .. . .. .             ...   ..    .  .
.  .     .  ..  .    .   .    ..   . . .  . .    ...        .   .. ...  . ...         .       ...    .
. .     .   . ..      ... .  .   .  ..  . . .   .    ...       ..  .  . .  .. .     .      .        ..
. ..   .  ...    ..    .  .      .  ...  ..    .  .    .  .    . .. .   . ..  . .   .   ...          .
.  .              .       . . ...  ....     . .       ... ..    ....  ....   . ...  .  . ..    . . . .
. .      . .    . . .              .   .    . . ...  .        . .. .    .        . .. . . ..  .      .
.  . .   .   .  . .. ..     .  ..... .. .    ..   .. .            . .   . .   .  .    . .     .  . . .
..     .     .    ..      .   . . .   .   ..  .  . .    .               . .      .  . ..  ..    .    .
... ..  .. .    .. ..         .         ..       .       . ..   . .     .... .  .            .     . .
.   .  ..  . .   .. .. ... ..      .    . . .   .. .. ..  .   . .. ..         .         . ..       ...
......................................................................................................
