.......................................................................................................
..    . .. .   .      .    .     . .. .   .  . .  .. ..       . .  ..  ..    ..  .          .      . ..
.     .   .  . ...  ..  .    . ..    ..     ..           ..    .       .  . . .  ...     .   .        .
.    .   . . . .        .  .. .. .         .  ..      . ...       .  .        .    . .   .   .  .   . .
.           . .       . ...   ..  .      .     .       ...    .  ... .      . ... .   . .      .      .
.... ..   .      . . .    .   .  .     .  .   .   . ..  ..  .   . . ..   ...      .. . . .  . .. . .  .
. ..        . . .      .   ..  ...    ..   ..   ..   .    ... ..     .    .     . .  ... ..     .  .  .
.         .  .     ....     .. ..     .  .     .   . ...   ... ..      . . ...  .  .  .  ...  .     . .
...         .   . .  .. .  ...      ..     ....    .      .   .       .         .    .  ..   ...   .. .
. .    .        ..  .   .  .    ... .  ... ..  .. .  .  . .  .        . .. . ...  ...    ..  .      . .
..     .. .   . .     .  .   .   ..  . .    .     ...   ... . ..    .        ..   .  . .  ..  .       .
. ..    .  ..      .  .       . .  .   .   . .   .  .  .  .  .      .  .    .  .  .                . ..
.  ..     .    ... .    ... . .    .  .. . .    .           ...   ..     .. . .      . .  .       ..  .
.     . ..     ..    .    .  .         . .         ...  .  .. ..        . .             .. .    . .   .
. .    .   .     . . ..   . ..    . .   . .     .    ..  . .   .   .  ..     ....     .  .     .     ..
.  ..  .  .   ... .  . ..    .     .            .  .         .      .  .    ..     .           . .    .
. .          .        .  ..  .    . .  .        ...   .        .    .      .. . . .      .      .    ..
. . .... .. . .. ..   . .      .  ...     .   .   . .        .  ..  .  .   ..        .      .  ..  . ..
...   .   .     .  . .            ...     . .  .    ..           .. . . .  .  .      .. .   .    ...  .
..    ..  . .   .   ..   .       ..   . ...       ...  ... ...    ..   . .   .   ...        . .       .
. ..  . .  . .   ..   ..     .   . ..   ..            ...   .           ... ..  .            . .   .  .
.  .    . ...  . .     .         ..     ..          ...   . ...    .  .   ...   ..     ..  . ... . .. .
... .   .      . .  .  .   .     ..  .  ...   ....     ..  .     . .  . .. ..     .   .    .     .... .
.   .  .   . .   . .   .   ..   .           .   .    .     .    ..  ..            .        .  .    .. .
...   ...  ...   ..    .   .     .  .  .    .     ..     . ..    ..   .                   .   .     ...
.      .  .. .    . .  .   .  ..  ... .. .    .  . . ..       .    ..       . .    .... .  .. .  ..   .
..  .        .         ..         . .              .   ..         .     ..   .....  . . . .      . .  .
.    .      .    ..     . .  .    .           .. .     ..  .. .   X   .    .   .             .  .     .
.          . .         ....  .. .   . .    ..      . .. . . ...    .. ...    ..  ...    ..  .   ..   ..
. .         .  .   .. ...   .     .     .. . ...            .    .    .       .. .. . .  .     . . .  .
. ..   .   .  .. .     ..    ... .     .. .              ..   .  . ..  ..   .  . . .      .    .      .
.   ..  .    .   .  .. .  . .  .    .. . .   . ..   ..     .   . .     .  .   ..    . ..    .  . . . ..
.  . .     . .  .. ... .  ..  ..  .      .     . . . .  ...    .           . .   ..      . .  . ..    .
. .   ..  .   . .     . .     ..    .  .. .  .  . . .     ..   . .                  ..     .. .     . .
. . .  ..                     . .                . .    ..  .  .    .    . . .  .    .    ..     .  . .
.  . . .   .    ..  .           . . . .          . .        .     . .  . .. .  . .         .   . .. . .
. ..  . .    ..   ..    .  .       ..  .        .   .  ....  .  . ..... ..    .     ..     .          .
..    . .  . . .      .          .      .   . .   .  ..   .  . ..         .    . ....  .  ..    . .   .
..   ....   . . .             .       . .  ..  .   . .      ... .   ..        .  ... ..     .       . .
.  ....   . .    .           .     .     . ..     . .        ..      .. . . . . .. . . .   ..  .   .  .
.   . . . .  ..      . ...  ..     .      .      .  .  .     ..    .  ....         . .   .    .       .
.  . ..    ...      ..   ..       . .   . .      . . . .  ..    . .   . .. .      ...   .  ..  . ..  ..
.       .. .     .. ..  . .  .. ..  .. . ... . .    ..     .   .  .. . .        . .                 . .
..     .   .. . ..  .        .  . . .     .  . .. . .  .. ..    .  . . . .   . .   ..   .   .   .   . .
. .  .    .. .  .       .       . . ..  .        . .   ..   .    .    . ...   ..    . ...  .     .    .
.     .     .   ...   .. . ..   .. .    .        .   .      .  .       .     . .     .    ..   ...  ...
... .    .  .      .  .  ..    . .  .           . . .     .. .   ...     .  .             ..      .. ..
.   . .  .    .. .     . .   ....   . . ..     .              .   . . .    . ..     ..   . .  .  .  . .
.   .    .   .  . .  . .       .   .  . . .    .   ...          .  ....   . .             .  .. . .   .
.  . . .   .. .. . ..    .  . .  .. ..  .  ..    .  ...  . .    .    .   ..   .  .   ..      .       ..
.   .   ..       .  ....  ... .    .  .. ..    ..    .. . ..    .   .          .    ..   .. . .. .   ..
..        ...         .   . ..    . .  ..    .     .  ...   .   .  .   . .  .  .. . .  .    . .      ..
..      . ..        . .   . .  ..  .      .  ..  . .     .  .   . .   . .   .. .             .  .     .
.          .   .   ...   ..  ..    .. .   .      .. ..     .  .    . . . . . .   .  .    . . ...  ..  .
. .  ..      .   .  .  .   .   ..    .    ...   .  . .     .   ..  ..            .   ..  .. .   ..    .
..   ... . . .  .    .      .....  .     ..  .   .. .     .     .    ..              .  .   ...     . .
..   . .    .    ... .   .       .    ......    .     .  .. .       . .    . .  ..    .     .  . ..   .
..            . . . .         .      .                    ..       .   .     .       ....      r.. .  .
. ... ....        . . .  .    . .  . .  . . ..    .. .       .      .    . .         ..         .     .
.. ....  .  . .        ..   ..  .   . .      .         .   . . . .        .. ..     .   .   . .    .  .
.  .. ..  .  .   ..     .     . .     ....   ...    .     ..  ..   .    . ..      . ...  .   .   .  . .
.         ..   .     ..  .  . ..   .   . .    .  . ...       .    .  .    .  . . ...    ..      .  .. .
.    .   .  ..   .             .   . . .  . .  ..   . ..    .. .... .  .  ...     . . . .    .       ..
. .       .     . .     ..  .. .  .     .    .   .    .        . . . .  ..           .  ..... . ..    .
.      . .           ..     .      . .    .    .... ...  . ..    . .  ...         .       .      .    .
. .   .  .    .  .   .   .. ....    .     .   . .   .. ..      .           . ..  .. . ..  .    .   .  .
.      . .                   . ..   . .   . . ....     . .     ..  .   . . ..     .  ..     .. ..  .  .
.       .. . .... .         .      . .  . .       ...  ..    . . .      .   .  .  ... .      .      ...
..  .   . .  .. .. . .   .       . .   .  .    ..           . ..  .   . .  ..   .     .     ..   ..   .
.      . . ..    ....     ..       ... ..   .   . ..   .        .           .  ...  . . .. .    . .. ..
..     . .         ... ..           . .  ...   .   . ..     .  .       . . .           . . . . . .. . .
.  . . ..   .     .   ..  ..  .   . . ..    ...   . .  . . ..       .  . ...   .   ..    ...  .....   .
.  .          .    ... .     ..          .       ...   ..       .  ...   .      .  .     ..           .
..   .   .       ..  .   . . .   .    .    .    .    .. . .  .    ..    . .   ..     .       .   .. . .
..   .   .    . ..         .  . .    .   . . .. .  .       .         . . . .  .. .  .  .         ..   .
.         .   .      . ...      . .  .. .     ..  .     . . . ..       ..    ..           ... . . .   .
.....  . ...     ..      .   ..   ..   .. .   .  ... . .    . .     .     .     .. . . ..     . . . . .
.   ....      .  .  .      . . . .    ...  . . . ..       ..    .   . . .  . ..  .          . ..   .  .
. ..     ..       .   ..       ..     .   . ...      .         .    .   .        .   .      ...       .
. .   ....  . .     . ..    . . .    . .  ..  . ...  .     .       .  .        ..      .    ..   .   ..
. . .. . .    ...   .   .       .  .    ..    . ... ..   .  .  ..     .  ..   ..                 ..   .
...    ..   .         .   . .        . .     ..     .   ..  . ....       .  .   ......        ...  ....
.       .      . .   .  . ..    ...    .    ... .. . .  .  .  .  .     .. .  .    .  .   ... ...  .  ..
.        ... . ..   .  .  ..       ..     .  .....   ..  .  .     . .. .... .....     .     .        ..
. . .      ..   ....      . .. .   .         . ... .     . .  . .         ... .  . .....  ..        . .
..   ...   .. .     ..        ....    .     ....  .     ...   ..   .. .. .      . ..  . .. .  .     ...
. . .  ...     ... . . ..     ..   .  ... ...    ..   ..            .  ... .. . . ..       .   .  .  ..
. .   .    .          .  .  .. . ..       . .  .      .     . .         .    . .           .    . .  ..
.  .     .. .. ..  .     ..      .     .     ..   . .        .  .     .. .   .   .   .    .   ...     .
...  .          .....  . ..      ..  . . . .  .           . .  ... .       . .     .  .. .. .   . .   .
. .       ..    .. .      .  . .  . .    . .    . . .     ..  .     . .   .           .. .   .   ..  ..
.  .. .  .     .    . .               .     . . .    . .    .    .     .   .     . . . .    .     . ...
..    .  ...   ..     .      .       .      .     .    ..      .    ...  ..     .      ..   ..      ...
. . .   .   ..             .   .   ..    ...        .     . .  .    .    ..  .   . .  . .  .  .      ..
.   .    . . .   .  . .     . .     .  .  .  ...   .     . .  .    .    . . .   .        .  .     . . .
.    .       .    .    ..   ... ... . .  ..  ..   ..  .           .  . ...         . .     . . .   .  .
.   .  .     .    . .  .    . ..     .   .  ..  . .               . .      .. .  .     .             ..
. .  ..   . ....             .    .     ... . . ..   . ..     .    .    .  .  .    .     ... . ..  .  .
.      .     .     .   .  .    ...  . ..  .. .  .     ..     .       ... .  . .     .   .        .   ..
. .  ..      .  . .  .     .        .   .      ..  .  . .     .     . .      .         .. .      .    .
.  .   .    .  .     .  .      .. .    .          . .            .. .        .                 ..    ..
.     .   ...   .   . .  .    .       .      . ... .    . . .  .  .  .     ..     ..   .    .  . . .. .
.......................................................................................................
