........................................................................................................
.. .  . .  .  . .    .  .  .   ..        ... .    .. . . .   . .   .  .      ... ..            .   .  ..
.           .        ..       .        .. .   . .  . .       .  ..          . ..        .       . ...  .
..  ...  . .. .  .    ..   .  ...  ...   . .  . ... .    .         . .     . . .. .  .    ... .  . .   .
.    ..       ..   ... .      . .       .         .   ..       .  ..      ..   . .                .    .
.. ..                           ..      .    .         . .. .  . .  ...    ...    ....   ..  . .  .  . .
.   .   ..   . ..  ......        . ..  ..  . .  . ... ...          ..             .    .  ...   .    . .
.       .  . .      .      .   ...  . ..      .   . . .   .      .        .  ..            .           .
...    .   . .   .   .   .         ... . .   .. . .  ..  . .    ..  ...     . .       .   .   . . .. . .
.    .  .  .  .    ...    .. .  .   . ..     .. ..         .. ..       . . ..          .   .   .   .  ..
.    .   .   ...  .... .  ....  .    .      . .  .   .  ..  ..   . ..   . .        ..  . .. . . .  ..  .
. .   ..   .... .       .         ...        .      . .   ...   .   . . . .   .. . .      . . .     .. .
..  . ..  .   . .     ..          . ... . . .  .    .     . . .   .  .   .    ...        ..     .  .   .
.  .     ....  . . .. .   .      . . .. ..   .. . ..  .    . .      .   .  .   .    .... .        .   ..
.    . ..   .  .    ..  .    . .       .. .       .     .  .   ... . ..  .   .            ..  .  .     .
. .    .   .          ..  ..  .     ..  ..  .  .   ..  .         . . ...  .. .. .     .  .     ...    ..
.    .  .  ..        .   . ....        . . ...    . .  .  .  . ..     ..  ...  . . .      . .  . ..    .
..        .      . .. .  .  .  ..    .    .   ...  .  .    ..       .    .  .  . ... .      .   .  ... .
...      .    .  . ...   .   . .   .          .   .  .   .   .    .  .     .  . .    . .  .   ..   ... .
...   . . . . .   . ..   .  .    . .   .  .   .  .      .   .       . . .    .     .   .  ...     . . ..
..   .   . .   .    .. . .   .  ..  ..       ....     .  .  .  .   .      .   ..   .         ... .     .
.    . .  .   ..           ..    .   .       ..    .     .          .. . .    . .   .      .. . .     ..
..  .  ..     .. ..  ..         ...          .. .    .   .. .. .     .. . .    .  . .    .     .   .   .
. .    ..     .. .        .  . .  ...   .  ...     . ..      . ..          .  . .   ..   .. .  .    ....
. .  .          ..   .                  .       ..  .  .      ...  .        .     .  . .  ..     .   . .
.  .   .  . . .   . .  .   .        .  . ..  ..              ..    ..             . .      .        .. .
.    . . .               . .    ....    .  . ..    . .   ..    ..   .   .    .   .  .       .  .  .    .
.   ..  ....       .  .   ...   .  ...      ..  ..    ...  .  .      .   . .    .         . ..    .    .
.      ..  .  .. .   .... . ...   .. . .   . .        .....        .   .    ..  . . .      ..   ..   . .
.     . .   .     .. . .      .  ..  .   .    ..         .  .  . .. ...  .   . ..  .   . .   .  .      .
..       . .         ..    .   . .  ..  .      .  . ..    .   .  . .       . .  . .         .. .  ... ..
. .  ..    .   .   ..  . ..  .   .   .  .  ... ..  .    . .     .....     . ...   . .       .        . .
.  .  ..        ... ..  . ... ..... ..    .       .   .. ...        . .... .  .      .     ...  . .    .
.        .    . .   .     ..      .   .  .   .     ... .   .                .        ....       .. ..  .
. . ..   . ..      . .             ..     .                 . .. ..    . ... . ..          .. ..  .    .
. ... ..         .              .    .  ..  ..     .. .  ...  .  .. .     .  .  ..  . .       .   ...  .
.   .. .  ..     . ...  .    ..   . . .  .   .. . ...           .  . .    .       ...   .    .     . ...
.    ..     . .        ....   ...    .. .     .  . . . .   .   .  ... . .  .. .   .  .. ..    . .  .  ..
. .  .   ...    ... .  .. .... .         .   .  .  . .. .   . .   .     ....  .  ... .  .  . .. ...   ..
.     .   . ..     .          . .. .. . ..     .       ...   .. .   . .   .  .. .       . ..  .   .  . .
.   .  .      . . .   .  .. .  ..   .        ...    .         .  .  .  . .    .   .     . . . ..    .. .
.   .   .    ..   . . .  .   .    ..       ..    .   ..    .  . .  ..  .  ..... ..  ..   . ......      .
. .... .   .... .  . .       .  .   .    .  .    .             ..         ..   ..  .           .  .. . .
.. .  .      .   ..  ..    .... .        .. .  .... .  ..   .. ..    ..   ..       .   . ...  .   . .  .
.  ..        ..  ..  .   .. ...  ..  . .    . . .  .. . . .  ..      .   . ..   ..   . ..   ..   .    ..
. .  .   ...       .  .   ..      .       . .               .. .   .. . .   .   .  .    ..      ....  ..
.. .       ..    ...   ..            ..               ..    ...  .       .  ...  ..  ..       ...  .   .
.       .  . .           .              .  .       .           ..   .        .           . .  .  .  . ..
. .  ..  .    .  ..      .      .   .      .     .    .   ..  . . ..   .  ..      .          .. .    . .
. ..       .   ... .      ..     . .. . .    . .   .  . .  .      . .     . . . .  .  .    .   .   .   .
. . .. ..  .. .    ....   .. .       .  .          . .  . .     ..      .   .   .         .     .. ..  .
.  .   .        .  .    .  .    .. .      . .    .    .   . .     .  .. ..  .  .......              .  .
.    ..  ..                ..  .  .    .       . ..     . . .  .   . .               . ...  ... ...   ..
.  .  .          .    . ....  ..   . ...   . ..... ..       .    .  .... . . . .    .    .  . .      . .
.   ..  .. .. .  .                ..  . ... . .      .       .  . .. .   .    .  ..    . .    .  .   . .
.   .... .  .. .  ...  ....   .    .  .           .           ...      .   .  . .   .       ..       ...
.  ..     ..     . . .  .  . . . .   ..  .  . .  .  .. ... .   .  .         .. ...    .   .  .  . .   ..
.        . .  .         ... ..  . .    .   .      .  .     .  .  .    .           .      .       . .   .
.  .      .   .    .  .     .. .  . . ...     .      .   .. . ..         .    .  ...   .  .   . .   . ..
..    . . .      .   .  ..    ..   ..                   . .   . . .   .     ..   .. . ..... .       . ..
.    . .    .   .      .          ..      ..    .     .  ..          .     .     .  ..   .      ..   . .
...   .   .    .   .  ...  .     ....   .     .... ..  .    .  ..    . .        ..   ... . . .   .  .  .
.     .       . .r..         ..     ..   .    .      .       .   . .  ..   . ..   ...     .     .   .  .
..          ..  .  .   . ..  .      .       ..  .   . ....  .   . .   ... .   .. . ..  .  .        .   .
.  .   .. ....  .   ..    . .. .          ..       .   .   . .  .     . .             .       . .    . .
.. .     . .  . .  . .....  .....  .    .   . .            .   .....  .   ..  ..  .         .      .  ..
. ..  .  ..    .         .   .   .     . ... . .   .   .  ..  . .   .       . .        .     . .       .
.       .   .  .   .    .   ....  . .  .     . ...           .  ..   . .    .. .    . . .. .        .  .
.    . .    .  . ..  .       .  . .     . .   . . . ... .  .      .    .  . ..  .     . ... .     . .  .
...   . . ... .    .    .   . .       ... .      . .  .         .  .  ..  .  . .    . . . .    .   .   .
.   ..     . ..  .     .  . .. .  .  . .                ..     .        .  .... . .    . ..     .      .
.     .       . ..         . .  .     .  .  ..        .. .   .  . .   ..     ...    ..   ...  .     . ..
.. ..        .    .  ...     .  . .... ..        .  ... ...      .        .    .      ..  .  ..        .
.              ..   ..  ...  ..      .  . ..   .    . .. .      .   ..      . ...     . . . .       .. .
.  ..          . .. .         .  . .  . .         .  .      .    . . . . ..   ..  ..      .     .. .   .
.  .       .   .   .  ....   .    . .  . .  .       .            . ...  .    ..      .  .  .  .    .   .
..   .    ..   .   ...        . ..    ..   .    ..     .   .   ..   .     . .. .   ..     ....         .
.  .  .      .        .  ..           .  .. .  .  . .     .  .     .   .    .  . ..       .   . ...  . .
.     . ..  .  .      . . ..  .     . . ...       . .      ... .             .    .       .         .  .
.      .  .   . .   . .... .    ..   .    . ..   .   .    .  ...        ...           .     .    .     .
.  .     . .     .  .  .. .  .  ..  ... .  .     .. . .        .    .    . ...     ... .  ..    .      .
.  . .    ..      ..       .   . .....      . .     . ..  .     . .     .    .    .. ..... .  .       ..
. .  ..           .. ..  .  ..   .  .  .     ..           .       ..    .   .   ...  . .. .  ..   .... .
.      .  .    .     .  ..    ....      ..  . .  .  .... .  .    .         ..         .  .    ..     ...
.... .  . .   .  . .    .                 .   .    .     ..             .   . . . .  ..         .   ....
. . ..   .     .   .      .  .  .    . .  .       . . .  .   .   ..          ..   ..  .. .     .  ... ..
.          ..  .                  ..    ..   ..  . ... .  .   . .        . ...   .   ..... . .  ..  .  .
. .  .     .            ...   .  ..     .      .. . ..   ..    ...  ...  .    .   .      . . .   .     .
..    ..    .  ... . .....        .. . .      ..  .   .     . . . .   .      ..    ...  . .  .         .
.      . .   ..  .      ..    .  .     ..      .. . .  ..      ..     .     ...  .. .   . .  .. .   .. .
...    .  .     .  .    .  .     ..       .   . .      .  . .. ..  .       .           .   .    ..     .
.   .. . .      .       .  . .     . .   .   ...   .   .   .  ..  .  .     .   . .  .       .        . .
.. .    . . .   .  . ...    .    .   .   .  ..        . ..                        .   . .   .    ...   .
.. ....   . .     ..  .     .  .   . .  .  .    ... .   .  . .   .     .      . ...           ..   ... .
..              .  ..   ..  .  .       .. ..   .   ...      .     .....    .  .  . .. ..    . .    . . .
. .  .       . .  .     .         . .           ..  .. .  .  ...    . .  .. ...      ...   . .    .  . .
.      ... ..  X  .. .     ..                .  .      .       ..                . ..   .  . . ...     .
..  ..       .   .  .    . ...   . .        .         .    .     ...   ..      . .     . . .       . . .
. .         . .    ...      .  .  .. .      .    .       .     .     ..   .. . ..    ..    ..  . .     .
..    .     .   .  .  .  .        . .       .   . . .    . .        .   .. . ...  . . ..  .   .  ..   ..
..    .     ..    . .  . .    .  .      .        .  ...... .  ..  .  .. .  .         .  . . . .      . .
..          . . .      .      .     .              .    .  .  .   ..  . ..    .. . .       .   ..   .  .
.        .  .         . ...   .   . ..    .  .  ...  .    .    . ..       ..       .   . ..  . .   .  ..
........................................................................................................
