.........................................................................................................
.    .          .   .  . . .  . .     .    . ..       .    .    ..            ...  .  . .   .   .  .    .
.   .    .    ..   .       .       ...  .  ....     .          . .         ...       .   .    .         .
...  . .     ....    .    .       .     . . . .  . .        . ...    . .  . .  . .  ..  .   .   ...  . ..
.         . .. .   .  .  . .   . ..           ..   .    ..    . .. .....   .. . .         .    .     ....
.         .   . .      ..   .     ..  .   . ...  . .      .    .       .. .   . . . ..   ..  .       .  .
. .    ..  . . . .  ..    .         .   .     .     .     .   . ..   .. .   .     ..    .   .    .      .
..         . .    . .. .      .   ...       . ..   .   ...   .  .. . ..     .. .. .  . ... .  .  .   .  .
. .         .     .     . . .     . .   .        . .          .  .. .    ..    .  .                  . ..
.  .. .   . .      .. . .   .     .     ... ..  ..  . . .  . .  .  . .... .  .     ....    . .          .
.        . ..  ....    .   ..    ..  .  .  . ... . .  .  .   ..     .  .    .         ..     ....       .
.       .. ..  . ....    .    .  .   .   .   .. .   .. . .   . .  . .         .             ..  .  . .. .
. .  .       .. .   ... . ..  ..       . .  .        . . . ...    . . .  .            .    . . .   . .. .
. .     .      .. .  ... .      .. .  . .    . ...... ..  .    ..  ...        .  .    ...    .  .   .  ..
..      .      .  . .     .  .   .   .  .     . .     .  .   . .. .     ..        .....  .. ..         ..
. .  .   . .   . .   .    .       ..  ..     . .  .  . .       .   ..  .. ..      . .      ...   . . .  .
.  . ..  .. .     .. .   .  . .         .. . .        .... .  ..   ..  .   ..      .  .. ..             .
..    ..    .  .... . .     ..  .   .  . ..        .. ..   ..  .   ..    .      . ...      ..    .    . .
.         . .  .    .   .  .           .. .     .. .  ..    .   .    .      .  .         . . ..   .. .  .
.  .. .  .. .  .    ..       .  ....  .  .  ..   .      . .. .     . . . .   .     . . .  .    . .  .  ..
.     ...     .   ..  .....     ... . .     . ..    . .  . .  . . ..   .  .  . .  .        .            .
.  .                    ...  . .  .   .       . . . ..  .   .    . .  .   . .. .   .  . .    ....   . ...
..   .  .    .   .   .. .              .  ...         . .   .  .   .   .   .  .      .  . .    ...   ....
.              .     .  .    ..   .    ...              .   .   .    . . ..     .  . .  .  . . .      ...
.. .        .    .  . .. ..     .  ..  .  .    . ..   ...  ...            .              . ..        .  .
.            . .    .   .      . .. .         .  ..   .....    . .   .   .. .  .            . .  .    . .
..   .     .     . .  .  .  .    .   .  .  ..     ....  .  ..    .   ..      .....       .   .  .  .    .
. .   ... .     .     ..  .  ..  .. ...   .      .          .     .  .     .   .    . .     .  ..    ....
.          .      ..       ....        .            .     .  ..     ....     .. ...  .  ...      .   .  .
..      .  ...   . . ....    ..       .        .     ..          .  .     .   ..  ...    . .  .   .    ..
.      . .    .  . ..   . . .   .. .  . ..          .         ..  .    .         .  .   .  .       .   ..
.       ..    ...     ... ..   .  .    . . ..  .    . .   .  ..            .      .. ....    ..   .  . ..
.   ..      .       ..  ..    . .. .      .   . . .  .  . .   .      .. . .  ..    .        ..     .    .
...      .  . . .    .   . .      ...  .  .. .  .  .   . . .   .     .     ..       .     . ... . .     .
.         .   .      ..  ..   .  ..  . ..                 .       .  .      .        .. . .     . .     .
...  . .       .      ..   ..        . .   .   .     ..      .        ..    .  ......   .. .         .. .
...  . .    .  .   .      .  .   . . .   . . . . .     .        ..  .      . ... .  .. .. .  .. .      ..
...  . ..     .  .    .. .     .. . . .    .   . .   ...  . .    .  .      ..     .  . .        . .. .. .
.  ..    .. .  .    . ..     . .     . . . .. ..   .  ..     .       .  .      .    .       ...     ... .
.   ..  .  .  .      .    .   .  . ..    ..  .    .       ..     .   ..      .    .  .   .  .. .  .   . .
..   . . .   . ...  .          .  .  .        ...  .   ..  .   ..     .   .  .  . .           .  .     ..
. . .    ..  .X    . ..           . .     ...   ..       .    ..   .    .     .          ...  .  .      .
.    . . ..  .     .. . ..    ..   .. ...      .    ..           .  ..       ..    .        .   . .    ..
.      ... ..  . .    ..         .  ... .  .  .. .   .   . .  . .... . .. . .        . ...  .  ..    .  .
.  .         . .  . ..       . .         .   . . .     .     ...    .           . .        ..    .     ..
. .  .       . ..   ... .     .     ..       . .  ..         ....   .    .  .  ..     .   .     . .   . .
..   ...  .    ...      .    ..  ...     .   .   .     .     ..  . .... .     . .  ..    . .    ..   ....
..  .. .  .    . ..  .  .  . .  ...        .    .     .  .. .      .   . .... .. . . ..  . .  . .     . .
. .   ..          .          ...    ..  ..... .  ... .         . .  .        . ...  .. .     . . ...  . .
.   . .  .  ..      . . .      .     . .. .  .          .    .  ... .. .  .  .    . .   . ..  .        ..
.    ..   . .          .   ...  . .   .  .    .. .         .                        ..    .  . .... .  ..
...  .  .  .    .  .    ... . .        ..     ..  .     . .     .... .       .  .   .     . .           .
.. .      ..    .  .. ..    .  . ..  . . .       .        ... . . . ... .       .   .. .   .  .   .    ..
... .     .. .   .    .     . .. ..     ... .. .  .  ..  ....      ..        ..  .   . .. .   .      . ..
... .  .. ..   .            .  ..... .   .  .. . . . .  ..   ..     . .  .. ..      .. ..   ..         ..
..  .    . ..      .   .  .  .    ....   .     .     ..  .     .      . ...   .         .  .   .        .
..  . ... .   .  ..         .. .    . ..   . .  .  ..      .  .  .. .  . .   .  .    .. ... .      ...  .
.     .   .   .   ... . .  ...  ..                 .  .   .  .      .    .  .. ... .   .       . .     ..
..    . ..   . .  .        ....      .    .  ....  ... ....         ..        . ..   .   .    . ..    . .
..... .    .      .       ... .  ..    .  .  .            ..    .         .         .   ..  .. ..     . .
.   .    . ..    .      .  . ..        . .  .  . .... .. .   .   . .  ..       .  ..  .  .    .     . ...
.      ..   . . . .              .. ..   ..          ...   .       .  ..  .             ..... ...       .
.     .   . .  .. . . .. ...      ..     ..           .    .  ..     .. .   .. . ..   .    .  ..        .
.    ..    .   .    .  . ..         ...   .  . .  .    . .   ..  .   .   . .  ..   .        .    . ..  ..
...  . ..     ... ..         .         . .  .   .   ...    .. ....   .            .     .     .        ..
.   .   .  . . .    .    .  .   .. .  .   .. ..         ..  . . ..    . .        ..   ....     .      ...
.   .     .  .       .     ..  . .      ..   .    .       . .       ..  ..         .  .         .   .   .
..          . ..     ...   .  ..  .. .  .   . .   .  .....   ...      .    . .. ..    .   .  ..  . .   ..
.   .       .    . .    .    .      .  . . ...     . .    ..               .. .        .  .    .  .  . ..
.        .     .  .        .      .  . ..  .    .    .  .   .    ..     .   .  .  .       . ...    .. . .
..    ... .  .  .    ..  ..  .. .        .  .. . .  .  .    ..   .... .       .  . .   . ...r.     ..   .
.              .  .      .      ..            .. .             ... ...   .  ....     .   .    ...  . . ..
..     .  ...  .   .  ....  . .   .  .      .       ..       ...     .        .       . ....            .
..    .     .  ....   .              . ..     .   ..     ..  .. .  .      .     .     .. . . ...   .   ..
.   .     .  ..  .       .       .. ..  ...  .    . ..  . .  .     .  . ... .       . ..    ... ...  .  .
.    ...  .  ..   ..  .  .   .  .. .  .  .     ..      ...      . .   .       .     ..          ...  .  .
.   . ..    .. .  ......  .  .. .      .       .. ..    .      .     .  .   . ..      .  ..   .  . ..  ..
.  .... . .....      ..            .  ..        .  ..     . ...  . . .    .  .      .  .  ..   .    .   .
. ..   .   .    .    . .    ......     .     .    .  .    .    . ...       . .  . . .   ...   ..    .   .
.  .....   .  .      .  .        . ..               . ....  .   . .       .  ..       . .. ... .    . . .
.  .   .      .   . .   .    ... .  .  . .  .   .         .   . ..       . .. ..   .    ..      .    .  .
..     .. .   .  .....  . ..    . . .   . .  .  ..   ..  .   ...         . .  . .   .. . .    ..        .
.       ..       .    . .    ..   .     .  .    . .  .     ..  .  . .  .    . ..   .  .    .   . .   .  .
..  .... .      .   .    .. ... .  ...   ...   . ...   .        . .         .  ..         .   .    .   ..
. . . .     . .    ...            . .  .  .   .            .        .          ...   .       .         ..
. .  .  .   . .    .     .   . .  ...     .  .   .    . .  .   .  .  ..    ... .         ....   ..  .  ..
..     .  . ...       .  .  .        . . .  .        ....         .     ..          .   .  .  ..      . .
.   ..       . .   .   .   .       .         .      .  .  .    .  ..      ... .           ..  . .. .   ..
..  .     .. . .      .        . .      .    ..      .     .  ..    ..    ..  . .   .   .    . . . . .  .
.     . . . .              . .... .     .. .    . .  . .   .       . ..  ... .  . . .. .  ..       ...  .
.    ..  .. .      .        .  .    .. ..  ..    . .  .      ..     . .   ....     . ..... .         . ..
.  .   .    . . .      .    .  . ..   .  ...    .  ..   .   . .     . ..     .   .         .  . .  ..  ..
.  . ..     .      . . ........... .     . .    .     ..   .     ..     .. .    .     .   .   .     .   .
. ..    ..   .  .     ...      . .. .    ..    ..            . . ..      .. .   ..  .  .       ..     . .
..   .         . .   .  .....   . ..... . .      ..   . ..  .    .  ..   .       . .     ..  .   . ..   .
.          .  .     .   .   ..  .    ....  . .       ..  ..  . .       .   .   .  .  .     . .. . . .  ..
.. ..  .               ..    ...   .   .   ..      .   .            .       ..   .    ... .  . .   ..  ..
.     . ... .    .  ..     .        .       .. .   ..   .  ..       . ..  .  . ..   . .  .  ...   .  . ..
.. .   ..         .     .        .         ..    .        .  . .    .    . .. .       .  ..  ...  . ... .
..  . .... ..          . .        .  .             .. . . ..   .       ..               .     . . ..    .
.      .   .  .             .   .  .     .        . . .          .. ..   .      .     .    .. . .. .  . .
.    .     ..       ..          ..   . ..    .    .     . .  .     ..  ... . . .   .    ..  .          ..
... .  .         .   .              .    .  .. ....  . .      .     ..     .       .      . .    .     ..
. ...      .    . . ..    ...      .  ..        . .  .  .  ...  .        . . ...  .   ..    ..  ..      .
.........................................................................................................
