..........................................................................................................
. . .  .  ..    .  .     ....     ..   . . ..     . . ..       .      .        ....        .   .     .   .
.. ..         .       ...   ..     .      .   . .      . . .  ..         . .   .       ..   .   . ...  . .
.  ..    ....     .       . .  .          . .    .     ..  .  .    .    ..  . . .   .  .    .   .  .  .. .
. ...    .     . . . . .. .    .   .      . .       . .      ..   .      ..    .  .    .. .. .  .   .   ..
.     .     . .   .     ...      . ..       ..    ..  ..     ..         . ..   . . ..          . .     . .
...   . . .     .....  ... .... .    . . ..  ... .     .    .     ...     .. . .. .   . . .    ..       ..
.    .... .... .  ....     .       .                   .   .. .      .  .    ..  .. .        .      ..  ..
.   . .  .     .....  .  ..   .       .   .       .      .    ..        .. .          .  .      . .  .. ..
.  .    .. .         .    .   .  ....  . .  .                           ..          .  ..          .  .. .
.    .   .         .  .    ..        .   .  .   . ...    .  .         .    ...  ..     . ..   .     .    .
...   .      .. .     .    .   . .   .    ..   . .. .......  .  .  .    .  .   .    ... .   . .. .  . .. .
.  .      . .    ..     . ...         ..  .               . .  . .  .      . .         .     . .    .   ..
. .    .  .    .   .    ..    . .   .  . ..  ..  . .     .  .   . .                ..    .. .   .    ..  .
.      .         ..   ..       .    . .     ..   . . ..    .     .  . .  ... .. .          .       .  .  .
.    ..  . .  .      .     .              ..       .     .   . .....      .... ..  ..  ..     . .   .... .
. .       .....  .  .       .  ....         .  ...    ..   ..   .  . . . .                   ..  .       .
.     .    .  .  . .      ..        .  .  .     ..    ..    .  .  .   ..      .... ..         .  ...   ...
.   ..  .           .   .     ..       .   . .. .       .     .. .        ...    .     .     ...    . .  .
.  . .. .  . .  .   .. .       ....   .. .  .   .       .   .    .. .      .    .. ....  .       .       .
.  ..  .  .      ..  . .         .... .      ...   .     .. .  ..  .      .   ...     .    . . ..  .. .. .
.. .. ...       . .   .  .....   . .. ..       .           . . .  .        .  .  . . ..  .  .       . .. .
.    .       .     ..   .   .     . ... .           .      ... .  .     ..   ... .       ..    . . . .   .
.   .        .    ..   . .  .   .  .   .      .   .           .. . .  .       .  .  . ..      . .  . . ...
.  . .   . ..   .....  .             .  . ..   . .   .         . .   .  .   .                   .   .    .
. ..    .. ... .   .   . . .         . ....  .   . .  .. .        .. .  .       .. .    . .         ...  .
..         .. ...     .     .   . .      ....  ..            .   .    .. ....  .. . .     .. .   ..      .
.  .. .  .  . .    .. . ..  ..           . ...  .        ...   .  .             .....     . . .      ..  .
. .       .    .  .     . .     .          .      .    . .           .   ..      . .        . .  ..     ..
..          . ..   .    .   .  . .    . .. ..  . ...   ..       .  .        .   .     . ..   . .  .  .   .
.           ..             .     ..   ..     .   ..  . .   .. .  .  .  .     .    ... .  ....    . . .   .
.      .  .  .  . .     .     . . ..  ..      ..   ..  . .   ..       . .       .. ... ... .. .     .    .
..  .  ..   .. ..          . . ..      ..       ...  .     . .  . .. .. . .. .. ..   .   ..  .   .    .  .
.    .  . .  .. . .. .   ..  .    ... .    .   .  . .   ..  ... . .    .  ..  .      .. ..    .      ..  .
.   .  . ..   ... .. .  .               .   . . .. ..  ...     .. ..      .    .  .      .      ..   .   .
.        . ..    .  ...  . .       .  .    .  ..  ....  . .. .  . ..   .    .  .....    .         ..     .
.    ...   .    . .  ..     . ..              .     . .     ..   .  .    .   .. .. .    .     . .        .
...  . .  .      .   .. .  .         .. .    . .   . ..  . .     .  .  ....         .     . .          . .
.. .   .. .   .    . .. ..    .. . ...    .   ..   . . .  .... .            . . .  .  ..  .   ..  .  . ...
.   ....  .     ..    ..        ..  .  .  .   .        .   .   .   .  .             ..       .     ...  ..
..            ..    .... .  .   ..   .  . .     .   .. .    .. ..  .. .      .  .  . . .   .   .  .. .   .
.         .      .  .... .              .     .   ..     .  .          . ...     ..  . .  .       .  .   .
. ..  ...   ..  ...  .     .         .          .   . . .  ..   . ..    .    .     .     .  . .  ..    . .
.     ..   .    .. .  .     .   .      .      .   . ..   .    .  .   .  ... .  .       .   .          . ..
. .    .  ..       . . .  .  . .       ... . .          .. ..   .          .     .  .    . .     .. .. ...
.   .  ..       .  .   .   .. ..   .       . ..    ... . .      ..      ..  .. .    . .        . . .     .
..  .  .          ..      ..  . .    .   . ..... .    .     .     . .   .  .  .   .      .       ..      .
.     . .     . .  .     ..  ... .       ... .   .  .   .    .     .    .  ...   .. .  .          .  ... .
.    .. .   .    . ..    .  .    ..    .     . .          .     .     . .  ..   .. ..  .. .   .     .    .
..      .. . .   ..   ..   . .  . ... .    .      .   . .     ...  .   ..  . .      ..  . ..  .        ...
.   . . .... .  .       .       .   . .  .      ..  ... .. .  ..   .. .    . .. . .  . . .   . .   .    ..
.  . .         .. .       .  . . ..    .     . .        .     ..        ...  ..        . .       .   .   .
.        .. .    .  .        .. ..      .     . .  .. .  .         ..     .   ...    .   .  .     .  .   .
....     ..     .       ..   .      . .        .    . . .       .  .      . X..  ...      ..  ..        ..
. .    .. . .   .        .   .  . ..    .        ..     . .. .     .       . .        . . ...    .  .  . .
.  .  .    . . .        .. ....        .  .  .        ..  .       . .    ..    ..  ....  .   .   . .     .
...  . .   . ... .. .              .. ..   .  ..  .  .              .  .    . . .  .     .       ...  .  .
.   ..   .   .          .. ...   .     . .. .. . .        .    ....   .  ..    .  .            ..  . ..  .
..  .  .  .     . . .  . .      . . ..   .      ..   ..   .  ..            .  .   . .     .  .     ..    .
.   ...  ..   . . . .   ... .  .  . ..   . .       .         .... .               . .       .         .  .
.. .   . .. .    ..    . .   .  . ..    .   .             .   .  ..   ..               ..  .     ...  .  .
..      .    .  . .  .  . . ...  .  .        .        ...   .      . . . .   .  .  ..     .  .     .  .  .
...  .        .   ...     . .  .   ..  ..   . ..    .  . . .    .   ..  ..     .   .    .     .  . .     .
.   .        . . ...   . .. .    ... .     . ..   .    .. .....    ..  .  . .      . . ..   .   .        .
.  .  ..    . . .      ... .  .         .      ....   .  .   .. .     .  . ..   .. ..   . .    .  .  .   .
..   ..   .   . .  . .     .. .        . .     ..  . . . ..       ... .     .  ..     .   .     . . .  ...
.   . . . .    .    .        .     .. .     . .      ....   . .    .. . .    .         .    ..    .. .   .
..   .  .   .   ... .    . .             .       ..   ..   .  .        .   ...    .          ...  .   . ..
.  .  .  .  . .. .  .  .  ..       .   ..           .  ..   .   .        .  ..  ..     ....  .  .   .    .
.  .  ... .. .  . .. . .    .. .      .    .       .    .    .  ..  .. .  .       . .. .       .   ...   .
.    .  .       .. .  . . .  . .. .     .. ..     .  .   . . .         . .   .     .   . .  .         .  .
.    .   ..    . . .  .. .. .      . ..     .      .       .        . .  .           .      ..   . .. . ..
.   ..    . .. ..... ..   .  . .            . ...       .  .     .    .  ....  .. r        ..           ..
.. .              . .  ....  ..    .. . .            .      . . ..      .. .        ..   . .     . .     .
.    . . ...  .     .  .       .    .   .. .       .  ..        .   ..   ..   ..     .. ... . .     . .. .
. ....           .   .  .. .  .    .     . ...... .  .. . . . .   ...   .    .      .             ..  .  .
.     ...  .   .                . .. .. . ..  .     ..             . .    ...  .   .  ..                 .
. ...     ... ..    ... . . .  .  .  .     .    ..   ..        .           . .   . .  .    .    .... .. ..
. .                .     .   ...  .    .  ...  . ..  . . ..   ..   .  ..       ....   . .   . .        . .
..      ..     .    .   .   ..      .  . .   ....... ..     .. .      . .     .      .   .    ....       .
. . . . .. ... .                 .  ...     . . . .   ...   .      . ... .     ...    .    .      .  .   .
.     ..      .   .      ..          .      . .      .     .    . . .         .  ..  .    .    . ..   .  .
.  ..  ... .     .. . .     . .  ..   .. . .   ...        ..   .            .   .. ..    ..   . .     .  .
...     .  ..   .              ...    ...  .       ..    .        . . . . ..     . .  . .    ....   . ....
. . . .         ...  . . . .. .. .    .    .  .     .. . .     .   .   .   ..     .  .       .   ... ..  .
.    .  . .  . ..     .  .  .  .   ... ..  . .    .  ..  ...   ..   .        ..      .  .  .   .  . ... ..
..       .  . .  .  ..    .   .          ..   . ...    .  .      ..  .   .   .       ... ..   ..     .  ..
...       .  ..     . . ...      .  ..    . .   . . ... .   .. ... .... .   . .  . .      . .  .       ...
.      .  .    .... .  . .  ..  .   .    ....  .       ..       ...      ..   ...  .. . . . . ..    .    .
.   ..   . .  ...   .   .        .   . ..   . .. .  . .      .. .....         ..              . .        .
..  .  ..   ..         .   ..     . .  .   .       . . .  ..     .    ...       ... .  .       .      .. .
. .  .  .   ..  ..     . ....       .      . .    .     ...  .  .  .       .    .  .  ....  .      . .   .
..     .       .  ..       ..      . .    .  . .  ..       ..    ..  . ...   . ..  ... ..  ...     . . ...
. ... .  .  ...   .      .      . .. . . . .    .     . . .      .   .          .  ..    .      ..   .   .
. ..  ...  .  . . .     ..    ...   .       .  .    . . .  . .. .   . ....   .        ...   ..... .... . .
..   .  .  ..   ..   .      .    ..  .. .  ... .  .  ...         .     . ..    .    . ..  . . .  .       .
.  . ....    .   .    ..  .   .      . . ...    .  . ...   .           .   .    ..  ..      . .     . .  .
. .  . ..       ..    .                 ...    .  .     .     . .....  .  .     .         .    .  .    . .
...            ..  .       .    . .       .  . .     .   .         . .  .       .  .     .  .  . ..  .   .
.      ...   .   ...  .       . .       .  ..    .    .       .   .   ...     .  ..    .   . ... ..      .
.    .  ..     .     ..         .. .  .  .   .   ... .. .      . .    .   .. . ..     .  .        .  ..  .
..   . .     .   .        .        .  . ..  .  . .    . .  .. ..   . .   . .   .  .  .   ..    .         .
.. ..... ...     .. ..  .     ..  .   .     . .    . .            .        .          .    .      ...  ...
.. ...    .       ...    ... .. .     .  .....    .   ..    .     .         .     .   .    . ..    .. .. .
.        .   .            .       .  . .   . .   .     .. .   . .  ..  .  ..    ..   .   ..   .. .  .   ..
..........................................................................................................
