...........................................................................................................
.       .  .   .  .         ...  ...      . . .  ..  ..     . . ..  ..      ......   .   . ...     . ..   .
. ..     .     .. .  . .   .. .   .     .  . . .  ..   . .         . .  ..      .    . .    . . . ..   ....
..   .  .   .   .   . .  ... .. .. .   .  .    ..  .    . . ..    . .   .   .  .     . ...      . .  .   ..
.  .     . ....     .  ..  ..    .   .      ... ..   ..    ... . .  . .. .  .      ... .          .. . . ..
.   . .. . ....  .. .      ...    . .. ..   . . .   . .     .     .   ..         .  .    . . .    . . ..  .
.  .   .   ..   .    . . .     ..     .   ..   ..  .  .  .  ..  .  .      .    .     .    . . .     .. ....
.   .         .        .. .. ... . .  .   .. .   .  .    .    .   .      .  ..    . .    .   .       .    .
.  .    . .  ..   .. . .      .  .    .. .     .    .    . .          .   .  .  ..    .. .       .        .
.  ...   ...      . ..  .        .         ..    .  .    .   .   .     ....   .    .. .     .  . .     .  .
. .. . . ..  ... .   ..   .  . ..      . ..  .         .. . ..   .   .  .     .   .     . ... . .     ... .
.  ....    .. . .  . . .   ..   ... .   ..  . . . .  .      .    ..         .   .   ..  ..  ..          . .
.   ..         .. .  . .  .  .. .  ... .      .  .             . . . ....  .    . .  ...  . .     .      ..
.. .  .. ..     .  .      . .          .   .       .        .... ...  .     .           . .  .  ..  .   ...
..  .   . .   . .  . ... .   ...    .       . ...   ...  . .   .. ...... . . .. .     .        ...    . . .
...  . .  . .   .     . .     ..     .        .   .  .   ..    .  ..  .  .           ..  .      .  .... . .
...        .      ...     . .   .     .      . ..            ...    . ..   ..    .        .... .. . ..   ..
. .      .. .   .   .    . .  .   .         .   .        .         .. .. .  . ....        ..   .  .   .  ..
.       .. ..  .  .... .   .    ..   .   .   .    .        ..  .         ... ..    .  .    .    . .  .   ..
..    . ..      ..   .   ..  .      .     ..     . ..    . .  .       . .   . .        .. .  ..   .   ... .
. . .. ...  .  .     .   .         . . ...   . ....  . .        .     .. ..    .  .  .. .. .           .  .
..    ..  . ..        .    .     .     ....      .     . ...  .   . . .    .         .        . .    .   ..
.  ..            .   .. . .    .  .              . . .   . . .     .   ..          . .          .      . ..
.   ... .       .     . .    . .     . .       .   .     . .   ...  .       .           .   .   .   .   . .
.    .  ...  . . . ..        . .               . ...  .  ..   .. .    .  .   .  . . .  .      .           .
. .. .       .   . .  ....  ..   ..    .. . .     . ..     .   .   .     .    .  ..   .  .           ... ..
.     .      ..  .   . .  .  .  ...       .   .     . . . . .     .    .  .   .   .   .  .     .  .  .. ...
.  ..  .    .   ...   ..  .  . ...          .     ..   .   . ..      .   .   .      .  ..   .  . .   .  . .
.      .    ... . .    ..   .      ..    . .  ..  .   ..  ... .       ..            ... .                 .
.     .  .    ..        .    ...    .    . . . ...    . ...      .   . .. .    ..  .. .  .   .  .         .
. .  ..   .      .   .  . ..  .     .    .  . .   . . .    .   .     .  ..  .     .  .. ...     .    .    .
.  .  .  .  . ..   . . ..  .        .    .. .   ..   .   ... . .    .. .  ..  .. ..        ..  .. ..  ..  .
.    ..   .  .  .     . .  .         .    . . .....       ..    .      ..    . .   ..  .   . . .          .
.  .. . . . . .       . ... .  . . .  .   .. . ...    .     ..  .   . . .   ..            .. ..   .      ..
.  .    .. .       .... . .    .          . . .     ..   ...   .      .            . ...  .   . .       . .
.  ..  ..  . ...   . .  .....  X  .    .     .     .          .     .   ..      .  .. .      ...    . .   .
. . .         ..     .      ..  . . ...    .   . ...       ...  .     ..                 .              ...
.   . . ...  . ..    ....  .      . . .       .. .     .    .  .  .    . .      . .     . .. .         . ..
.   ..   .  .  .  ..  ..   ..     . ...     .         . ..  .        . .          .      .       . .  . . .
.       .    . .   . .      .        .            . .  .     .  .        . .     .  .    .. .   .   .     .
.   .  . .     .        .   .    . .        .  .    ..    .      .  . .    .    ..   .  .    .  ..     .  .
.   ..   .   .      .    .  ...       ..          .. . .  ..    .. .  .    . .  ..  .  .           .      .
.. ...    .    . . .   ..   ...  .    . ..   . .  . .        .  ...      ..  .        .      .      . ..  .
. .   . . .  ...   .  ..      .   . .       .  ..  ...   ..  ..    .. .     .  .      ...  ..         .   .
.  ..       ..    .  .   ..  ..                   ..    . .   . .   .       .   . ..          .....   .. ..
...        .   .     .          ....  .   .     . .    . .  .         . . . .    .  ...      ..  .  .     .
.  ... ..   .      .            .  .. ...   .   .    . ...  . .     . ..   . .. ..          ..      . .  ..
.  .     .   .      .. .  .       .   .  .   .  .        ..   ..  . ..      ...    . .. .  ..  .  .     . .
..     .  .    . ..   . .         .    .       .. .  ... . . .. .     .   ..     .       . ..   .   . .   .
.     .   .   . . .   ...   .  .       .   .   ...  . . ..    ..       .. ..   . .  .             .  . .  .
. .              .. .  ..       .       ..   . . .... ..  .  .  .             . . .. .... . .   .  .     ..
.     .       .    .   . .  . . .  .  .  . .         .  .... .  .       .  .     .               .. .    ..
.     . .       . .          .    .  ..             .   .   .   .  .         .        . .  .        .    ..
.        .      . . . . ...          .   . ...   .          .  . . .   .        .      ...  . ..  .       .
.    .    .    .  ..   ..            .    .   .    . ..   .    .         .   . .   ..       .   ..     .. .
.    ..  .  .    .       .         .  .    . .    .      .. ..       ....   .. ..  . .    .  ..    . . .  .
.  .... .   .. .       . .   . . ..  ...   . .. .     ..   . ...     ...   .  ..    .  ...  .  ...    .. ..
..       .    .    . .   ..   .  ..   ..   .   . .   .. .    .   . .....   ...        .   .         ... . .
.  . ...  . ..        .   . . .    .      .       . . .        ..   .  .    .. ...      .. .   .      ... .
.   .        ...   .   .    . ..  ..   . .     ..    .      .  . .. .  ..  ..     .  . ...  . .  ..  .... .
.    .  ....  ..   ..   .   ..            .. . .  . .  .  .. .. ..   .... ...     ..      ..    . .     . .
.   .                .    . ..              .  .      .     ...   .    ..    .  ..    .  ..       .    .  .
. .     .       .  .     ... .     . ..      .         .  .   . . .. ..  ..   .    .. . .  .    .  .    . .
. .. .... ..   . .    .   . .  .      .    .  .. . ..  .  .   .  . .   ..   .     ..   .      .        ....
. . .. . .    .    ..  ..  .   .      .. ..    .. .. . . .. .. . .  .   ..  .             ..  .      ... ..
.  .       . ....   .   .    . ..     .   . ..                  ..  .   .  ...   . .     .  ..  .  . .    .
..   .   .. ..       .  .    . . .. ..     ..         .    .  ..   .   .. . . .  ..      ...   ...      ...
. .   ...  .   ..           .  .     ...      ..      .. .  .    .  .  . .   .     .. ..      . .      .  .
...   . .  ....   .     .   .  .       .. .  .   .      .         .  .        .       .         . . .... ..
.     ..        .     .    .. ..      .   .  ..  ... . .      ..     .   .     ..                         .
.   .      .   .  .          .   .    .   ..   .. . ..  .          ..            ... .      .. ..  .      .
. . ...  . . ...         .  .  . .. .  .                       .  ... . .   .      . .    .  . .    ..    .
..   .  ...       . .        . .......   .    .   ...   .  ..       . .      . .    .  ..    . . ....  .. .
.   .. ..    .  . ..    . . ..        .  .    .        .. ..   .      .. .  ..   .. ..   .   . .  . .    ..
.  .  .     . .....           . .        .     .           .   . .  .   .     .. .      . .. .   .    .. ..
..   ... .  .       .. .. .   . ..   ..... .   .. .  ..   .. ..   .  .  .   ... .  .   . .  ..  .    ..   .
.    .     .       ...         ..      . ..     .    ...   .      .. .  . .   . .  .      ..    ...    . ..
.. ..   ..  .    .   .  .     .  ..   .   . . .  .   ..     .  .    ..  . . .      .     ..         .. .  .
...  . .       .       .  .. .    ....  .       . .   ... ...   ..     .  . . .               .       .   .
.  .. .    . .      ..   .         .  .. ..     .... .       .         .   .    ..   .. .  .        ....  .
.   ..    .   . ..     .    .    .    . .  . . .   . . .      .   .  .         . ..       .  ...  .. ...  .
.    . .. ..         .   .      .   .  ..... .     .  ..      . ..   .. ...    ..   . .     .    ..   .  ..
.      ....  ..        .   .    ..    .    . . ...   ..  .  .    .      . .      .. .        . .          .
....  .   .    .   ...      . .        .  .   .   .  .      .     .  ....   .. .. . .   .  ..        .   ..
. .   . .....     ..  .   .  . . . .  .    .     . .         ..   .      .  .   . .    .. .  . . .  ....  .
.   ...  . .     .  .. .     . .    . .  . .  ..    .  .           ..    .     .      ..    .       . .  ..
.    . .   .... r      ...    .   .    .     .  . .  .     ...    . .           .        . . ..  ..    ....
.     ..  .   .      .   .  ..   .     .    ..    .    ..   ..   .  .  ..     .     .      .  ..    .   . .
..    . . .  .  .       .  .. . .. .   .. .      .    .  ...  .       .    . ..  .  .    . .  .     . .   .
.      .       . .                      ..     .   .    .  ....     ...      ...   .      .. .   ..  ..  ..
.  .      .. .  .       .     .   ..  ..    . ......  ...... .      .         .   .           ..    .  .. .
.   . ..  ..      .     .     .      .. . . .   .   .  ... .  ..  . .      ..   .  .    .   .. ..  .    ...
.            .  . .    .  .    ..   .  . ..     .      ..  .       . .    .     . ..  .         .         .
... .   .  . .  . . .             ..  .    . ..  .   . .. .  . .       ..    .. .           .   .   .. .  .
. . . ..       .  .   .    . . .  . .    .    .     ...   . ....          .         ....    .     . ..    .
.         ..    . . .  . . ..   ..    . ...     ..   ..    .     ..    .         ..    .     . .   . . ....
.    .    . .  ...   .. .      .     .  ..             ..     .....  ..      .    .. .   .   .  . .   ... .
.. .  .   . ..     .           .   ..       . .           .      .             .    .    .    .        . ..
..   .. ...    .    . .  .. .    .         .  .    .  .  .. ..  ... .    .       .   .             ..   . .
....    ..   .  . .             .  . ..  .         .  ..   .   .. ..... . .       .                 ... . .
. .  .    ...      .   . . .   .. . ....         ..   . .  .  .   ..    .   .     ...  .             .   ..
.    ... .      . .    . . .    . .. ..    .     .   ..    .  .        ...  ..  ..  . .. .   .    ..  .  ..
. ..     ...   .           .    .   . . . .  .  . .         ..     .     .   . .        .   .  .   .     ..
.   ..  .      .   . .      ...  .      . ......   .      ..  .  ...   .  .  .... ..     ...  . . . .    ..
. ..   .             ... .     .     . .  .. .     ..       .         .    .. ...       .. . . . .      . .
.   ...    . ...     .     ... .           .  .. .     . . . .   .     .  .    .. . ...   .. .       .  . .
...........................................................................................................
