............................................................................................................
.  .     .. ..      .      .   . .    .  .    .  .    .           .   .    .  .  .   . ..   .. .  ..      ..
.  .     .. ..  .  .. .    .    .  .   .   .   .. . .. .   .      . .  ... . ..      ..  . .   . ..    .....
..   .  .. . . .   .  ..     .  . . .   .   .    . . .   .     .   ..   ..    .         .. .   . .       . .
.     . . .      ...   . ... ..   .   . .   .    .   . .        .    .     ..   .   .       .  .    .     ..
.  .        .   ..   .  .     .     .       ..    .  .   ....   ..         .   . . .    .    . ...  . .    .
.  .  .  ..  ..       .    .  .. . .  . .          ..   . ..  . .. .     ..     .        ...               .
... ..  .    .. .   .  .  ..  . . .  . . .  .   ...      ..    . . . . . . .  .   .    .           . .  .  .
.        .      ...  .         . .   . .  . .      ...  ..   .        ...      . ..  . .. . ..    ..   . ...
.                 .    .    ..      .  .      . .   .   .. .    .    ...      . ..   ..      .  . .      ...
..   ..... .   ...   .     ..      . ..    .. ...   .        .. .    ...        ..          .    . .    .  .
.. .     ..  . ...  . .     .  .   .     ..   .. .  .   .  . .... .. ..   .  .   . .  .       .      .  . ..
.      . .        .   . ..   .         .. .      . .. .. .   ..   .             .   .     .  .  .        ...
..  . .     ...    ..    .               ..  ...  ......     ..  ...  .  ....  . ... .   .. .  .  . ..  . ..
.  . . ...     .     .. ..       ...        . .. . ..  .    .  .  ...   ..     .   .     . .   . .     . . .
..  . .  ... . ....   .             . .  .  .      .       .  . . .  .         ..   .        .  . . . .    .
.  .  . ....   .   .. .    . .            ...    . .    .  .   .     ...   ..     . ..   . . .  .    ..  ...
.    .  .     ... .     .  .     .        ..   ..   .  ..   . . .....      . .     .     .        .     .  .
.   . . ..                   ..   ..   .  ... .     .   .   .      .. .          .   . . .     .    .    . .
..    . .  ... .   .      .  ....   ..          . .   ..             . .       .     .    .           .  . .
.        .                 .  . .    ..  .        . .      ....    ..   .. .     . . .  .  . .  . ..       .
..  .    ..  .  .   ...  .  . .   . .     .    .  .   ..  . ..       . .    ..      . .   .. .   ... ..  . .
.  .  ..  .         ...      ..  .  .  . . .  ... ..  .    ..... ..     . .     . ..  ...                  .
..     ...   ..  .        . ...  . .. .    ..      .. .     ....           . .. .     .   .... ..       . ..
..    .   .    .  ... ...      .         .    .   .   .. ...      .. .  .. .  .  .   . .  . .        .     .
.     .       .    . .       ..  .  .   .  .       ....      ..         .    .. . .. .   .  . .        . . .
.    .         .. .     . .     .... .      .. ..   ...  ...   ...   . .  .     ....      .  . ..       .  .
.  .  .  .        .     .     .  ..    .    .  .   . ..    .     .  .     .      . . .... . ..  ...     ....
.... .   .  .   . .   .          .    . . ..       .       . ....     . ..  .. .   . .   .     ..   . . ....
.  ...  .   .     ..        .  ...  .   ..      .  .   .   ..     . ..        ..   .. . ..        .. ..    .
.   .   .. .        ... .  .         .   ..        .     .   .  .   .....   . ... .    .   .   . ..      ...
.  ..    ..      . .  ..   .            .. .  .   . .     ..            . .. .   ...  ... .            .   .
. . . .  . .     .  ..           ...       .  ..   .  .         . .  .  .   . .  .    .  ..      .     ... .
..  .  .    .  .    .  .      ....  .   . .. ..      .  .. .   .       .   .   ... .. ..   . .     .       .
.        .  .        .          .   .. ..  . .   .    .      .          ..  ....  . .. ....  .   ..    ..  .
..    . . .   .   .  .   .  . . .       .    .  . .    ...    .     . .        .   .. .  . .    . .   .    .
..        . .  . .    .   ..    . .   .   ..  .     .   ... .  . .  ..   .            . ..  .        .     .
.. .        .   .      ..     .  .          ...  ..    .  .. ..           . .    .  .  .  .   .   .  .   . .
.    ... .. . . ... . .   ..    .     . .  ... . . .        .   ..  .  .   . .        . . .        .   .   .
. .   ..    . .. .   ... ..     ..    .  .. ..       .   ...   .. ..... . .   ..    ....  . .. .. .     . ..
..  .  ... .  ..   .     .    .      .. .  .   ...   ..  .   . .  .. ..    .   ..    ....  ....      ..... .
.. ..  ..        . ..   .    . .          ...  ..  . .    . .     .      ..  .    . ..    ..   ...   ..   ..
.  .  .  . .   .  .   ...      . ..  .       .    ..  .. .  .      . ....   .     .    .  .  . .           .
.  . .       .  .  . .  .  .   ..       ..   .    . .          .   ... . .  .  .    ..    . .     .      ...
. . ..   ..     .  ..   . . . .   ..   .            .    . ...   .      ..   . . .  ..         .  .. ..   ..
. . . . ..  ..         ..   .... .     .   .. .        .    .   .  .  .    .   .    . . .      .  .   .    .
.     .. ..     ...  .  .        .   .. .. .          .      . . .  . . ...  .  ..    .  . .. ..    . . .. .
..       ..   ..   ..   ...    . ..       .      .     .      ..  .       . . ..   .    .  . .  . .  ..    .
.   .. .  .   .       .     .             .       ...    .   .   .        .  .    .  . .. ..    ..  .. .   .
... .    . .    ..  .    .       .  .       .   .  . .    . . .. .     .          . .. .   ..    .  ...    .
..   . . .       . . .... ..  . .   .   ..  .     .       ..       .          .  .  .     .  .    ...   .  .
.     .. .. ..    .  .. .  .    . ...         ...   ..  .   ....       .          .    .    . .      .    ..
.  .  . .  ...  .    ..      .       . .           .       .     ....  .          .       . .  .        .  .
. ...         .   .     .. .    ..    .       . . ..       . .       ... .  . .     .    .       ....      .
.    ..     .  . .   ..  .. . .      . . .    ..   .      .. ..    .    .   . .   ..   .          .     .. .
..    ..   .  .   .  .   .      ..  .       .   .  . . . .       .. .    .   .    .  .     .     . ...     .
..        .   .  . ...        . .   ..     .   .  .      .     .   .       ..  .        ..       .         .
.   .. ..    .     ...  .  . . ..     .       .   .   .   .                 .     .. .. .      . .        ..
.   .   .  ..     .    . .  .   . .. .   .     . ..  .. .    ..    .       ...   .      .  .    ... .     ..
. .   .  . .  .    ...   .  . ..    ..  ....     . ...  .  ..  ..  .  .  .  .  .   .   .  .        ... . . .
.    .    .   .  .       .  . .             ..  .   .. .  ..   .  .  ..  .. ..    . .        .  .  . ..    .
.      .   .          ...     .      .   .   .  .. .   .                    .    ... . .   .    . .  . ... .
...   .     .  .. .  .           .     . .   ....   .    .   .. .   .    .. .. .. ....    .. .             .
.. .    .      .    . .    .     .     .         . ..  ..   ...       .    . .     .. .  . .  .   . . . .  .
.   ..   . .    .    .            . .        .   .  . .          . .   .  ...    .... .   .. ....      . . .
.  ...   .  .    .       .  .   ...  .    ...  . . .  ..   .    .       .     .     .              .. .    .
.     ....  .      .      . .  .  ..  .      .. . .    ..  .          .       .  .           .  .   .  .   .
.               .      .     .   .        ..    . .             .     .                  . .    .      ... .
.         ..... .   .    . .  ..             ..    . .    .       .      .. .  .     .   .  ...  .. .     ..
. .        ..    .  .   .  . . . ..          .   . . . . . .      .     .  .. .    ...  . . ...         .  .
. . .   . .  . .     .   ...                 .     ..       . . .   .   . .   ..     .     .. .      ..  . .
. . . .  .  .       ..    ..   ...  .   .  .     .  . ....  ..   . .      .          .  . . ..     ...  . ..
.       .    . ...  .  .. .  . . . . .      ..  .          .              .     ..         .  .        .   .
..  .   . ..  . ..  . . . .    .  . . ..      . .       ... . .            .. .   .       ..   ..      .. ..
.   .   .  .. ..      .       . .         ...  .        ...    . ... .  .      ..      . . ..   .      ... .
.    .  . .    .        . .    ..      .   . . . . . ... ....     .. . ..  . ..  .    .  .   . .      . .  .
.   ..   .  ..       .  .  .. ..  ...    . .      .  .  ...  . .     ...  .   .  . . .. . . .  . . ..     ..
..  . .   . .  . ..  .   .  .  .        .         .  .    . .  .  . . .. . .    . . . . ..  ..             .
.   .  .    .        . .    .   .  .    ..     . .             .  .     ...    .    . ...  .       .   ..  .
..   .    .     . .  .   .   . ..    ..   .   . .        ....   .  .   ..   ...    ..     . .        .     .
.      .  .   ..     .  .. .  . ..          .    .. . . ..    .    .     .       . ..  .   .    ...   .   ..
.. ..     .    .      .  .  .  ...  .    ..         .    .          . .    ..     ..        .     .  ..    .
. .   .      .     .. .  .  .           ..    .  ..       . .   .  .    .      ....  .      ..  .    .     .
..      ...   .  ....   .            . .     .  .   ..  .    .  . .....   .      .   .  .    .      ..     .
. .      .      ...  . .. .       . ... .      .  .  .. .     .. ...      . ..                     ..  .  ..
.  .  .       ...  . .      ..   .         .     . .      ... ...    . . .   .  .   .. .    .. .      .  ...
..    .   ..  . .  .  ..    . . ...   .  .  .  ...     ..    .  .      .               ..  . .   ...  .    .
.      ..     ...                . .   .     .     . . ..               .    .    .. . .    .  ..  ..  ... .
..   ..   . .     ..   .  ..     .  .. .  ..   .  .    . . .       ....     ...  ..    .        .    .    ..
...        .   ..  .. .   X      .. .   . ..    .       .. .    .   ..  .  .  . .  ..   .. . .  . .      . .
.  .     .     . ...  ..  .     ..   .  .  .. ..      ..      .  . ..          ..   . .  ..   .   . . .. . .
... ..   .       .  ...  .  ..  .     .    .    .           .  . .  ..    .  . . .       .      .   .  .   .
.... . .   . ..     .   . .      .      . . . .    .   .  .   . . ..   .  ....    .. .  . . . . ..       . .
. .   ..         ...  ..   .  ...  .  .                     .    .     .  ....       .  ... ..   .    ...  .
... .  . .   ..       . . .      . .    . . .  . ... ...  .. .   ..        ..    .   ..     .  .      .. . .
.. .  .             . .  ..   .. .  . ..  .    .    . ..       . ...  .    ...  .. .   . .    .     .      .
. ..  .             .   .  .r      .  . ..          . .. .  . ..        .. ..  .. . ..   .  .  . .     .  ..
.  .        .          ..  ..    .   ..   .  .. .     . . . .    .   .. ..        ...        . .. .     . ..
...  .... .   ..   .  . .     .....      .  ...    .   .      .          . ..  ...  . ..          ..       .
..    .          .     . .   .     . . .    . . .       .  . .   .   .    .        ... . ..   . ..  .     ..
.     .        .  .        .     .    . ..  ..          ..  ..  ... ..      ..  .   .    . ...    .  ..    .
.               ..      . ..      . .     .  .  .    .          . .    .  ..        . .    .    .     .. . .
. .  .  .   ...   ..     ..     ..   .    .             ... .   .. .    .     .       ..  ..   .          ..
.  .  ..     .     . .   .      .    ... . .   . . ...      .      .    .  .    ..  .    . .. ..  ..     ...
.   .     . . .. ..     .. .        ...  .... .  . ..   ..  .   .. .. .  .. . .. ..    ..      .   .       .
.   .  .     . .  .  .  .. .    ..  ..   .    .   .  .    .         .. ... .  . ..       ..    ..  ..  . ...
.   .. .... .. . ....... . . .   .    . ..   .  . . .    .         .   .. .    .. .        .    ....   .   .
............................................................................................................
