.............................................................................................................
..  ..    .  . .. .  ....    .  . ...    . ..         .....        .                 .   .   .. ... .   . ...
. . ..  .   .. . .  .   . . ..    .      .  .   .   .  .      .               .   .  .   ..   .   ...  .  ...
..                .   .  . .     . .. .    ... .  ..          ..            .  .. .  . . ..    . .  .   ..  .
..    .   .  . .  . .  .  . ..   .  . .. .  ...  . .  .. .  .  .  .             .    .  . .  ..      .   .. .
.  .          .. .   .         . .       ....               .  . . . ..   . . .   ..       .      . .   .  ..
..  .   . .       . . .      .      .   .           .   .      ..    ..        .        . . ..       . . .  .
.      .... ..    . .  . .. . ...     .    ..          . .      ..  . .     .            .     . .. ..  .  ..
...     . .. . .... .. .    .  .   .  .   .  .  . .  . . ..  .   ..  .      .. .      . .   .       .     . .
..  .            .  . .        .         . ...  .. . . .  . .      ... .    .  .   ..   . .     .      . .  .
.       . ...        .. .              .. ...  ..   . .  . .            .. .. . .. . ..   .  .. . .     . . .
. ..  . .  . .  .  ...    . .  .     .     .     .   ..  ...         .   ..   .   .      . .  . . .    . .  .
.          . . ..  .     .. . .     .             ..      .. .   ..  .       .  .    . .  .   .    ..     . .
. . .   ..   .   .. .    . .. .  . . . . .   . .  .          . ..        .     . .   . .  ..   ..  .. ..   ..
. .       .  .  .    . . .  . .  .  .           .     . .   .        .         ...  ..    ..     .     .    .
.  . .. .  ...    .. .       .   .  .  . ..   .  ...    .      ..       . . .     . ..   .      . ..       ..
.      .      ...    .   .  .   . .   ... .....         .  .  .   ..  .     .    .  ..       .   . .    ..  .
.          .     ..  .     .. .  .   .    .    .    .   .     ...  . .  .    ..  .    .   .  .  . .    .    .
.          .  . .         .   .. .  .     . .  .     .  .          .  .    .. .  .  .    .   ..   .   .   . .
.  .   .     .     .  ...   .        .....    ..  ..             ..     . .  ..  .   . .         . .  .  .  .
.  ..            ..      .    .   ...      ..       ..   . .    . ...   . .         . .   .   .. .     . .  .
.    . ....  ..  .  .    .      .      .      .  .   .. ....   ... ..       .     . .  . .    . ..   . .    .
. ..  .    ...     ..  . .   .     .  ..  . ..  .  . .       ..  ..      .   .. .. .  .  .  .       ..     ..
. ..   .    . .  ...  . .  .. .    .. . ...   . .      . . .     ... .   ..  . . .     ..  . .     .        .
..   ..      ..  . .   .. .     .  ..  ...   .     . r                ....         ..  .    ..  .  ..  .    .
. ..    .    .    .    . .    .    .   . .  .   ..      .. .         .        . ..  . ..      . .. ..  .    .
...   . .      .  .   . .  .   ..  . .      .   .        .. ..     .  .. .  .  ..     .. .     ..   . . ... .
.  ..  .. .       ..  .  .  ... . .... ...       .  .   .            .   .. .  .           .   ..... ...    .
.  .   .     ..      .   . . .   .    . .     ..  . .. .  .     .    .    ... . .   .     . .    ..   ..... .
.        . . . ..      .        .  . .   .. .        .  .   .  . . .... .    .  .    .  . .. ..  .  ....  ...
.  .   .   . .          .  .    .. .  . . .. . ..      .       .      .  . .     .  . .              . .    .
. ....  .        .     .    . .    .. .    .    . .     .   . .    . .                .   . .   ... .  . .  .
.      .    ... .    .      ... . ... . ...       . .. . .       . .    .        .    .   ....     .       ..
....    ..     .       ...    . .     ...  . .   .. .. . .  .. . . ..       .  .      . .        .     .   ..
.     . ...  .  .    ..         ...     .   .    .    . ..... .   . . .          .    . .     . .  .   .    .
. . . .    .    .  ..         .. .    ..      .   ..         .......  .     .  . .. . .      .  ..   .      .
.        . ..     .    .  ..  . .  . .      ...    . . ...    .     .... .    . . . .    . . . . . .   .. . .
.    .  .  ......  ..  ..     . .    . ..  .     . ..        .  .   ... . ..     . ..    .  ..   .. ..  . . .
.   .   .     . . .   . .     ..  ..        .  . .       .    . . .. . .       .  . . .     .   . .     .   .
.   . . .   .  .  .      .  ..   ..        ..       ..           .  ..  .. .     .  .  ..    .. .  .      . .
.    .    .. . .     .. ... . .    . .       . . ..   ..  .    .    . ..  .   .  ..   ...       ....  .. . ..
.   .      .      .  . .    .      ...  .  .      .. .       . .    .. ..... ..   .   .         .  . .   .  .
. .  .. .. .   .  .  . .  ..   .     . .  . .. .   ..                .  ... ..  .   .     . .. .  .     .  ..
..           . .          .          .  .  .   . . . .....  .            ..  .. ...   ..   . ..     . .  .  .
.     ..    .      .     ..      . . . .   . .  ..  .      . . . . .       ...      . .   .. .  . . . .  .  .
..   .. .   .. .   ..    ..  .   .      ..         .    . ..   .   .    .. .. .              ...   . . .    .
.      .    .             .     ..     .     .           .  .           .         .           . . . .    .. .
.  .. .   ..    . .   .     . .   .   ...  ..    . .        . .    .   .  .  . . . .. ..   ..      .  .   ...
...        .    .     . ..  .   .       .      ..     ... .        ...        .    .   .             .  . . .
.     .   .             .  ....     . .. .  .  ...  .. .  .  .     .        . . .   .     .        . .    ...
.   .     ..   . ..  .    ...       .  . ..     . .      . ..  . .. . . .      .  ... ..  .  .. ...    .  . .
... .   .  ..     .. ..   . .     .  .   ...    .         ..   . .. ..     . .  .   .    .. .       .       .
. .          .. ....    . .     .     ..   .     .  .    .       ....      .      .   .   .   . . .  ..   . .
.    ..             .          . .       .     . . . .  ..      . .. .    ..   .       .   .  .      .. .  ..
..     . . . . .    .      . .   .       .. ..  .     .. . .       . .    ..       . ....   ..   .. .  ...  .
.. .       .       .  .  .  ..        .   .  .    ... .  .            .  ..   .     .. ..         .   .. .. .
.. .         .  . .       ..        . .. .  .      .  . .  .         ..  . .   .. . ..   .  . .        .  . .
. .      .  .     .. .    .          .  . .       .     .   .. .  .  .....   ..  .     .    .    . .  . ..  .
..     . .  .      .  . .        . ....    .   ...   ..           . .  .   .  .... ..  . . .   .     .  .. ..
.  .      ..     .     ...       ..  .     ....    ...              .. .     . . ..   .  . .. .       ..  . .
..  .   .      ..   . . .       .   .  ..       . ...      ..    . .. .    .   .     ..    .     .  .   ... .
. .. ..   ...  .        .     ... ..  . .. . .     . .    .. .     . ..    .  .  ..   .  .     ..  .        .
. .    ..     .   ....  ...  .   .   . . .    .   .    .    .  ..    .         .      .      .    .    .    .
...  .  . .   . .    .. ..  . .   . . .  ..   . ..      . .    . ... ..   . . .  ..    .  ...      .        .
..   .   ...    . .               .     ..     . .  . .     .      .   ..    .  .     .. .      ..  .. ..  ..
.    .   . .   .             .    ...    .   .   .            .    ..   . ... .    ..  ...    . ..    ..    .
.. .  ..   .       .      . . .   ..        ..  . ..  ..    .    ..       .  .   .         . .  ....  .  .. .
...    .  .    . . .        ..  . .       .. . .    .    .    . .. .. .  .. . . .     .  .  ...     ..  .....
.  ...   .     .      .    . .  ..   . .      .    . .  .. ..        .   .        ... . .  . .           .  .
.        . ... .  .. . .    .  .  .    .      ...     . .   ..    ..   .    .   ..     ..    . .  .   . .  ..
..       .   .       . . .     .   .        ..       .   . .   . .  .       . .....   .  .       .          .
.        .. ... . . .   .     ..         .      .. .   ..        .    . .    ..  .      .       .. . .. .   .
.  ..   .     .     .      .. .  .     .    .      .     .. .       .  .  .  .      . .      . . . .. .  .  .
.       ....                    .  .   ..  . . .  .   ......      ...   .        ..   .             . .  .  .
.      .   .... .     . . .   ...     .   .      .  ..    .         .    . . .. .            . ..         . .
. .       .. .  .  .        .   .    ... ...  .    . . ..        .        . .      .           ..  ..   ..  .
.     . . ..   .      .  .    ... . ...   ..         ..    .  .   .   . ..  . ...       .      ..   .. .    .
.   ..  .     ..   ..  .   . .  .    . ..     ... .     . ...   .  .    .. .... . . .   .      .       .   ..
. .    .  . . .  . .. .    ...     ..    .. .... . ..      .   ... .  . . .  .  .   . .  .  . .   .   .  ....
..      .         ..  .    .      . ..   ..  ..  ..  .  .    .     . ..  . .  ..   . ... ..     .  ...  .  ..
.   . . . .    . ...    .  .   .       .            .. ...  .. .   .      . ...   ..      ...     .     .   .
. .   . .  .  .  . .              .  .. .. .    ..    ..  ..  .    .. . .      .   .  .    ..      ..     ...
. .         .       . ... ...   ..    . . .  ..  .     . . ..    ..       .  ...   .  . ...   .     ..      .
.  ..   ...  .. ..        .  . .     .    ..     . . ..    .   .          .  .. .    ... . .          .  .  .
. ...   .     .  . .  .   .... . .. .      . .  .   ...  .   .     .  . . ..       .       .    ....      . .
.. ..  .  . ..       . .              . .  .  ..   ..       ..  .   . .        ......    . ...      . .     .
. .      .          .   .       . .. . .    .. .  .     ..     .  ..      ...       .     . .  .     .    . .
.     .. .   .    . .  .   .     .  .      .  ..  .   .  .      . .          .        .    .     .         ..
...      .     .. .   .  .            .          ..   .  .    . .  . .  .  .                 ...   . .     ..
.   . ...            .  ..    . . .  . .    ..   ..              .   .  .    .   .  . .     .   ..  .       .
.     . .   .     .   .   ..  .  X  .      ..     . ...    .       .  . .. .. .  ..   . ...   .       .    ..
.     .  ..  .         .        ...  .  ..   . .   . . .  .         .         .  .   . . .     .   . .  .   .
.     ...  . .. .. ...   ..  .  . ..        ..   . ...      .  .   .     .  . .   .     .          .   . .. .
...   .    .  .  ..   .          ..          .       .      ..   . ....       . .  .  .   ...  .   .. .     .
...   ... ..   . . ..   .    .    .       .    . . .           .  .        . ... .  .    .   . .  ..   .. . .
..     .  .  ..             ..              . ..      . . .   .  . .           ..    . . .   ...            .
. .            .      . ....   ... ..    . .  ..    .   .     ...   . . .  .   ..      . .    ...  ..   .. ..
... .     . . .       . ..  .  .           . ..     .   ..  .   .           .      . .. .... ..  .  . . .   .
.      .... ..  ..       .   ..   .  ...  .    .    .....        .   ..   . .  .     .  .    . .  .    ..   .
.    .   ..   . .  .     . .     ..  .    .. .. .  ..  .      .       . .     . ..  .            ... . . ....
.       ..     .      .. ..  .   . .   . .... ..   .  ....     ..     . .   ...      .  . ....    .   ...   .
. .    .  . .  .   ..  .          .  .   .    .    .      .  . .. . ....  .       ..  .  .    .. ..   .     .
..   . .  ..   .    .     ..    .    . .     .. . .           .      .               . .    .   . .        ..
...   .   .   .. .     ...    . . .   .. .   .      .. .. .   .      . ..    .. .    . .   .       . .. . . .
. ..         .....     .   .. .    . . ..         .         .  . .   ..   ..           .. ..   .   .. . . ...
. .  .        .. . .    ...    . .  .   ..   .. .   ..        ...  ..    .   .       .      ..           .  .
..           ...  .  .. .   . ..     . .     .     .  ...      . . .. . .  . .. .   . .  ..   . .  .  .  .  .
... ..  .   .      .     . .  ...... .    ..  ... .  .     .        .. ...              .. ..  .            .
.............................................................................................................
