..........
.  .  .  .
.   X    .
.    .. ..
.       ..
. . .   r.
.. .     .
.. ...  ..
.  ...   .
..........
