..............................................................................................................
.   ..   ...  .  .  .   .  .  .    .     .     .    .   .       .  .     .   .  .    .  .  . . ..            .
. . .   .  .    .         . .  .    .   .   ..    . .     .. .        ..  . . .     ..  .. . .  . ..  .      .
.  ..   .. ... . ..  .. .  . .  .              .        .          . . .   .    .   .   .       .     . .    .
.    .    . .  .  . .   ...  .....    . .    ..  .      . .     .        .    .       .         .     .    . .
..     .  .      ..        ...  .    . .    . ...         ..  .       . .. .         .  .   . .   ..  .      .
.    . .  . .  .          .  ..   .  .  . .      ....         ..      . ...   ...        .. .. ..  .. .. .   .
.              ...  .   ..    .   . ..     .       .   .     ..  ..       ...   . .. .          .  .     .   .
...   .      .      .  . .  .   .            ..   .    .     . .   . ..     ...     .   .  .  .       . .  ...
.   ..  . .    ..  ..       ...   .     .  .           ...  . .  ..   ..    ..  ..   . .. .        ...  ...  .
..      ..  .  .         .. . ..      .   .     .      ..  .     .       ..... .  . . ...     .    . ....   ..
.  . .  .           .  . ..  . .  .         .   ...  .. .     ...      .. ..  . . . .    .  .      ..  .     .
.. .  .    ..   . .. .   .. .. .....  .      . .  .  . .     .         .        ..  .    . . ..  .   ..  .   .
.            .....    ... .  .  .   ....    . .    . .  ..  .. .    .  . .. ...      .. ... .....  ..  ..   ..
.     .         .  . ... .. . .      .     . ...     . .   .      . .   .  .   .     .     . . .   . ....  ...
.    .   .   ..   . .           . ..   .  .. . .     .          . .  .            ...      . . .      ..    ..
.  ..     . .  .  .     .  .      .  .  ..  ..  .    .  .  .   .. .        . .  .            .    .   .     ..
. .  . .                              . .. .     ...... . . .. .  ..  . ..  . .   .  .     .      .  .       .
. ..       .. .  . .    .. ...     .    . ....        . ..     .    .. .    ...  . .. . .          .      .. .
.. .   .                  .  . ..      .    .   .....   . . . ..  . . . ...   .   .. .            .  .       .
. .      .    . ..   .        .    .   ..    .   . . .         .       .                    . . .       .. ...
. ..    .       .     ... .   .. .   . .  .    .  .   ..     .   . .. .   .     .      ..   . .            . .
.      .  .  . ..  .  .    . .  .   .. ..    . .   .  ...... ..   .. .          .. ..  .        .     .  .....
..     ..      .  . .  .    ..       ......    ... .  .     ..     ..  . .  ..  .   . .  .  . .  .  ..   .   .
.   . ...     .   .       .   . .   .  .  . .   ....  .. .    .  ....   .   ...  .   ..       .  .       .   .
.       . .  ..      .     ....        .  . .. ....        .         ..     .   . .  . .  .   ..      .   .  .
..  ...   .  . .        .  . .           .  ..    .       .  ....      .. ...    .    . .     .  .  . .   .  .
.   .    . .   .             . .  .          ..   .   .   ..        .. .  .  .   ..  . ..  .        .  ..  . .
. . . . .. .  ..      .    .      .  ... ..     .  .        ..  ..  .  ... ..    . .             ..  ..   .  .
.       . . .     ..    ... . .  .. . .  . ..         ......  . .  .        ..    .  .. .  ....   ... ..    ..
.. . .               ..  . ... ..   ...   .     . .   .. .        . ..      .. . .      . . ..      ..     . .
.. .         .  . . . .... .   .  .. . .     .    ..      . . .       .    . .        .        . .      . ....
.      . . .  ..  .     .            .       . .   .   .  .  ....  .    .   .    .         ... .             .
.   . .  .  . .  .   .     ..  . .     .   .. ..  . .        .      .. .. . .          .    ...     ..     . .
.  .  ..     .     .   . . .     ...   ..              . . .. . ..   .   .  . ...     .   ...  .   .  .. . . .
.   .    . .    .. .    ....    .. .    .   .   .    .        . ..   ...    ..          .  .    ..      .   ..
.  .    . . X   .     .    .  .  ... .     .     . .        . .   .     .. . .   .    .      .. . ..   . . ...
...  .    ..  . .  ..   .     . . .. .    .  . .   ...  .     .  .  .    ..  . . .   ..            .  ..   . .
.....     .. .     .   ..      ..           ..       . . . . .    .  .. ...     .   .      . .   ..  .       .
..   . .    ..     ... .  .       ...          .         .      ..  . .. .     ....    .  .  . .. .  .. .   ..
....      ...    ...     .     ..            .   .. .       .               ..  . .  .  .   .. ..   .    . . .
.  .     . . .      .   .          . . . .     . .  ..   .  .  .  .      . .            ..  .  ..   .. .. . ..
.   . ...   .. ..  .  .   .        .  .. ..  .  .  .    .    .  ...  .     .     .      .          .      .  .
.     ...      .    .   .    .      . .   .         .. .       .   .     .   .. . .    .         .  ...      .
...  .... .    .          . . . . .  .. .  . .   ... .         ..     .  . .  .  .       .           .. .  . .
.         . .  ....        .. .         .. .   . .   ..   .     .    ..     .      .     .  .  . . .   ..   ..
...    .. .  .    .....   . .    ..   .  .  .           ....      .    ..  ..     ..  .                  ..  .
.     ...  ...  .   .        .. ..          . .   ..  ..    . .   . .      .        . . .      . .      .  . .
.     .    .   ....       ..          .   .. ...   . .   . .    .  ..    . ..  .      . . .  ..        .    ..
.    . .   ...    ...  .  .  .   .   .   .   ..   ..      .  ..  ..     .     ..   ...    .       .   .  .  ..
.     .  .           .  . .      . .  ..    .      . .. .   ..  .  ..      .  ...     ...   ..      ...   .. .
.          ...   . .  ..     . . .  .    . .  .  ..    .... .  . ..    . .  ..       . .. .  .. .  .. . . . ..
..          .  .    ..  .  .  .     ..      ...  ..    ..   ..       .      ..             ..  .     .       .
.   .       .    . .     . .          . .    .        . .  . . .        .    .  ..   ..           ..   . ..  .
.  .. ..     ...      . .  .     ..  ... ...     .          .   . .  . ... ...     . .  .. .  .    .  ..     .
..    .  ..  ..      . . ... ..  .  .  .   . .                .        .  ...  ... .  . .      .   .         .
.            . . . ...            .     .... .     .  . .      . ...    .     ..  ..  ..         . . .   .. ..
.         . ..   ...       ...  ... . . .       .        .   . .  . .                                  ...  ..
...     .   . ..    . ....  . ..   ....  ..         .   .    .    .    . .  . .  . .  ...        . .      .  .
.     .    . . .    .       .         .   .    .. .      .  ..      .  . .      .    .       .  .     ..   . .
..       ..   . ...  ..     .   .  . .     ..  . .   ..    .   .  ..  . .      .  .  .            .   . . ....
.  .. ..         . ....       .   .....   .       .       .   .     .   . ..  .   ..  .  .. . .  ..      .   .
.    .     . .   .   .. . .   .. .  ..   .   . .        .   .      .      ..   . .       . ..  .     .  .    .
.    .   .      .  .   .     .       .     ....    .    .. .. .  .     .  .    .  .. .  .  .  ..  .   ...  ...
.      ..       . .  .  .  ..  ..    ... .      ...    ..    .  .. .   . .       .   ..  .  . . .  ..   .    .
...   .   .      .  ...    .. ...     .       . . .  .  ..  . .....    ....  .     .     .   .    ..         .
. . .  . .  .  .        .   ..   . .    .   . .      .. .        ....  .   .    .    ...  .       . ..       .
.  ..  ..     . .   .  ..      .. . .. .   ...   .  .  . ..     .       ...     .         .   . .    .       .
.   ..    .  . .. .  .     .   .  .    .   .   . .                 .. .   .    . .  . .   .  .      .. .   . .
.   ... .  .... .   . ..  .       .       . .   . ..       .  .   .    .  ... .    .    ..    .      ...  .  .
. .   .    .    .    ...        .      .  .   ... ... ...   .   ..    .     .        .     . .  .      .  .  .
.. . ..    .   . ..    .      .  . ..    ..     .  .    . .    . .       .      ..    .       ..     .   .   .
.    . .    .    .  . .   ..     .    .   .     . . . ..   ..  .   ..   .      .. .. ..   . ..   ...        ..
. .     .  .   .  . .  .  . .   . . ..  .     .. .  ...  ..  .     .  ...  .  ....  .     .     .   .     ....
.   ..  .. .      ..  ... . .        .. . ..     .  .  .   ..  . .  .. .    . .     ....    ... . .   . ...  .
..  .  .  ..                        ..    .   .     ..        . .. ..    ...     .             .         ... .
.   ..         .   .    .         .. .. .     .  . . . ... .      . .    . .  ..      .. . ..       ..   .   .
. ..       .   ..  . . .    .  . .  .     . .    ....  r. .     .  ... ...      . .  .  .....    ... .       .
.         ....  .     ...   .. . . .  . .     .  .  ..  .          . .   . .   .. ..  ..          .  .     . .
.  ..      .  .  .   .  .   .   . ..    .   . .  .  . .   . ..   . . .. ... ..                 . .        .  .
..  ...  .       .   .        .  . .     ..  ...   . .        . ...  ..   ..  .  .   .        .. . .  . ...  .
. .. .     ...  .. . . .   . ..         ...   .       . .   .    .. ..  . ..   ..  .   ..  .     ..   .      .
. . .. ..  . .  .     . ..   ..  .  . ..       . .    . .   .     .. .  .. . .  .. . ..    . .      .   .  . .
.      .         .    .  ..  .     ..  . .   .   .      . .    ..  .  ..   .   .   ..  ..     ..  .  . . ..  .
.    ..  .  .        .  ..     .        . .  ...    .    .... ..     . . ...       .. .  .     ...    ..     .
..  ..    ..... .          .  .. . ..    . ..      ... .        .         . ...   ..  .    .  .  .  ..   .   .
.        ..   .        .            ...      .              . . ... .  ..   . .       . . .. ......     . .  .
..     . .. .   .    .. . ..   ..       .     .. .   .    . .          .    .   ..   .  . .. .  .   ..  .   ..
.. .. .     .  .     .    . .  .    ..        .. .. .     .         . .  .     ..     .  .. .   . .  . .  . ..
..   .. . ..     .   ...        .       .  ..  .       .      .    ...    . .    .   ... .  .                .
. .  .  . . .  . .   .    ...        ..      .    .  ..  .      .  ...       . ..   .        .  .    . ... . .
.       .   ....  .. .   .     . .. .   .  ..        .   ..  ...  .      .  .  .  .     .. . .       .  ..  ..
.. . . .. .  ...    .  ..      . ..  . .      .. ....  .   .    .          .        . ..       .    .   ..   .
. .. .  .       ....  . .  . .  .  .     .       . .      .    .      . ...  .      .  .. ...   . .        . .
...           .  .      . .  . . .   ..     .   ..           ...  ...   .  . .        . ..  .   .   . .   .  .
.       . . . .  . .   ... .   .       ..     . .. .    . .       . . .  .   ..              .       . .     .
..     ..        . .  .  . .   .      ..   .  ...   .                 .  .  . .      .  ...      .  .  .     .
. .. .     ..   .         . .            . ....     ..    .. .  ..            .    ... .     .   . ..  ..   ..
. .  ..   .      ..     .   .       .   .  .  .            ..           .       ..  . .  .   .       . .     .
.   .   . .     . .   .  . . .   .  . .  ...    . .               ..   . . ..   . .. .    . .    .  .     . ..
.  .            .  .. . .   . .  .        .      .  .      .  .     .  ..        ..     .    . ... . .  . . ..
..   .. .   .    ..  .. .  .. . . .  .   . .  ..     .    .  .   .   ..   .   .. .   .      .  .    .  ...   .
. .   .    .   .       .   ..   .   .. ..  .   .   .. .       .    .         .  .  .  .  . . . ... . . .     .
.  ..    . .     ..   .       .. . .. .            . . .  ... .  .     .. .             .     .            . .
. ... .  .  .         .   .          . .      .    .   ..       .. ....   .   . ..   ..  .        .. .  . .  .
. ....   . .     .. ... .    .   .   .        ..   .   ..   ... .. .  .    .    . .. ..    .   .        .... .
. .   .  .   ..    .      . .   .   ..            . . . .   .   .  .. .. . .  .       . ..    . . .       .  .
.  .    .. ..     .  ..   .    ..  .        .. . ..    .. . ..  . . ....   .  . . . .    .      . ..     .   .
.     .    ..  .    . .  . .   .   . .   .  .      .     ..  .. ..   .  .  .  ...    . .    . ....   .   .   .
..............................................................................................................
