...............................................................................................................
. .      .     .    .      .   ..       .    .   .     ....            .  .   ..... .   ... .   .  .      .   .
. .       .        .   ...     .   .     ..         ...          ..     .  .  . .....    . .  .  .. . .   . . .
..       ...             . .   .   .  ..   .      .   . .    .. . .   . .    ..  .   .  ..... .    . ..       .
.  ..  .    .   ....   ... .  .          .. .   .        .  ..      ..      .    ..          .              . .
. .    . . .      ...     .  .    .   .. .      .   ..  ..     .. .   .   .   .    .      ..  .       .. . .  .
. . ... .   . .    .    .     ...  .  .      .    .  ..  ..     .    .    .  .  .     .  . . .  .    .     .  .
.     ...                ..         .  .          .              .....     .. ..... . .  .. .  .... .  ..    ..
. ... .  . . .   ..  .  .  ..  .    .   ... . . . ....    .. .    ... . .. .  .  .   ..    .     .  ....      .
.. ..  .    . ...       .       .. .     .     ..  .         ..  . .. .     ..   ..    .         ...         ..
. .       ..   .       .. .  .. .         ..              . .        .     .   .     .    . . .           . . .
.. ...     . .       .   .   ..  .  .  . ..   ..  ..  ..  ..      .   .   .     ..  . .   . .     .      . . ..
.   .  .. ....   .  . .     ... .      . . .             .  .. .   .  .  ..   ... .  .          ..     .      .
..        ...  ....  . ..         .    ..... .     . .      .    . .   .       .      .... . .    . .         .
. ... . ..  .. ..  .    . . .        .  .   .  .... ..  .. ..  .    ..       .  . ... .       .    ..         .
.    . .  ..   ..      ...        .  . ..      .         .     .  .    .    .  .      . ..       . ..  .   .  .
.  ...    . . .. ...    ....   . .          .    . ..  ..      .            .   . . .    ..     ..         .  .
.      .. .            . . ..   . ..      .  .  ... .    . . . .    .    . . . . ..        . ..    .   ....   .
.   .  .       .      .         .   ... ..         .    .  .   . . .   . .   .       ..   ..  .  .. . .. .   ..
. .   . .   .. .. .  .. .....     .  ...      . . .           .    .  .      .     .  .   .     ...    .. .   .
.    .. . . .  . .   .      ..    ..     .    .       .    .        .   ..  .   . ..  . .. .     ...    .     .
. . .      .  .   .    . ..    ....      .       . .       .    . ..         .   .  .     .    ..      .      .
.    .   . .     ....   .       .  . .          ..     . .         . .  ..  . .    .     ..           ....    .
..  ....     ..  .      . .   .   ..    ..     .               .      ..  ..                  .. .    ..      .
..    .   ..        .    . ...  . .   .   .    . .             .       .         .      . .    .  . ..   .. . .
. .  ..        .        ........     ..     ......  .  .     . .  . .   . ..  .        .   .   . .    .   .   .
.. .  .      ..   .  .    .       .    .    .   .  .  ..   ..   .   ..  ..  .. .   .   ..    . ..   ..   .    .
..   . .    .. .  . ..       . .     . . . ..  ..     ..   . ..    .   . . .   .            .  .       .  .   .
...  .  .     .   .   .        .  .. ...      ..   .. . .    .   .   .... ..  ..   .      ...  .. .     ..    .
.     . .       .    .    .      .       . .  .. .        .     .  . .         .    .  .. .  .  . .   . . .. ..
. .. .  .  ..     .    .  .. .  . .       .     ..  ..  .                  ...  ...      ....            ..   .
. ..   .  . .   .  . ...   .. . .             .   .    . .        . .     .               .     ..  .     ..  .
.      . ..   .   .    .  .   ...        .     .  .. .  .  .      ..   ...     .  ...   .      ..  . ...     ..
...  .  . . ..     . .     . .   .   .        . .    ...   .         . ..       .   .   .  .  . .  .. ...     .
.   . .    ..         .. .     ..   .   .  .   .   . ...   . .   ..   ..    .      .  . .  .       . .  . . . .
..       .        . .  .    .    .  .  .               .   .  . ..       . . . ..  .    .  .  .   . .   .   . .
..    .   .   ..  . .  ..  .    .  .  .. .  . ..  .      .  . . ...      . .  .   .... .    .     .. .        .
.     . .  . ..   ..... . ....   .    .. .  .  .  ..  . ..        .. . ..... .           .   .  . ...   .    ..
. ... .. ..  .  ..        . .     ..   . ..  ..  . ...   .  .   .    .  ..    .     ..           .....        .
.     . .    .. .   .     .       .    ...   .     ..          .      ....  .      . .  . . ... .      .  .. ..
.. .           .      ..  .   .        .    ..    .     .  ....       . . .  .         .   . .              . .
.      ... . ..   ..    .     ... .  . ...          ....   ....    . .   ..    . ..  .   .    .       .. .    .
.  .      ..  .       .  . ...  .... .  .    .    .        .    . . ....   .    .              ... .      .   .
..   .. .    . ...   .    .   . .        .        .  . ...    .           .          ...  .  .    .         ...
.     .       .     . . ...   ... .   .       ..  .  .     . ... .  .     .. . . .            .  . . .. ...  ..
.     .   .   .    .   . . .   .  .   . .      .  .   .     ....   . .              ..     .     .   .      ...
.. .       . ..   ..      .  ..    .    ...  .      .     ..   .  ..     .    .  ..   ..  .         .   .  . ..
.    . .  .   .    ..  .  ... ..    .      .    .  .. .  ..        .  .           .      ... .  ..  .    . .. .
..   .....   ..   .   . ..               .....  .    .  .           ..        ..  ..  . .   .    .    .     ...
.  .      .   ..  .     .. .         .    .       .             . ..   .. .  . .    ..  . ..   ..   .. ..    ..
. ..  .       .  .  .     ..  . ..  .. . . .   . .   . ..        ..  . ... ...       .   .    .      . ..  .  .
.. . . .    ..  .   .     .     ... . .     .  . .  .   .     . ..     . .... .      .  .   .   ..           ..
.. . .        ...    .. . ....   .  .           .   .  .        .           .   ..    .      . .  .. . ...   ..
. .          ... .  .     .  .  .  . .  .   ..     .... .... .   .   . .  .  .  .   ....     ..  . .     ...  .
.   ... .     . . .                ...      ..      .. . ..  .   ...     . .  . ..   .. .        ...  .   ... .
.    .. .  ... .    .  .          .  ..    . .           ..   ..  .   . ..  ...        ..   ...   .   . . ..  .
.        .  .       .      .    . .  ..         .  .         .... .     ....      .  .        .  ...  . .     .
.. ..  .....        ..        .     . . . ..     . . ..  .  ..    .          .  .  ....          . .    ...  ..
.   . .   .        .  .  .    .. ..   ..     . . .. .  .   . .  ...  ... ..  . . . .. . . ...  ..          .. .
.     .     . . .    ..   .. .  . .  .  ..  .       ....     . .     . . ...    .  . .  . .. .  ... .   .   . .
.   . .  . .    .  ..    .     .           ..    .    .  .. .     .   . .     .           .. .    .      .... .
..  .      .. .    . ..    . ..  .     .      .           ..     .     ..    . .  ... .       . .. . . .   .. .
..    ...    ...        .    .      . .. . .. ..     ..         .    ... . . ..    ....      .         .      .
..   .  .       .  ..    .  . ..    .. . .   .      ..  .    .      .    .  .   ...  .   ....    .. . ..     ..
..          .   .. ...  .. .    .      .        . . .   .  . ..    .   .... .. . .     .     .  . . .       ...
.       .       ..  ....     .       .     .. .. ..         . .  .  ...  .      .      . .      . .  .  .     .
.   ..          .    .  ..   .  .          .  .  ...  .    ..   ...      . ...   . . .. .   .  . .. .    . .. .
.  ..    .  ..  .     .  .          .  .      .. .     .   .  ..            . ...    .    .    .   .      .   .
.   .     .       ....     .  .  .   ..  .  .     . ..          . .    ..  .  . ..     .     . . .   . .   . ..
. .  .             ..              .             .  ... . ..  .      ..     .   .  .    .. ..  .     . . ..   .
. .  .  .    .  .. .   .    . .         ...  .  .   ...       ..  .  ..                    .      .   ..      .
.   .    ...  .  .     .        . . . ..        .       . .   .       . .      . .  .   .   ... .    .  .  .  .
.            .    .... ..      ..   ..          .  ..      .       .   .  .             .       .. . .    . ...
.   .  .  .  .  . ...         .  .  . .    .   ...         .      ...   . ..   . .    .     .     .    .      .
.  .  .     .    .    .   ..   .. .      .   .   .   . . ....       ..   .     .  ..     ..             ..  . .
.     .   . .   .  ..   .   ... .        .. .        ...    ..   ..   . .. .    .  . .  ..     .      . . ... .
..   .     .     ..  ..      . . . . .    .  .        . .        ...     ... .      .   .    .    . .   .     .
.  . .. ...    . .                    .. ..       .  . .     . . . . .     ..  ... .. .  . .. .  .         .. .
.       ..  ... . ..       ..    .          .  .  .        .    ..            ..   .   ..   .   ...  .     .. .
..            .    . . .   .   ..      . . .. .    .    .  .  .  . . .  .  .     .       ..                   .
. ....  .  .       . ...     . .  . . .   ..   ..    .     . ..  .         . . .. ...   .  .    . .    . ..  ..
.   ...  . . . . .                  .   .     ..         .    ..     .           .      .  . . . . .   .  ..  .
..       . . . . ..     . .. .. .        .  .         . .     ......  .  . .         .... . .     ..   .  .....
.  .        .  ..     .  . .   .  .       ..   ..   .    .  ..    .     ...  .. .. ...     .         . .  ..  .
.       .    .     .  .  ..  .        . .   .    .. ....       ..  . ..   .        .  . ..   .    .. . .   .  .
.  .          .  .. .     .          .. . . .      . .  ..     ..  .       .    . .  . .   ..  ...  .      . ..
..     ..    .   .  .   ..  ...  . ... .. .  .. r                   .    .  .   . ..   .      .  ..       ..  .
..  . ..  .  .         . .  .    .   . .  .  .    .   .. ...   .     .         .  X.....   .  ..  . .   ..   ..
.   .. .... .    .          .  .  .   .  . .... .      ..     .   .     .. . .. . .    ...       .    . . .....
.     .   .   ...   .   .       . .  .   .   ..   .      .   .   . ..      .        .            .  ..    ..  .
.   .    . .    .  . . ..     . . .   . . .   . .   . .  .  .  .  ...  .            ..      .   .... .  .    ..
..  .           ... . . .    .  ..     .   .     . .   ..      .  .  . .   ..    .   .    ..    .   .    .  . .
.     .    . .. .   .       .             .           ... .     . .   . .   .   .       .     ..   .. .  .    .
.....    . .  . . .. ..   ....  .         ..  .      .  .. .  ..   .  .  .. .. . ..    . .. .   .         . ...
...   .     . . .   .....  .   . ..          .  ..   .  .     . .. . .     .   . ..  ..       .. . ..      .  .
. . .  . .. .    ..   .   .        .         ... . .   .   .   .  .. .  .   ..  . . .    .   .  . .   .  .   ..
.     .          . .. .        . .  .  .    . ...     ..                . .             .  ..  . . .     ..   .
..     . .    .. ..  ...                  ..   .  .   .     .   . .  .  ..  . .      .  . ..    ...... ..  .  .
..  .  ...  .      ..   .            .    .    .   .  .  .  .     .  .  .       ...         .  .      ..  .. ..
. . . .     .    ...       .   .  ..  ... .     .     .  .   .     . .  .       . .   .  . ..  .  .  . . .    .
.....  .        .. .     .      .    ..      .. ....    . .   .      ..    ..   . .. .     . .  .. .    .     .
.. . . .. . .  .      .             . ...   ... ..  .        ..   .   . ..    .           . .     ..    .  . ..
..     .        .  . ...    .       .   . .  ..  ...   .  .      ..     .  . .    ..     .   .   .  .     .....
...      .  .  ......  .  .  .   ...    .    . .       .     .. .   ..   .    .    .    ...  ...        .     .
.   ..  .  .  .  ..           . .                    ...      . . .  . .    .  ..     ... .     .. .   . .  . .
. .    ...  . .  . .. .  ...    .    . . .    ..            ..  ..     ...  .  ...    .     . .. .       ..  ..
...          .   . .. ...  .  ..  .   ...       ..    .. .  .  .  ..   ...   ...  . .    .        .. . .    . .
.  .      ..     .      .    .  .      .  .  . .... .. .     ..  .     .      ..... .  . . .  .     .  .. . . .
.. .  .  .....    .. .... . ..     . .. ..     . . .   .     ..  .... ...     .   . .   . .        .. .    . ..
.  ..   .           .    . .    . ..  . .   . .  .  ...  .. ...         .....    .  ..    .  .  .     .  .. . .
...............................................................................................................
