................................................................................................................
. .  . .   .  ..     .   .             .   .  .  .  . . .  .   . . . .  .   . .. .    .. .   .     .  .   ...  .
. .   .. .    .  . . .              .. . .. ..    .    .  .. ..  .   .      .     ..  ..  ..    .. ..        . .
.  ..    .         .    . .        . . ... .     .          . .   .    ... .  ..  ..   .    ..    .     .     ..
.. .   .  .  .. .  . ..   . .  .     .      ..... .   .        .     .  ..  . . .     .  .  ...    . . .. .   ..
...  ..         .  .. . ...  ...   .  .  ....  . .         .   . .      . .  .       .    ..           .   ..  .
. .  .    .     .  .  ....      .     .    . .  ..   .      . . . ..        .   ... .  . ..    .  .   . ...    .
.  ... .   .   ..  . . .     . . . .  ... ..  ..  ..         .  .     .      . .                 .            ..
. .     ..        .    .  ..     .   ..  .  .   .     . .. .          ...  .      .    ..   .  . .   ..     .. .
. . . .  .     ..    .  .   .  .  .  ....   ..     .     ...  .  .    . ...  .               .       .    . .  .
..   . .      .. .     .       .  .     ...  .   .       .  .  .    ..       .  .    .. ..       .    ..       .
. .  ..  .    .    .    .  .   .    .   .      ..  .   . . .     .   . .         .   ..   ..  . . .... . . . . .
.   .   ...      .       .   ..   . .. .   . ....    .  .   . ... ..   . . .             .  . . .    ..        .
..    ....  ..       ...  . .  ...  .  .  . .  ..    ....  .     . .             .  ..   ..  .         .    .  .
.   .   .     .    .  .    ... .       .. ..     . . . . . .    .    ...   . .   .  . .  . .  .     . .   .    .
. ..  .        .           .   ...    .    ..   .  .  .    .        . .   .  .  .    .  ..       .  . . . .   ..
.      .   .    .  .     .  .     .        .  ... ..  ..    .  .. .. ..  .  ... .. .  ..   .    . .            .
.     .  .      .       . .       .   .    .      .    .  . .. .. . ..  ..        .       ..      ..  .     .  .
.      .  .   . .   .    . . .      ..    ...  . .. .. .  .  ....  .    . .   . .  .  .  .    .. .   ...       .
.. .   ..      .  .. .     .     .    . .. .. ..   .....      .   . . .      .           .     .  .     .     ..
..          ...  ..      .   .   .  .   ... .    .    ...    . . .  ..   ..  .  ..      .  .      .     ...    .
..  . .  . . .  ..    .               . ..  .  ..         ... .   .     . ..     .     .       . . .           .
.     . ..... .       .      .   .. .   .  .  .  . ..     .. ..    .. . .       .. . ..  .    .  .    ..       .
.  ..   .  . ..   .   .     ..   . ..      ..      ...  . .  .    .         .     . .   .        .        ...  .
.   .      .  . .      .  .        ..  . . .   . .    ...            ..   ..    . . ..   ..    .     . ...  . ..
.  .    .     .        .    . ..   . .  . .   .    .  ..     ...  .      ...   . .    .      .     .  .  .  . ..
.  .  .        ..           .  .  ..        . ..    .  .. . .   .. .    .   .        .. . . .           . . .  .
.     .  .   ... ...     .   .       ....  . ..   ..  ...      .. .  .. .  ...  ..    .        ..   ..  .  .   .
. . ....  . ..     . ....    .. .     ..     .   .... .       .  ..   ... .    ..      .   .           .       .
..      ..   .    .  . .    .  ..    .. .  .         ...    .  .  ..            . .   .      ..  ..  .      .  .
.  ...... .         .     .   . .        . . ... ..   .      .  ..   ...    .  .   . . .   .  ...    . .       .
.    .  .  .      .  .   ..   .  . .      . .. ..   . . ..   .  . .        .. .. . .     ...    .         .   ..
.. .    ....  .. . ..   ...  .  . .  .  .. .    .    . ...          ..   .          .     .. .     .          ..
. ...      . .    .     .  ...      .. . .  . ..          .. .  .   ..   r ..  . .. .X  .  .   .   ... ..   .  .
..                  .   .   .   .  .    ..      ..   ..   .   .    .   .    .           . .    .  .    ..     ..
.   .         ..  .   .   ....  .. .                . .     . .  .     . .    .. ..  .  .. .        ...   .. ...
. ..     . ..     .   .     .... ...  ... . .   .      .     . .   .    .. .   ..   .       .   .  . .    .   ..
..    .      .    .   .     .  .   . ... .  .   . .... ...     ..      .   .     . .    .    .     ..      . . .
... ...       .     .      . .. . ..  ..   .. ..  .. ..     .  .   ..   . ...   .  .   .  .. ... ..       . . ..
..     .  .  ....    .. ..           . . .  . .  . .        .  .    .        .    . .   ..    . . . ..  . . .. .
.      ..    .     .  ..  .  ..        ... .       .  . . . .   .    .       . .       ....   . .          ... .
. .   .   ..   .   .      .        .  .        . .         .        . .  .    .  .       ..  .  .  .   .     . .
..   .....  .  ..       ...  ..      .   .   . .... ..   .  ..  .       ..          .. . .        .   .  .  .. .
. .  .   .   . .   .        .       .   . . .  .   .    .   . .  . ..  ....   .   .     .. ..  .  . .  .  ..   .
.   .  . .            .   . .  .    .       .     . .      . . . .    .   .    ..  .      ....   . .  ...   .  .
... .  .. .     ... .  . . ..   .    . .     .  ..      .. . .    . .. .   .  .      ..  . ....   .    .... ....
. ...         ..  ..  . .      ... .  .  . ..  .      . .. ... .......... .      .  .. .    . . . .    . .   . .
.  .  ..  . . . .     . .     .   .  . .      .....    ..  ..    .       . .             . ..     ....         .
.    .  .  ..      . . . . .       . .   .. .            .         .  . .     . .    ..  ..       ...          .
...     .  .     .  .     . . .     . .  .   ..       .      .. . .   ..  ..    .   ..       . ... ....     .. .
.   .    .  ....         . ..   .                   ....   . .  .     .        ..    .  ..       . .  .   ...  .
.       .  ..    . .    . ...     .   ...  . . .  .   ...   .     ... ..    .  ..          .   . . . .    .... .
.            .     . .  ..    . ..   .      .       ..      .         . .   .  .          .     ...            .
.        .   .   ..    .  .  .    .. . ..  .   .  . ..     .      . .  .   .                       .       . . .
.  .  .        . .    . .   .. . . .     .   . .  ..      . .     .  ..     . ...      ..   .   ...  .. . .    .
. ...         ..  .  .   ....       .    . .   .  .         .     . . . .  .. .     .  .   .  . .    .    .   ..
.   .    .  . ..  .   .  . .  .    .  ..  ...    .    ..   .       .   .       .  .   ..       .  . . .. .   . .
.  . . .   . ..     . .   . .  ..    ....       .   .   .  ..  . ..        .   .        ..  ..     .  . . .    .
.  .  ...      . .     .     . .  .. .  ..  .         .  .  ..     .. . .. .  .    .         .  ..    .     .  .
. .      .    ... ... .  . ..     .         .  . .       .             .             ... .          .  .   .  ..
. .  ..   ... .    .      . .  .        ..    . . ..     . .  .     . .. . . ..   .. .  .  . .   .     ..    . .
. . . .          .   ..       .. .. .  .   . . .     .  ...    .  . ..  ..   . .. . .  ..  ..    . . .      . ..
.. .        .    .   .  ...  .        .  . . . . .  . .     .                  .     ..    .  . ..    .  ...  ..
.   ..  ....  ...        ...   .   . ..   .       . . . . ...  . .  .....     .    . .      ..  .  .   .    .  .
.            ..  . .  . .. .   .. ...   .  .       .  ...   . .  .  . . .  .. .  .      .    . ..  ...   . .   .
.    ..  . . .  .         . .. . .  . .     ..   . .. ..     .  .         . .         .  .. ... . .            .
.  .  ..      .   .  ..    .. . . ..  ..   .  ..   . .....       . . . .    ...       ..       .     .. ..     .
.       .  ..  . . .       . . . .  .     .    .           .  .  .    ..   . .   ..      ..  ... . . .  .    . .
.      .      .    . ...    ..       . ..        . . . ... .            .. .   ..   .          .        .. . . .
.  .      . .  .   .  .... .  .   .       .   ..       . . . .      ...     .  . . .   .   .. .  .    .. ..    .
..  ..  . .. .   ..   .     .   ... .   . .    .  .       .    .   ..  .    . .  .      .... .   .  . .   .    .
...    .  . . .    .       .        ..     .     .   .. . ..  . ..  ..   .          ..  .   .  . . . .     .  ..
.  .        .    .    . .        .      . .  ..  .  .. .. .      ..  . .       .    .  ..  .     .    .     .  .
.        .   ..     . .  .  ..     . . ...  .         .   .   . ..  .     .  ..    ..  ..   .  ..   ..  .. ..  .
.       .   .     ..  ..    .      ..  .  ..    . ...    .   ..  ..  .      .   .      . .  .  .        ..  .. .
.               .    .   .    ..    ..  . . .   .. .    .  .. .   ..           .  ..  . ..   . .  . ..  .      .
.   .   .  ..      ..   . . . .   .      .      . . ..            .  .       .  ....         . ...           . .
. .      .    .    .. . ..    .     .          . . .    . ..     .  . .    ..     ..  . ..       .  . ....   . .
.  .  .     .   . .  ..  .  ..      .      .    ..        .   ...  . .    .      .      .    .  ..         .  ..
. .     .  ..     .     . .  ..  . .   .... .   . ..  . . ..   .  .          .....  . ..      . .  .   .       .
. . .      . .     . .    .. . . ...          . .      ...  .   .     .        .     .. .    ..   .... .. .  . .
.  .   .   . .   .  ..   ..    .     . ..            .   ..     . ..             .        .      . . .         .
.      . .   .  .     .  . .               .. .   ... ..    . .     . ..   . .. .  .      . ...      .  . . . ..
.         .    .   .   .  . .    . .   ..               ... .   .     ..  .    .    . .      .. .    .  .      .
. .  .  .  . .   ...  .  .  .    ..  . .  ..  .       ..     . ..   .  . . .   .                .             ..
.      . .. ..  .        . .       .      ..     . . .. .  .    .   . .                 ..       ..  .  .      .
..          . .  ..      .  ..      ...   .   .     . .        .  .    . .  . ..          ....  .    .      . ..
.    .   .  .    ..    . .      .   ...   . .. .     ..     ... . .. .       .   .      .    .       .     .   .
.      .     ..  ..      ..     ..  . ...   . .  .  . ...   ....   .   .    .  .     . .  . .        .       ...
.  .  .        . .    .. .     .             .        .       .   .... .           .   ..      ...      . .  ...
. ..  .   .  .      .    .          .  .    ..  .   .       . .   .  .     .   .  .  .  .  . .       .   .     .
.. .        ...  ...  .   . ... . .  . ..          .      . .  . .        .   . ..   . . .  .  ... .  .  .. .  .
.         . .  .  ..    .     .... ....      . .   .  .        . . ..  . ..  .     ..   .. .  . .. .   .     ...
.  ..  ...  .     .      ...  ..   .  ..           ..       ..                     . .   .  .       .       .. .
..  .        .   .      .   ...    .. ..    ...  .....     .  .. ..     . . . . .  ..  .  .   .  .    .  ..    .
..  .       . .   . .  .   .. ......   . .  .   .   .                .  ..       .             ...  .       .  .
. ..   .   ..  .     .   .... .     .      ..     . . .         .  .   ..  .       .   ..    ..            .   .
.  . .          .  . ..   ..  .. .  ..    .  .     ..  .  .    .  ...   . .   . . ..  .      ...         .     .
.   .    ..    ..  .      .  ..  ...         . .  ..    .  ..  ...   .......  .  . . . . .    .. . .  . .     ..
.   ... .    ..   ........    ..    ..  ... .  .   . .. .      .    .  ..    ..   ..     . .         .     ... .
.          .   .    .   .   .        . .    .. .  .       .  . .   . . ..   .  . .  .   . .  .      .... .. .  .
. .  ..  ... ...      ....    .    .       . .     .      ..  . .            . ..   .   .       .          ..  .
..    .       .. .    .   .   .. .  . .   .     .    ...  .          ... .   ..   . .  .. .... .   . .  .      .
.  . . .  .              .           .          .   .. .. ..   ....   .  .  .. .. .    .   .        .  .. .   ..
. .  . ..  .       . . .    .. ..      .  ..       . .       .       ....     ...  .  .  .  ..   . . .      .. .
.   .. .. .  .. .   .         ..  .    .  .. ...   .. .     . .     .     . . .   . . ..    .   ...  .   .     .
.     . ..  . .  .   .         .  .   . .     ... . .    . ...  .  .. .      .  .  .             .   ..... .. ..
.   . .     ... .  .      .  ..   . .. .  .      ..      .      .   .. .  .   ..   ..      . .     .  .      . .
.     ..  ...  .  .     .     . .  .      .     .    .         .   .... . . .. . .     .      .  . .. ...  .   .
.   . .    .          .  . ..  .  .       . .    ....     . .    .         .       .. .     .       .. .   . . .
.    .    .. ..    ....   .       .  ..   .     . .   . .   ... .  ...     ..    .        .   .    .   .. . .. .
................................................................................................................
