.................................................................................................................
.    .. . .        . .    .  ..    .  .     ..       .   .        .  .      .       . .      .. ..  .    .      .
. .          .    . .    .   .  . . . .  .         .   . .  . .     ...  .    .  .  .  . .....   .     .      ...
.   . ... .    .  ..   .. . .                   . . .   ..     .        ....    .     .         .     .         .
..          .. . .  ..   ..  .      .      .    . .         .      ..     . ..  .. .  .   .    .    .  . ..  .. .
.        .    . .  .      .  . .       ...   .    . ..  . .   .         .    .    .    .   .   ..    .   .    . .
..  . .       . .  .         .  .     ..    .   .   .         . .. . . .    . . . .  . . .       .. .     . .   .
.         . .  . .  ...      .       ..            ..       .    .    .  .. .  ... .. .. .  ..  . .    ..    .  .
.    .  .    .   .     .  . ..     .  . .  ..     . .. ..   .   .              ...  .   .    .  .   .. ..   .  ..
...  ...   ..  .  ..    ...  .    ..  ..                 ..     .     . .  .  .. .  .   .     . . ..   .  ...   .
.  . .      ..    . .            . .. .   .   . .   . .   .. .  . .. .. .        .  .   ..   .    .     .       .
. .     .    .  .    .  .   .    . ..      ..  .  .    ..       .  . ..   . .  .. .  .   .  .. ..     ..        .
...   .          . . ...    .     ..        ..    . ...    .  .     ..    .           .  .   . .  ..  .     .   .
.  ...    .  .    ... ..            ...     .    .   ... .    . . .. .     . .          ..      . . . .    ..   .
.            .. .    .       . .        ..   .   .     .  . .      .    . ..    .  . .. .  ..    .. .. . ..   . .
.  .   . .          ..  . .  . .  .  .. . . .....       .  .     ..        . ..      .. .  . ..   . .  ..      ..
.  . . . ..     .  ..   .    ..  .   .   ...   ..     .. .. . . ..   .          .          .     .   . . .     ..
. . . .    .. . .                .. .     . . .    ..    ..   .         ... . .      ..    . .   . .     ... .  .
..X  ..  .. .. ....     .. . ..     .   .  .  . .  ....  .   ..         .        .     ... . .... ..   ..     . .
.  .   .       .  . . .   . . ...     ..  .. .    . . .      . .  .  ..        .    ....      .   . ..       . ..
...   .. . ..    ..     ..    .  .   . .. . .    .. .. .   . . .         .      . . .     ... .       .   .     .
.  .  ...   .   . .. . .....    ..  .  . .         .. ... .    ..      .  .     .  . ..   .   .    .  .  .  .   .
..    ..  .   .. ..      .  .     ..       .  .  . ....   .  .     . .  ...     ...  .    .  .  .     .   .  .  .
..  .          .  .     .   .. .         .     .  . . .     .. .... .. .. .  .   .  . .  . .     .       ... ....
.   .        ..   ..  .  ..   . .. . .      .....    .   ..    . . .      . .  .  .   ....   .       .          .
..   .         .        .   ..  . .. ..     .        .  .   .   . .   . .. . .   .       .   .  .  . . ... .    .
. .  .   . .       .   .   .. ... .   . .    .  ..                    ..   .     .  .   .     . .  .   .    ... .
....    . ..     .   .     .... ..    ..  .   ..  .  .     ..   .  .  ..     . .  ..      ..      .     .   .  ..
.   .      .    ..     .   . .. . .  . .     ..    .        . .   .  . . .  .   .  .          .  .   ..   .  .  .
.   .   . .     . . . . .   . .    .    . .        .     .    ..   . .     ..     ...      ...          ..     ..
.        .  .. . . .   ... ..  ..    .  .. . .       . .    .        .        ......     ...  .       .  .  .. ..
.. ..   .    .          . .. ...   . . .   . .  ..   .  ... ...  .   .  ..     .. .     ....  .  .     ...  .   .
. . ..     ..     ..   ..  .     .          . ...       .   ... . .        .. .. .. ...         ..  . .  ... .  .
..  ...  .  .   ......  ..  .       .  .     . .    .     .    .. .             ...      . ..      ..  . .  . ...
. ...       .. ..  .  . .   .   .   ..  . ...  .. .    ... ..          .. . . .      .   ..  ...     . ....     .
.. . .     ..      . .   ..     .. .    . .          .  .   . .           . .         ..         .   .    .     .
..    .      ..  ..         .  .         .  .   ... ..  . . .      .    ..  ..  .     . .      ..    .  .   .   .
..     ..      .  . . . .     .     ...   .     . .  ..     .....    ..       . .  .     .       .  . .       . .
.    . .  .    .  .       .   .  ..    . . .  .     ..  .. . .  ..... . .  .            .. .  .    ... .  . .   .
.  ..      .  . ..  .      . .   ...      ..    .  . .  .     ..    .     . . .  .   .           . . ..     .. ..
.    .. .     ..       . .    ...        .  ..  ....  .    . ... .   ..    ..           ...  . .  .      .   .  .
. .  . . .. . . . ...  .  . .  .     .      . .   .    . .    . .      .... .. ..    .. .. .  .. . ...    .    ..
.    ....  . . .  .  .   . . .    ..    ..  .  ..   .   . .      .       .    .   .. . .. . . .    . ....       .
.    . .   .     .. ....  . .  .    .     .  . .      ..    ..    . .            .   .  .   . ...  .. . ... .. ..
. .. ...     .   ... .          .  . ..      .                     .   ..   ..  . . .  .          .     .  .  . .
.  ..  .   .  .  . .  .     .  .     .. ..  ..    .      .      . . .             . .     . .  .    ..    . .   .
.. .. . . .. .   . ...   .   .  .       .        .   . .     .  .            .   .   .   ..             ....    .
.    .   ..   .. .  .    . ..    . . .  .   .  .  .....       .    .      .  .      ..       .   .. .    .  .   .
...  .. . .  ... .   .     ..      .         .  .        .. .  .  ..         .     .  .     . ...   .     .   ...
.    .        .  .  .       . ...   ..    .   . .         .   ...       ......    .. ..              ..   .. .  .
. .    . .  . ..  .        .   .    .  . .   ..   . . .       .    ..          .  .       ...  .  ..     . .    .
.   ..  .       .  .. . .      .    .      ..  ..                . . .       .  .    . .     . .  .      .      .
....     .  ..   .   .   . .    ...   . .. . ..     .  ....          ..     .   .    ...  .       .   ... . ..  .
.   ..  .  .  .   .    ... .     .   .   .      .   .      . ..   ..   .      . .    .....  .. ... .    .       .
..   .         ..       ...  .     ..  .. . .        ... ...            .. ..                    . .   ..       .
. .  ...     .. . .         .    .  ... .     .. ...   ..           ....   .  .     ....       ..      ..  . .. .
. ..   .   .  ... ... ...  ..   . .   .   .   . .    .  .     . .  .          . .. .    ...        . .  .       .
..   ...... . .     .      .    . ... .      .   .  .   .    ..     .. ....   . .    .             .     .  . ...
..   .    .. .   .   .        .  ..       .. .. . ..    ..  ..  .    .  .       . .   . ..  .. ..  . .  .   .   .
.. .      ... .           ....  ....   .   .     .       . . .   .             ....     .  .  .  .    . .       .
.    ... .. .. . .  ... .  .    .   .. .       . . . .      .   ..  .   .         .  .  ....      ..      . ..  .
.  . .           . .. . . .          .   .   .      ..        . . . . .      .         .  ......  .  .. .       .
.         .    .. .        . .      .      .    . .     .     .   ....  .    .  . .    .     ..     ... .. . .. .
. . r      ..  .   .   .    . .  .     .  .     .   .  ..         .    .  ..             .    . .      .       ..
.. ..      .  .  . .   . . .   .         .  . . .    . .       .       . .  .  .  .   .    . .    .   ....   ....
. . .  .  .   .. .    .   .  .   . ...  .   .  .   ..       ...      .           .    ..         .     .. .    ..
...    . ..  .  .. .  .. ... . ...  .  .      .     .   .     . .      . ...  .      . .  . .    .    ..   .  . .
.  .. . .          .     ...   .  .    .   ... ..       .   ..       .      .   .  .   ..  ..    . .  .  .   . ..
.  .   .  ..  . . ...  .     .. .   ... ..  .   .       . . .   ..        .    .      . . .      . .     .     ..
.     .  . .             .     ..   ...  ..  ........ .  ..    .   .      ..  . .       ....  .        ..    . ..
.  .  .  ..  .    .      .     . .. .  .  .     .          . .  . ..      .      ....        . .  .    . .  .. ..
.. .      . .     . .   . .  .   . ..   .. .                .. .  .   .. .     ...   .        . . .   .  ..     .
..         ..  . ..       .  ..        . ... . .     .. ...         .    .      .      ...      .      .  .  . ..
.   . ..   .      . .  . ...  . .    ... . . . .   ..       ..       ..    . .  .  . . ....   .  ... .       .. .
.        .           .   .        .     ..... ..  . ..  ..  .       ...   .      .   . . .     ..      . .  ... .
.         . .  ..         . . ...       .         .   . .  .  ..  ... .            . .  .   . .  .     .    .   .
.          .    . ..   ...      .     .   ... .     . .  ..  ..            .  .      .. .     ..        .. . .  .
..        ..      .  .             .         .    .  . .   ....  . . .            .   .      .  .         .   ...
. . ... ..      .        ..           .  ...    .. .  ..  ...     ... ..  .  . .  .. . . .. .     ..    .     . .
..     .        . .        . . . .      .     .          . . ..   .        . .    ..  .   .  . .  .   .   .   ...
..           . . . .  . . ..            ...   .    . .      . .  .     ..  . ..      .       . .       .. .  .  .
. .   ..        ...      .  ...  .    .    ..   ..  . .  . .       .. .        .. ..    .     ..        .    .  .
.       .        .    .  .  ..     . .      .  ..     .     .    .  . .   .   .    .    .  ..    ...  . ..    . .
. .... .      . .      . . . .  . .   .  .  .  . .   .   ..    . . . . .   ..         .   .     ...  ..      .  .
.              .   .      .     ...         .    . .             ...  .. .   ..    .     . .  ..    ...       . .
.  .. ...  ....  . .  .. .. .     .        .     ....    . . . . .       .   . . .. . .   . ..   .    .... . ....
..   .. .  .          ..  ...  .  ..       ...       .  .   ..    .. .   .......  .       . . ..  .  ..  .. .....
.     ..  .   .. .. ... .. .. .     . .     . .  ..         .        .   .   . .     ..        ..       .  .   ..
.. .. ..  .       .   .      .       .   .  .    . . . .  .  .         ..   .        .    .           .    . .. .
.   . .... .  .       .    .  . . .  .  ..  .. .  .  .       . .        .   .      .  .    .. . .     .  .... ...
. .. ...  .   .    . .            ..        .. .  .  .   .       .     .  .  .   .         .  .. .  . . .   .   .
. .        .      .  ...  ..   .  .  ... . .  ..   .      . .        .  .           .  .     .   . .    . . ..  .
. .   .  ..     ..      . .   .    .  .   .  .   .      .   .   ..     .      . .. ....    .  ..       .  . .  ..
.. . .        . .  .    .       .  ..   .....    .      .     .. ..     .   ..  . .     .   .  ...   .    .. .  .
. ... . . ...   .        . .    .  ..  .         .  .  ....  ..  ..  . .     .   .    .     .  .    . ...       .
..     .  ..  .. ..         .  .. . .             . . .   . ..    ... . .. ...     . .    .  .. ...     .  .... .
..     .  .  .   . .     ..    .  .. .                         ... ..    . .  .   .  ...  .. .. .  .    .    .  .
. .. .     . .        .  . . ....    .    . .         .  .. .  .. .     . .. .   .  .    .     .   .       . .. .
.. .  .. .     .   ..     . .   . .... . .  ... .               .   . .    .         ..      ...    .   .. .. . .
.     ..             . ...  ..     ....  .. ..         ..    .       ..       ..      .  . ..    ..    ...      .
. . . .   .    . . ...  .. .          ...  . .. . .     .  .   ...   .     .       .     . .   ...      . ... . .
.    ... ..  .... .   ..     .    ...    . .. ...    .   .        .  ..    .  . .       .     .   . ..  .   . . .
. .  . .  .   .   .      .    .   ..  .      .   .  . .  .      . .     ....  . .    .. .  .  ...    ..  .    ...
.               .   ..  .  .  . . ... .   . .        .    . .        .  ..          .     .  .   .   .. .    . ..
..       .         .                  .  .     .         ..       . .    .        ..     ..   ...      .   .    .
..   .       .  .     .  . .     .. . .  ...                .   .  .          ...  . .   . ..       ..    .     .
..        . .    .    ...        .. .  .      .    .  .    .      ... .      .    .    ..  . .   .  .   .    . ..
. .   ...         .   .  .  .     .      .   . ......   .     . ..    .          .   .     ..   . .. .  .     . .
. .   .     ..   .. .    .  .  .    .   .   .   .   .. . .          . . .. .  .   .   .. .  .  . .    .    .    .
.  . .    ..    .    . .. .          .  ..      .         .  ...     . .        .. ..        .  .  .         .  .
.   ... ....   ... ...    .    . . ..  ..    .  .   .   .          ....  .        .   .      .  .   . ..        .
.               .    ...   ..  .  . ... .       . . .     .        . ..  .           . .    .    ..    . .. .   .
.................................................................................................................
