..................................................................................................................
. .. ..                   . .. ...   .    .   . .....   .   ....    . .      .   .   .   .  ... .    .  .    .   .
.  .   . ...   .  . .          ...   . .                      .    ..      .     .      .           . . .. . ... .
. . .  ...    .     .  . . . .     .       .     ..                 .        .. . . .  .  ..   ..            ..  .
..  ..   . .    ..  .  . . .  .  ..   .   .  .. .  . .    .      .    .      ..    . . .   .. ..  ..     .. ...  .
..      .. .. . .       .    ...   ...   . .         . . ..     ..  ..   .      .  ...  . .    ..      ..     .  .
. ..  ..  ..  .....    .  . . .. .     ..    .  .         . .     .        .    . . . . .          ..        .   .
.    .   . .. .     .      . . ..    .     ..    ...  .   .  .     .      .              .      ..      . .   .. .
.   ..  .     .     .  .  ...  .  .  . ...      .  .   .  .. .  .    .   .   ..    .  .. ....    .. ...   ..   ...
.   .....   .    ....  . . .       .        .        .   . . . .   . ..  ...       .    .   . . .  ..   . ... .  .
.   .  .       .       .. ....     .. ..    ..        ..         ...    .    ..    .  .. ..   .. .     .     .   .
... . .      .... . .   .    .    .  .   .. .  ...     . .  .      . . .  ..     .. .  . .  . .. .      .....    .
..              . .   .   .  .   .  .     .. .  .  ...             .  .   .   ...       .. ...  .  .   ..    ..  .
..  . .  ...  .    .. . .  . .     ..  .     .  . ...     ..   .. ..    ..        . .      .       .  . .... ... .
.     . .  .     ..       . .  . .   .  .     .  .. . ..  .  ..... ..  .. ..    .    ....     .  ...   . .    .  .
...     .   .       .    .  . .      ..  ..    .        .           ...    .. .     .. .    .   .     .    ..    .
.  .. .   .   . ...  .  .      .  .    ..      . ..   ..       .    . ..... .   ..  .   ...  .      .    .   .   .
.     .    ..  .   .    .  . .      . .  . . .        . .. .... ..         .  ...  .     . .  .  .      .     .  .
.    .       ..     . .   ...       . .   .       .  .    ..       . .. . ..      r....  ....   .    . .      . ..
..    . .       .  . . .  .     . .. ...  .      . . . ..          .      . . . . ..  .. .    ...       . . .    .
.  .   . .     ..   .     .   .....  .   . .    .     .   . .        .         .     .        .  ..      ..   .  .
.  . ..... .  . .  .. . .   .    ....... .             ..  .  . . .      ..    ..    ...     ....  ...     . . . .
...  ..    . ..              . .     . .  . .               .    .  . .    . .       .    .   ..  .          .. ..
. . .. ..    .. .        ... .             .  .         .        .   . . .  . .       ....    ..                 .
.... . .  .    .      .    . .    .  .     ..    . .   . .    .    . . .     ... . .  . . .    .. ... .    . . ...
. .     .          ... ..  . .  ... ...         .       .. .   .  ..    .     .      . ..    ....      ..  .     .
... .  ..  ..    ..  ..       . .  . .     .   .    . .   ..   . .  .   ..    .  . .   . ..    .  . .  .        ..
.. . . .     ... ....  . ..                  .      ... .      ..    .. .    .. .   ..       ..   ..       .. ....
.... .. .   . ..      ....          .        . .. .   . . ...   .  .  .   ..         ...   . .      .. .   ..  . .
..          .. .  ..        .  .   .    .   . . .         .  . .   .   .         ..  .  .   .        . .         .
.    .   .  ..     .     .. .   ..          .        .         ...       ..        .  .   .    . .  .   . . . ....
... ..  .    ..      .   . .. .        . .      .       .  .. .  . . . . . .       .  .  .    . .  . .. . .      .
. ..     ..      .        .     ..    .  .    .. .    .     ..  . .     .  ....  .     .          .  .        .  .
.  .  .     .          . .    . .   ..   . .  .. .. .         .   ...   .  .     .       ..         . .       .  .
... .    .        .  .  .       . .     ..   .   .  ..      .       .. ....       .. ...          .       .. .. ..
.      .        .    ....            .. .. .   .     .    .   .  . ... .    ..  .     . .. . .. . ..  ..    ..   .
.     .        .    .      .    . .  .  .      . . .  .         ...  .   .. . . .    .  ..       ..        ..    .
...     . . ..      . .       . . .    .    . .. .     .      .    . .  ..        ....       . ..     ....       .
. .     . .      .     ..       .. .    ... .      .  . ...      .        . . ...  .     .    . . .    .. ... ....
.. .   ..                 .. . .     ...    .  .  .       ....  .  .    .       .   . .  .   .  ....  .  . .. .. .
.    .   .   .. .    .  . .  .         .  .   .         .   . .     .. . ....    ...      ..  . .         ... .  .
. .   . ...       .. .     .     ..      ..         .  . .   ... . .    ..          . . .   .        . .  .   .  .
...  .      ...    .    .  ..  .         . .  .   .        .. .  ..         ..   ..   . . .  .        .    ..  . .
.          ..  .  . .     . ..   ....   .     .  .  ...   . .   ..   . ..          .  .   ..   ..       .. . . . .
.   ...     .  . . .       .   .....   . .      . .....        . ..     . .   ..          ..  ..      .     ..   .
.. .      .  .. .          .......  .    .  .      ..  .      . .     .. . .   .   .. .. .    .  .  . .  .   .   .
.  .  .     ..   ...       ..          ..    .. .. . .... ....    . .  .  . .. .   . ..   .    .  ..        ..   .
..   .  ..    .       ..           .   .            .      ..   .    . . ..     .    . .    .    ..     . ... .. .
. .          ..  .  . ..    .      ..    .   .   .   .. . . ..   .      .   . .      . .  .  .   .  ..           .
. ..    .  ..       ..  .      . ..  .   .  . . . . .     . .    ..  .     .   .     ..  .  ..  .. .  .. . .     .
.       .          . ... .. ..        ... . .    .   .   .   .      .   .  .  . .  . .    ..     . . . .    . .  .
.    .  ...            . ..   . .   .       .      ..        .. .   .    .            ..    ..   ..  .     .    ..
. ..  ..  .. ..     .      .      . .   . .  . ...     ..   .        . .          . . .   .    .   .. .....  .....
.  .       .  .    .   . . . ..  ..     .     .. .    .  .    .       .  ..       . .      . . .      .          .
... .        . .  . .....     .    .        .          .  . ..   .      .. ... .    .. .. .    .... ..   . . .  ..
. .       ..    .          .  .     . ....    . ...   ... .  ..    .    .    .    . .   . . ... .    .    .  .   .
.  .. .. .. . .  .  ..  .  . ..      ... . . . .      .   .        ... ..   .     .. ..     .  .    .  .   .  .  .
.    .  .  .  ..   .   .       .  .  .  .   .    .  ..        .   .           .  .   . .  . . . ...    .    ..   .
... .     .       .. .   .       .      .      .  .        . . .    .    . .     ..     . . .    .         .   ...
..       .  ....       .. . .  .  ...  .   .  .    .   . .. ..  .    .   ..   ..  . . .    ..  ..  .  ..    ..   .
.     . .  .  .. .   .  . .. . .  . .    . . .     . .    ... .  ... ..   .                ...   .       ...   . .
.  . .   ...  . .  . .   .   . ...    .    .. .    .   . ..   .  ...  ..        . ...  ..         . ...          .
... ..          .. .   .   ..  .. ...     .  . .  .  .     .  .   ..     ... ...       .. . .   ..           ..  .
....     .     ...   ..    . .  .   .  . ..      .  .   ..     .   .        .    ...  .   .  ..    .. .        . .
...   ... . . .    ... .   .       .       .  .    . . . .     .  . . ..      . ....   .    . .   . .  ..  .     .
.  .    . . ...   .     .         ..   .    ..       ..       .   .         ..        .   . . ...  .  .    .     .
. ... .  ... .  .           .. . ...   . ... ..      . ..  .   . .. . .   ..                . .    ..    .  .. . .
...  .       .      ..  . .    .. .    .  ..     ... .     .  .         . . .    .   .   .   .   . .. .  . ..  . .
. .   .    .. .      ..  .      . .       . . ..       .   .  ..      .     .. ...      ..       . .    ..      ..
.    . .  . . . .. .   .   . .    .    .  .. .. .       . ..  . ...       .  .  .  . .    ..     ....      ..... .
.. ...   .  .  .   . .     .   .    ..  ..   . .   .   . .      .       .      .    ...    .    .      . . .    ..
..     .. ...         .      .   .  . ...  .       .  .  ..  .     .. .          ..   .. ... .  .  ....  .     . .
..    .    .     .   .     ..           ..  .. ..  .  ... .    ..   .   .. .    . ..    .  ..     ..        .  . .
.          .      .  .    ....    .    .  ..     .      .    . . . .  .  . .    .  .  ..       .     .     ..    .
. . .          .  .  ..      .  .    .   ..   . .    .  . .                 .    . ..  .  ..     .  .  .. . ...  .
. . . .       . ..  . . ..  .  ..        .  .. .          .    .  .    .  .   .  .    .    ... . ..     ..       .
.  .           ..  .   .    ..      .  .. .   . ..   ..   ... .     ..    .       . . . . .   .   . .      . ..  .
.   .   .   .   .        .        .   .       .   ..     . . .  .  .     ....  .  .  . .. . .       . .. .... .  .
.      .  ... .  .  .       ..  ..      ...      ..  .                 ..   .   .  ..   . . . ..        . ...... .
.  ..  .    ..          .  . . .     .    ..        ..             .       . .     ....     ....    .    .       .
.   .  .  . .     . .      ..      . .   .. .. .     .      .   .  . .      .   . .....   . .   .      .  .  ... .
.  .  ..    .     . ..  . .   ..  .   ..     .    .  .     ..  .   . .  ...        .    .. .      .   .  ...     .
..  .  .     .. . .         . ... .    .    ..   .       ...   .... .         .  ..           .         .        .
. ..    .       .  .   .      .    .  .          .     .  . .         .  .     . ..     .    .  . . .  . . ...   .
.  .   ..  .         .   ....      .    ..  .  .      .    .   .. ..     .   ..          .  .  .   .     ..  .   .
.  ..   .   ..   . ..        .    .    .    . . .  .  .   .             .   .. ...    ...  .  .  ..     .      . .
. ..        .  .              . ..  .  .   ... .  . ..  ..    .  . ...   ..     .  .        ...  ..   . .  .   . .
.   .    .       .         .     . .   ..  .    .               .   . ..  . ....  . .        .. .          ..  ...
. ..        . .    ..      .      .     .. .  .  .      .     .. .  ..  .      .  . . ..    .. .. .  .  .       ..
..      ...  .  . .  ..              ..   .        .        ..         .    .      .  ... ..           . ... ..  .
.            .   . .  ... .  ..   .   . .    .      .  .. . .   .  .     .  ...            ... .     .  .        .
.. . .. .   .   .    .   ....  . .  .  . .  .         .   X          .       .. .    .      .     .         ... ..
..     .       .     .         ..   ...   ....            .   . .  .. .  .   .  .   .   . . .            .     ...
. .     ..                 ..   ..   . .   .  ..    ....    ...     . .    .  .      . . ..    . .    .   ..   . .
. .  .     ..          .  .  ..    .   ....             . .     .  .      ..  .    . .. ... ..  . .      ..    . .
. .      .    .  . ..    .     .   .. . .    .. .    .    .   ...       . .  .    .    . . . .  ... ...  ..  . . .
.   . .  ..   ..  .. . . . ..         .   . .    .    .   .. .  . .    . .. .    .. .  .. . .        .  . .   .  .
.      .. .            .      .    ..   .      .  ..     . .   .  .        .       . .    .      .     .  . ..   .
. . .  .  . .....  .       .  .. ..   .    .. ....  . .  . .  .  .     .  .... .    . .  . ..   .     .   .      .
..    .   ..  .  .  . .. .  ..  .  .....     .   .   .  .    .         .        . ..  ..    .   ..   .     .     .
.              ..  . . ..    .  ..  .     ...     .  .       . ...   .  .  .   .  .    . .     .         . ..    .
.   .  .  ..   .. ..      ....    .      ..   ... ..    . .... . .. .  .   . .    .   .  .        . ... .   .  ...
..  ....    . .    .  . . ..   ...   .     .      . ..       ..  ..             .. .    .      .  .   .. .       .
.  .  .   ..  ..  .     ..           .    . .           ....  .    .... ...         . ... .  .   . .   . ..      .
.    .  . .  . .  .. .. ..    .  ..     ..    ..      ...     .         ...   . ... .                            .
.  . .        ..    . . .     . .  . ..    . .   .        .   .  ...   .    .    .    .         . .  .   . .    ..
.      .         .  ..  .  .  .. ..  . . .  .. . ..     .   .         ..    .       .  . .       . .     .  .  . .
.  .  ...      .   .    . ..     .   . .   . .. ... .      ..         .. .  ..   . ... .  ...    .    .   . .    .
.   .       ..  .  .           . . ...              .          .   ...  .. .  ..  .     .       . .   .          .
. ..   .          . .. ...   .   . .....   . . .         ..   ..   . . . ..  .   .   ...   .. . . ..    ...  .   .
.   .        .....         . .  ..  .  .  . .          .   .   ..             .            .  ....        .  ..  .
..   . . .    . ..   .   . .....       .       .   .       .      . .  .   .       .  ..  . .    .  .       .   ..
. .  . . ...   ..    .  .. ..  .  . .      .   .              .       .. .    . .   .     . . .     . .          .
..................................................................................................................
