...................................................................................................................
..    . . ..    ....    . .. .     .  . .    ......  . .       ..  .           .   .           .. .      .     .. .
...     . ...    .....  ...     .. .   .              . ..   ..  .  ..   . .. .   .. ..       .  .    ..  ..  ..  .
.. . .  .... .    .    .  .     .        .  .  . .  . . .  ..  .        .          .    .      .         . . . .  .
. .  . .    ...  ..   .   .        .   ..    .   .         .    ..   .          .   . . ..   .  ..   .     .   .  .
.      .         .           ....  .  .  . ..   .   ...  .   .    .  . .. .   ...   ...      .          . ....  . .
.    .   ..    .      .     .  . .      .       . ..   . .   . .   ...      ... .   ..   .  .    .  .   .  ...    .
.        .    . . .. .    ..  .    ..   ... .       .  .       . .     ..     ...   ..  .  .... ..  .  .      .  ..
.      . .     ...   ..     . .  .  .     .  ......  . . . .          .   . .   ......     ..        .  .    .... .
.... .. .  ...     .  .   .   . . .        .         .  .   .            . . .  .    ..      . .. .               .
. .   .      . ..         . .. ..  .... ..     .  . .    .     .    . .     . .....   .    .   .   .   ..  .    . .
..  .  .    .  . . ..   ..          ..     .   .... .     .      ..     .      ..    ..   . ...     .          .. .
..       . . .. .    .    ..    ....     .  .. . .     ..        .    .      . ...           ..  .   . .   ..   . .
.....  ..    .     ...           ..  ...    .   . .    .           .    .        .     .       .         .        .
.         .   ..    .   . .   .    .  . ..    ....  . .     .    . . .. .   ... .  .        .   .  .     . .   .  .
. . ...  .  .       .     .   ...           . ... . ..   .  ..  . ..    ..            .  ... .. .      .   ...    .
.                . .         .  ..   . .   . . .  .. ..          .   ...   . .   ..   .       .. ..   .        .  .
.. .... .. . .  .. .   . .   ...   .  ..          ..     .    .   ..  . .  ... .    .        ..  .  ...   ...  ....
.       . .       .  .        .  .   .. .    .   ..    ..  .     . .... ... ..      ..  . . ..    ..       ..  .. .
.   . ...   .  . .   . . .   .      .  ..  . ..    .               . ...      .  ..    .          ..   ..   .   . .
. .. .        ..    ..  .  . .   .   .          .. .  . .     . . ..   .   .     ...        .... .   .    .     . .
.        .. .    ..        .... .    .  . .    .    .   .   . . . .   .    .    .  .. ..        . .. . ... .      .
.. .      .       .. .  .        .. ..  .          .   .. . ...    ... .        ..  .     .   .. . .  .  .   .  . .
.    . . .  .  .     . .. . .  . .   . .    .   .      ..    ...   . .. .              .       . . .         ...  .
.. .  .. .    ..      . ..    .       ..   .    ..    ..   .  .    ..  .               .   ....       . . . .  .  .
.    ...     .    .  .  .     . .  .. .     .   .. .   . . . ..    ..         .   .. .... .   .     . ...  .... . .
.          .  ..                .   ...  . . ..  ..    . .. .      ..   .   .  . .    . .  .                     ..
.             .. .  ... . . .   .    .  ..... . . . . ..  .   .     . .   .       ..     ...     ..  .    .  .  . .
.. . .. . .    . ..   .    .    .   r          ..          ..        .  . .... .  .     .  .    . ..  .... .   . ..
...  ..     .. .  .  . .  .   .  ...   .   .   . .      . .      . .      . .          .      . .   . .    ...    .
.     .      .. .   .... . ...     .    .  .    .  ..  ..         . .....  ..    ..  .     .     .. .  .   .  .   .
. ...    .    ..   . . . ..  ..   ..    .   .    .        .   .  .   .  .   ..  .           . .. ..     . .     . .
.    .   .      ....        . .     .  .   .   . ..   .      .  ..  .   ..  ..  ...  .      .   ..     .   ...  . .
.   .     .     . .    ...     .  . .    . ..    . .      ... .  ... .       .  ...      .  ..  .  .    .... .  . .
.     . .. ..  .       ...     . .       .     ... .      ..  ... .    ..   .      ..  ..     .. .          .. .  .
.   ..   .. ..    . .    ..  .             . ...  .     .   .  . .   ..  .   .. . .   ..             .   .        .
.    .  .  ...       .    .  .                 .       . .  .      . .           ..     .     .  .    .   .      ..
. .  .  .      .  .        . . ..        . .  .. . .. ..   .  .  .        ....     .  ..  ... . . .  ...  .  .   ..
..   .     .. ..      .      ...  . .    .  .      .          .      X  ..        .    .          . .  .. .   .   .
.          ....          .   .. . ...  .     . .  ..  .  . .        .    .   . .  .  . .    . .      ..   ..  .   .
.      .  .     .   .    . ..   ...     .     ....    .. .               ...         .. .. . .    .    .        . .
.  .. .   .   .             .. .  .  .   .   ..  . . ..  .  ...          ..               .   ..       . .   .  . .
. .          .            ..   .     .  .. . . .     ... .  .   .....     ..    ..         ..      .   ... .    ...
.      .  ..   . .    .          .   .   .            .  . . .   .   .       ... . .   ..     .  .   .. .  ...    .
.   .     ...          .  . . .    ..   .       .   .  ..  .  .  .        . . .            .    .... ..    .      .
.      .. .      ..  . .   .  .  .  .        .  ..  .  .    .            ..      .    .   . .  . . ..  .     .    .
.       .     .         .     .   ..   ....        .     ..   ..  .     .  .   .. ....  .     ..   ..    ..   .   .
.    . .  ....  ...  .    .    ...    ....    . .    .  ...   .      .      .   .      .         ..      .        .
.. ..   .    . .  ... .         ..   .. .   . . .. .  .....   .  .    .  .  .   ...   .     .  .  ... ....       ..
. .   .. . .  . .    .....  ...  .  ..  . .. .   ...  .. .         .   ...  .     .   .  ... .  . .  .   . .  .   .
.   .  ..  .  .. ...     ..    ...      ... ..    . .. .. ..  . . .   ..   ..   . ...           . .    .          .
..... .  . .  .          . .         .  . .      . ..      ..        ..                 .    .. .    .   . . ..   .
..   ..  .    . . .    .  .  .   ...   ... .      . .   . ..     ...  .   . .    . .      .        ..   . .       .
.  ..     ...    .       .   .  ..     .. .    .  .  . ..     ...      .  .   .     .      . .  .   .. .       ....
.    .        .   .. . .  .       ... ..    .        ..   . .   .  .. .        ..  .    .  .  .    .           .  .
.. .. .    .      ..        .     . .  .    .  .   .    ..   .    .. .        .       .. .    . .       .   .     .
.  ..  .  .     ..       ..     .    .        .     . ..      ...  ..         .  .      .. .  .. .   ..  .. . .   .
.    .  ....  . ....     .  ...       ..     ..   .  . . .      .    .  ...   .     .  .  ..     ..      .   . .  .
.   .      .    . .      . ..    . .. .         ....   . .  . . ..  ...  .   .   ..   .  . ..     .  ..        . ..
.       .   . .     .   ..   .   .   . . .          ... . ...   . .  .         .       . .. . .  ..  .     ..  ....
.  . .   .      . ...  .       .     .  . ... ..      .  ..  . . ... ..        ..   ....  .    .  .  . ..     .   .
.  .        ..       ...   .  . ...  .. .     .          .  .   .     ..  . .           ..      .   .  .     . .  .
.       ...   .  ..     ... .    .   .                .... .    .      . . .  .. .     .     .           .  .. .  .
... ...  .    ..  .        .   . .  ....   . .  .  .  .. .   ..           ...    .  ..   ..            . .     . ..
. .    ..  ..     .         .   . .       .  .  ..  . . ....    .       . .     .. . .    . .   . ..   . .  .     .
.    ... .      .    .      ... .  ..  .    . . .  .    . ..   . ..       .  ...  .    .  . ... .  .  .   ..      .
... . ...          . .   .   . . . .  ..         .   . .  .              . . ..  .       ... .     . .            .
. .  .     .   . . . . .    ....   . . .     .            . .   ... .. .     .     .  . ..    . .    ....   .   . .
.. ....     .     .. .   .   .         .   ..  .     .        ..  .               .  . .  .             . .    .  .
.   .   .          . .  .    . . .   .    ..            ..      .       .    .  ...     . . .  .     .      .    ..
....  . . . .   .  .              . .     ..     .  .   .. .  . .. .  .  . .      .    . .....  .  . . .   . .  . .
.  ..     .        .  .               ..   .... . ..    .    ..   .  .   . .  .   .    .  .  . ..   ..  ..   . .  .
.  .   .   .     . .     .      ..    ..  .    . .     ... .  .   .  ..  .. .  ..     .   .   .    ..      . .   ..
..      . .   .. .       .. ..     ....               .     ...  ..       . .   .           .   . . .    .. .  . ..
.          . .   . ..   .  .   ..  .      .     . ..        .     .. ..   ...  ...       . .   .    .   .   .  .  .
. ..  ... . .. .. .      .      .. . .        ..      .. ..  .     .  .     .  . .  .   .              .  ..  .   .
.    . ....              .  . .     . .   .    .     .    . .  ..          ...  .    .   .     .. ..     ..  . .  .
. ..    ..   .  .    .  . . .   ... ..   .  .. .     ..    .     .. . .    . .  .           .. . . .   .. .  .   ..
..   .. .. ..       ..   .   .... ..       . .      .    .   .  . .   .     .  .   .. .      .      .  ..  .. . ...
.        ..    .    ...     ....      .  ... .    .    .      .   .     . . . . ..... .   .       .  .   .  . . . .
. . . .  ...   . ..   ..       ..  .   . .    ..     .         . ..  .... .      ..     .... ..       .   .    .  .
..    ...... . . .      .  ..     .      ..       .    .  ..   .  .. . ..      .  . .    ..  .     ..   .... .. . .
... .      .. .   .. ..  . .   ..  .       ..  . .       ..      .. . . .                  ..         . .   ..  . .
. .      ..       .      . ..       .  .  .. . . .. . . .       .        .       .   ..   .         .     .   ... .
.   . .    .   ..  .  .     .   ...   .    ..  .   . .    .       . ..   ...  ..      . . ..        .    ...      .
....   . . ..   .      . . ..   ...  . .   .. .. ..  .. . . ..     . .            .  .          .     .    .      .
. . .     .. .  .   .     .     . . . .      .   ..           .....  .        .    .  ...     .    . . .          .
.   . .  ..  .    . .   ..   . ..           .    ..      .         ... .   .    .   ...  .. . .   .       .   . . .
.. .  .  ..  .  .       ... .   .. .  .    . . .        ..                .       .       .  . .   .  .  .     .  .
. .  . . .. . ..  ..    .  .      . .    ....           .  . .   ..     .. .    .  .  . .     .    .. .     .. .. .
.     .  . .  .   ..       ..   .     . .     .      . .      .   .    .. .    .. . .          .     .. .         .
.    . .            .   .    .  . ..      .   .. .  .  .   ...  .. .    .       .      .  .  ..  .    .   ..  .  ..
.        .. ...    .  .   .. ..    .  .   .   . .   . ..  .  ..  .. .      .   .     ..... . .  .     ..      . . .
. ..  .  .   .     ..     .    .  . .    .     . .  . .  . . .              .  .   .. . .  . .           .        .
.   . ..        .   .  ..   . .           . . .... ..  .   . . . .  .           ..              . . .    .       ..
.    ......  .    ...   .. .              ..  ...    . .  . .   ...        . .      .   ...        ...   .   .... .
.     ..    . .    .....       .  . ... . ..    .  . .   .          .       ..     .    .  . ..  .    .. .. . ..  .
.    . . . .   .  ...   . .  .       .. ...      . . ..  .....    .  ..  .  .. ..             . .   ...... ..     .
.     .  . .    .  ..        .   .  .   .       . .. .     ...  .    . .        ...  .       .       .  .   ....  .
.   . .    . ..    . .  .    .  .  . .      .      ....       .  .     .  .  .    ..  ..     ....   ...         . .
.     . .   ...   .   . . .                    . . .       ..          ..      . . . .. .  .   . . .       . .  ...
.. . .      ...        .  .    .  .. ...     .  ..      ..  . ..    .   ..  . .       .   . . . ..    . . ..  .  ..
..     ..    ..   .   .  ..   .         .  ...  .   .     . . . .. ..    ...   ..    .   .     .  .       .   .....
.    .  .  .   . .. ..       .       .  . ..      .  .     .    ... .. ....   . .   ...   ..   ..    . . .  .    ..
...     ...   . ..    .   .  . .  .. .            ...        .  ... . .   .. .   .   .    .  ..          .   ..  ..
.  .   ..         .      .          .           .  ...  .           ..   .    .  .           . . .   ..      ..   .
...       .   ....       .     ..  .   .   ...   .      .  .  .       .  .  . ..    . . . .  .     ..  .  .  . .. .
. .     .   . ..    .       . .   .  .  .      .        .       . ..  ..  .  ...   ...   .     . .  .         . ...
... .   .    ... ..   ..  .  . .  .    .    .   . .  ..         .   .  .          . .          . . .....  . .     .
.  . .  .        .   .   .   . .      .         .   ..  .     .  .    . ..       . .  ..      .          .  ..    .
. .  .  .            .    ..   . ....         .   .  .        ..      .     .. ...    . ...  .   . .    .      .  .
.   . . .  ..  ....       . .     .. .  .  . .   .         .   .    .  ... .. . ...     ...   ..  ...  .  .. .  ...
.       .            . .       .. .     ..          .  .  . .   .        . .    ..    .  .. .  .  . .   .   .  .  .
.  . . ..   . .. ..   .     .       ..  .         .  . .   ... ...    .    .  . .     .  .  ...     . . .   .   ...
...................................................................................................................
