....................................................................................................................
. . . . . .  .   .    ...  .    .   .  .  .  . .   . .          .  . .      . ..   .    .    .  .  .      . .. .   .
.   ... .        . . ..    . .    .  ..  . .    .  .  . . .  ...   .  .. .       ... ...  .   .     .   . .    .   .
.  .  . ..  .            . .. ..   . . .  ..  . ..          ...     .   . ...... .   .      .  .        .    . . . .
..  . .   ..        .    . .           . .   .     . .  .    .         . ..  .  ..      . ...    .       .         .
.. ... .      .     .. .         . ... .  ..   .    ..  .        .  .      . ...     ...   .   .        ..  .   .  .
. . .     ....     .  .   .   .. .     .  .       .  .      .      .        .. .        .   . .  .       .  . .   ..
... .   ..  .    .    . ..  .  . .. . ..        .  .   . ..   ...  .   .         .     ..  . . ..       ..   ..    .
...  .  .     ..   . ..          .  .   .  .  ..   .     .  .          . .. .  .         . .. .    .   ...  .  .  ..
. . ..  . .     . .    .      .  .       .  .   .. .    .        .   . .    .              . ..    ...   . .   . ...
..   .    .. . . .      . ..     ..        ...   . .     .  .  ....   .   . ..   ..... ..        . ... .    .     ..
. .... .   ..      .  .   .     .  ..    .  . . .    . .  .  ..     .     .               ..    .   . . .    .  .. .
.         .   . .  ..... .  .     .  .     . ..   . .   .   .             . . .       .  .    ..   ..           .  .
.       ..    .. ...  .    .   .   .      . .       ..  .   .   .. .  .    .. .   .         .  .     ..    .   ..  .
.  .   .    .  .  .  .  .   .....          .. .  ...  .   .   ....   .  .       ..  .   .    .     . ..  .  ..  ....
.           .  .    ..   .    .        . . .  .                 .   .   ...   .   . .       .       . .  ..   .  . .
..     .     .  .    .  .      . . .    ...   .   . ..  ..  .  ......     .      .  . . .    .    . .  .     ..    .
..  ..     .       .   ..   .  ...  .          .... .    ...     .       .  ..   . .         . ...  . .....   . . ..
. ..   .    ...              . .    . .   ...       ....  ..   .             .      . . ..        .   .          ...
.     .. .   .      ..      .  ..    .      . .  ..  . ..     .        .    ...   ..         .     .     .  .  .. ..
..    .    .   ...       . . . . .  ..      .    . .  .    .     ..              .      . .. ...   .   .  . .     ..
.   .    .  ..     .   . ... ....          . .. ...      ..       .       .        ..  .    . .. .  ..       ..    .
.  .     . .      .   . .  .    . .   . ....    .    .   . .    .  ... . .   .         ...  .  .    .              .
..                 . .  . ... ....    . .     ..               .     .               .   .    .  .... .    . .    ..
.. .. .           .. ..  ..  ...   ..  .   . .  .   ..  .. .  .  .   ... .  . ..   ...         .. ..   ...    .   ..
. ..   . .   ..    .   .  ..    .         . .. .   .  .. . ...       ... . .     ..    .   .     .   ..         . ..
.       ..     . .          .   ..           .    .. .     ...      .      .     ....   .  .    .   .  .  .        .
..        . .  .         .    .    . . . ..   ..  .  ... ..  .. .    . ..  .   ..  .        . . .   .  . .. . ..   .
.   .     .  .     . .... .  . . .       . ...  .        ...     .        .     ..  .                      . ...   .
.     .  .  .   ...      .  .     .. .   .  .  .    .  ..   .  .. ....                ..    .         ..   ...   . .
..  . .     .. .    ...    .       .     .   . .     .    .  .    .      .    ..        .  . .          . .     ....
.  . .. .   .  ...  .    .       . .  .  .          . .          .     .            .  . . ..     ... .         .  .
.      . .  ..     . .         . .     .. ..          . .    .   ..  . .         .    .    . .    ..     . . ..    .
.     .    . . . .. . .  ..     .               .  .      ....       .  ..          .  ..   ..   .  . . . .        .
.. .. .    .. .  .   ..     .  ..    .    .  . .. ..          . . ..  .  .    . .. .        . .     .      .    .  .
. ...    ... ..             ...  ..          . .  .   .         .  .  ...   . .  ..... .....  .  .  ..   .       . .
....         .   .    .     .    . ...    .   .   .  .   . . .  .  .  ...       .  ....    ..                      .
.  .     .  .      . .   .  . . .    .  . .   .      .  . .. ...               . .  . . .         .      . .   . . .
.   .  .       .    .   .  . .     ..  . .. .  . . .   ... .   . .     . ...        . ..  ..  . . . .. .  . ..  .. .
. .. .  .              .   . .  ..  .   .  .    .  .   ..  . .   .   . .        . . .      .   .   .  .   .        .
.       .      .    .    .         .   ...      . .  ......   .    ..  ..     .   . ..  .. . . ..      .     .   . .
..   ..    .   . .  .      .. .. .  .   .  ..  ..  .. . . .            .   .   ...     .       .. ..  ..  .     .  .
. .. .. ....       .    .   . .        .         . .  ... .  . .    .       .      .    ..  . .. ..               ..
.    ..      .      .   . .              .  .  .  .  ...   .       .  .    ..    . . . ... . .   .  .      .    .. .
..    ....   .  ..       .. .  . .    .  ..  ..  . .  ..   .  . . .   ..     .   .        . ...  .   .     .. ...  .
.  .. .     .  .          .     .   . . .....           . .     . . . ..    ..      .  ..      .      .        . . .
..   .       .  ... . .... ..   ..          .. . . .     . .    . .    ..     .  .    ... ....   .     .   .      ..
. .      .    .   ..   .   .  ..   .    . . . ..             .  .       ....  ...   .     ..    .      .     ...  ..
.. .. . ..   . .. . ...   ..            ..     .           .  .  ..  .        .       . .          .   .   .. .    .
...  . .    . .  .  . ..          .. . .  ..        .    .  .  .   .. .          ..    ..     .  .    .  ... .   . .
.    .. . .           . .     .   .    .   .  . .     . ..        . .     ... ... ... .              .    .  .     .
. . .         . .       .      .   . . ..  . .     .   .              .   ..    .     ..    . ....    .  ..  ..   ..
. .     ..        .    .     .   ..  .   . .   .   ...        .....   .   .  .  .     ...  .. . .     ... ...  . . .
.  . .            ....   ...   .   .    . .  . ...          . .. .   . . . . .. ..     ..  .    ..      .. .    . ..
.    . ..      ..   . .   . .         ..  .   .. .  .. .   . .       ..          ..       .  . .  . .       .      .
.   .    .    .. .   ....  ..   .  . .. ..  . ..      .        .   .    . .  . .. .           ..      . .      .   .
... . ..   .  .     ... .    .  .   ...      . .. .  .   .  .     ..   .  .. . .. .           .  .  ..  . . .      .
..    .   . .  ...  ..            .... .     .      . .       . .  .    ...  .        ..   .    .  .  .  .     . ...
.  .   .  ..     ..  .   .   .. ..  ..    ..   .  ...  ... ...  . . .  .  .    ..     . .. .  . .    .             .
.   . .  .   ..   .         ...       .  .  .    .     .. . .. ..   .                 ..         .     .       . . .
.   .          .   . ..  ...       .. ...  ..   .  ..  . ...  ..        .. . .  .    .   .  .   ..  ..  . .        .
.  .      .    .   .    . ....    . .       .  .   .  .  . .  .   .    . ..   .             ..   . .  .     .. .  ..
. .  . . .      .. .   .. .     ..  .. .  .  .   . ..      . .  .   .   . .      .   .    . .           .   . ...  .
..   .     .      ... .  .    ... .   .. .  .   ..       .        .       .     ..    ..  ...  . .  .. .       ..  .
. .   .         .   ..    .     . .        .....   . .    .  .   . .   .      .   . .      . ... .   .        .  . .
.   . .  . .           .       . .  . . . . . .   . .   .            .    . .     .             . ...  .  .. .     .
.. .....    .     .           ...   .  .   .     . ..        .   .       ..   ..    .         . .. .  .  .        ..
...   .  ..  .    ...            . . .. . ....   ....      .  ..    .   .     . .  .          . .         ....   ...
.      ..     .  ....  . .  . ...             .. ..        .  ...  .    ..   .  ..    .  .  . . .. . . .      .    .
.   ..  .. .     .  .   .       ..... .    .  .    .. ..       ..      .      .   .       .        .     ..   .  . .
.  .       .   .     ..   .    ... . .  . .. .         .  ..       .  .  .  ..   . .  ..      . . . .    ...   .   .
.     .   .   ..           .  .       ..     ..  ...   .   .          .  .   ..  .   .  . .  . ....      .  .. . . .
.  .    ...   . .   ..    . . .  .   ...    . .   ..  . .. .   .   .      ..     .   ..       .  .  . . .     .    .
.....  .   . .     . . ..      .     .   .   ..   . .  .  .    ..       .. .   ..    .  .. ... . . ..    .         .
.    .   ..         .  .   . .     .   ..  .   ... ...   ..  ..   ..   .     .   . .  .        ...  .  ..   . . .  .
..     .   ..   ... . .. . ..      .   ... . .    .   ..    .     .   . .   .  .      . .    . .  ..    .         ..
.     . . .   . .   .. ......    ..   ..   . .   ...      .  .   .  . ..    . .   .  .    .  .. .       .      .   .
.     .     ...         .  . .  .  ..  . ..     . ... . .  .  .    .    .     .  . ....   .. .   .      .        . .
.  ..   ..  .  .            .. .  ..  .         .     .    . . .    . .         .       .  . .. ..   . .   .. ..  ..
.           ...      .   ..   .     ... .    .  ...    . . ..  .. .  .      ..   .  .        .  ... ..       .     .
. ..    .. .      .. . .  .  .  .  ... . .     .   .       .   ..   .    . .    .. ...    .       . ......  ..  ....
.    ..  .    .    .    .     . .  .    ......   .... .       ..    .  ..   . ... .    r.  . . ...  .       .  .  ..
.. .   ....   .   .  .    .         .  .     .  .      .     ..   .. .      .   .  . . ..   .      .  .    . .     .
...  .      .    . . .  .     .  .   .   .  .   . . ..  ..   .  .. . . . .  .  .. . ... .   . . . ..   .    .    ...
....         ..    ...   .   .  .. . .. . . . .        ..   .         X.      ..  .. . . .     .  . . ...  . .     .
.  . . .   ..   .   .      .. . .     ..       .. .         .. . ... . .      ..         . . ..       .      . .   .
.    . .  .           . .      . ...    . .       .      .     .. . . .... . .. . .  ... .    . . ....   . ....   ..
.  .   .. .        ..   ..   . ..  .   .......  . ..... . . .. .. .  .. .  .     .. .      ..            ..  .  .  .
.  ... ..  .       .  .   .   .  .       .. .  .               ..   .  . .   .          .  .    ..     .  . .  . . .
..    .. .   ...    .    .  . . .    .... ...   .. .. . . .. . .      .   .                .      . ...   ..   .   .
. ..  ...   .. . .    .     .  . .        . ..  ...        ..       .... .   .    . . .      .... .         .      .
.          .             ..  .       .  .    .   .   .  .        .   .. .... . .      . ..   .   .  ..   ..       ..
.  . ..  ...  .             . ..      .   .. .. .                ..    .. .      .     .   .   .   .          .    .
.. . .       . . ..   .. ... ..   .    .. .. ..    . . ..      .. .   .        .  .   .          . .      . .  . ...
.        . .     .. .     ..  .      ..  . .  ..  .   ..  .   . .   .         .. .    .    .  ...       ..    .  . .
.      . .      .  .  .       ... .    .    .   .. ...        . .  .  .   .  ..  .  .     . ..       .  .      .   .
..       . .  .     .   .        .           .  .   ..  .  .  .....  . .  ..     . .   .... .             .        .
. .. .    .    .  . .. . .  ...          ..      .  .     .  ..  . ..  .        .        .        . .. .. .  . ..  .
..  .      ....   ..        ..      . . . .      . ..  .    .  .      . ..  . ..    ..   .   .  .   .. .  . .  .  ..
.   .        .   .    .     .    .     .  ..         .   ..    ..    ..    .     .  .                .. . .  ..   ..
. .  .  .. .  .  .  ..        . ..  .      .  .    .   .     .  .  .       ..           .     . .    .      . .    .
.     .. ....   .. ... ..    .   .  .. . ..  . ..   .          ..   .    . .  .   ..        . .   .           ..  ..
.    .     .  ..   ..        ..   . .   .    .         ..           .      . . . ...  . .   .     .       .  .   . .
. . . . . .  . ..    .    .      ....  . ...  ..   .   ......   ..     ..  .    .       . .          ... . .   . . .
.  .            ..   .       . .   .  . .    . . ..  ...      .   . .    . . .     ..         .   .     ..     ..  .
.. .   .   .     ... .    . .   . ...  .      . .. .   .. ....     ..        .    .   .   ..  ..      .        .  ..
...   ..  .   ..       .   ...   .  .. .   .. . ....   .  ..  ..   . .    .   .  ...     .  .   . . .. . .    .. . .
.       . ..  ...    .  . .   .    .  .    .      .    . . .  .. .....  .    .  ... .   ..   . ..           .. .   .
.    . .         .. .. .      .  .  . . .   .    ...   .    .      .   .                .   .      .  . ..       . .
..  . .... .   . . . . .    .       .      .   .    . . .     . .     . .   .  .. ..   .     .      .      .  . .  .
. ...  . . .    .    .      .   ...     . .           . .       . .    .  ..   . .  . . ..   .  . .       ...    . .
.      .   . ..      .  .. .  .     ..  ..  ....  .  . .   .         . .    .     .  .           .  .  ... ..    ...
.  .. . .      .      .    . .  . . .    . .       .   .   .  .  ....  ..   .  .    ..  .    .   .  .        ..    .
.          ..  .   .    .        ..  .     ..   .  .  ..           ..  .              .. .  .         . . .  ...   .
. .  .   . .. .   . ..  .  .    .....       .    .. .  ...        .... .   . ..   . . ..      .   .   ..  .  ..   ..
....................................................................................................................
