.....................................................................................................................
... ..    .   .  . .     .    ..    .     .  . .  .       .   .   .      ..   .    . . . .   .        ..   .   . .  .
. .    .   .  . .      .     .      . .  . .. ..     .   .     .    ...  .      ..   . .     .  .  .. .   .. .. .   .
.  ..  .. ...  ..  .    ..       .  .   . .        .         ..    .   ...        .    .    . . .   .     .    ..  ..
.   .    .              .             ..  .   .    .       .... .   .   .      ..      ..      .   .   .        .. ..
. ..    .   ..      .          . ..         . .  . ...  ..    .      ..    .   .       ...         .    . ...      ..
.     .   .  .    .      . . ..   .     .    .   .. . ..   ..       .  ...  .    .. . . .   . .   .      .        . .
..  .     .      ... ... .             ..   . ..     .          . .. .            .       .              .. ..   .  .
.. . . .. .       . .. . .  .   .. . .   .. ..       .       .  ... ..  .  ...     ... ....   .. .    ..  .      . ..
.    ..  ..   . .   ..  .         . . .        .  .   .. . . .. .. . .      .   . .... .        .     . .  .    . . .
..       .  .    .  . .  .  .    .   .        ...  .   .  .   . ....   .  .  .. . .   .     .   .   . . .    ..   . .
.    .    . .. ..   .      .     ..  . . .        .   ..   . ..  .  .  .      . .     ...   . ...        .  .  . ....
.    . .  .      . ..       . .     .  .. . . .  .            .   ..   .    ..  ..   . .  .  . .  ..  ..   ...     ..
.   ..    .     .    .    .     .   .  .. . . .  .     ..      .... ... .     ...      .  . .      .  .   .     .   .
.  .  . .    . ... .      .     . .      .   .. . .      .   .  ..       . .     .       .    .     .  . ..   .     .
. . .     ..     .        .      .    . .    ..  ...  .       .  . . .      . ...   ..  . ...          .   .  .. .. .
..     .      . .   .. . .. .        ........       ..      .  .  .    ..  . .  . . .    . .  .  .     . .     ..   .
.. ..   .. ...    . .              .  ...  .        .   ..       .     .  .. . ..   . .  ..        ..   . .   ..  . .
.  .   .      .. . .  ... .          .   . .     . . .  .       .    ... .. . .     .. ...  . . . .      .   .     ..
. ..         ..     .    .         .   .      ..    ..     .     .... .  .  .  . .    .        .     .      .....  ..
..   .       . .   .   .   .. ...  .   . .    .  .  .      ..   ..    .    ..  ...   .     ... .. ..      .   .     .
. ..... .       .. ..    . ... .....  .     .. .     . ..  .     .      .      . .     .    . .     .      . .   .  .
.. .  .  .           .  .    . ..           .      .           . .       .  .         ..... .      .   .         .  .
. .   ...             .  .    .   .   ...  .           ..   .    .   . ...        ..    .     . ....  ..        ... .
. .   .  .   .    .       .    . . .  ...    ...  .  . .   .    .  . . .  ..  .    .... .  ..   ..  ..   .        . .
. ..   . .         . .       ....   ... .   .      .              .   .   . .  . . ... . .      . .     ... .  ..   .
.          . .         . .               .      ..   ...         ..   ...   .     ....  .     .    .     .      . ...
.         .  .   .      .  .  . .   ...     . .. .      . ..    .        .. . .    ... .  .  .     .  .         ... .
..     ..    .. .    ... .                  .  ..       .. . .    .  . .     .       .          .   . .. ..  . ..   .
.      ..       . .. ...      ... .  . .    .      .   .  ..          .  .. ...           ... ..  ..   .   .   .  . .
..  ...       ...  ..   .    .    ..     ... . . . . ..     .     . . . .....  . ..   . . .   .    . ....   .. .  . .
. . .  .      .  .             .    .    .  . ..  .  .    . .  .           .. . ..            .      . .. . .    .. .
. ..   . .     .  . . . . .   .       . .  .     .  .       ..    ..        ... .  .       ..    . ..     . .       .
.        .          .   .  .    .      .     ..      .  .  .       ..  . .    .     ...     . . .. .    .     ..  ...
..       ....  ..   .    .   . .        ..     . .          ..  .    . . .    .  ..  .      .   . . .        .  ... .
. .     .     .  . ..       .. .     ... ...         ...  .  .. .   . .     .   .  .      .     . ..    ..          .
.  .  ..       . .     ..    . .     . .   .     .    .    .  . ..              ..     .    . .  ..    ..    . .    .
.          . .  . . .   .  ...      .    .  .  .        ...     .             ..       ..  .    .   .   ..  . .  .. .
. ..   .  .       .  ... ..  ... .. ..   ..    .    .. .    .           .....     ..     .        . ..   ... .     ..
. .    . .   . ...       .      .. .     ... .. ...        . .     . . ..   ..     .     .    .   ..           .. . .
.       .   .  .   . . .    .    .  .. .  .     .   ....    ..  ...    .    ..   ..  . ..     .   ..  .  .         ..
. . .. . .. . .    . .  .    .     .    .   .   . ..     .  ... .   .    ..   ...       .   .   ..   .. .           .
.         .  .        ..     ..    .   ... . ...  .... . .  .  .   . . .  .  .       .. .      . ..  . .       ... ..
.   ..   .  . .   .        ..     .. ..      .      ..     .  ...     .   . .             .   ..  ...      .     . ..
.        ..    .          .  .    .  .      . ...  .   ..  .  .. .     . .. ..        .  .   . ..  .    .   ...   . .
.  .       ..  .    ..  . . . .. . .. .    ..   . ... .   .   .   ..      ..   . .   .      ..   .  .  .  . .     . .
.  .. .   . .      .    .     . ... .  .  .. .     . ........  . . .    .           .       ..  . .. .    .      .  .
. .. ....  .           .   .      . .      .  . ..    .. . .         ..  .    ..    ...    .   .        ..        . .
.      .  . ...   ..  ... .   ..   ..      .   .  .        .    . ..       . .  . . .. .       . ..    .   ....   . .
..  .....  .  ...   .  ..  .  .  .  ..    .. .... .      .. .     .      .  .   . .  .  .   ...         . ...     . .
..   .  .  .    . .    .  . .   .  .   .  .          .    ..  .   .       . .     ... .   ..     .    . .     .     .
.. .  . .  .       .    .         .  .  . .  ..     .         ..   .    .  ... .. .  .   . .  .       .   . ..  .   .
..          .         . ..     ... .  .   ..    .     .  ...     . .   ..... .     ... . . .   . .. .        .      .
. . . .. .  ...   ....      .   .  .. .   .  .     .       ..  .. ..      .   .    ..              .  .         . ...
... .   .. .... .    .   . .   .. .  .   . .  .  ...      .  .       .     ..           .    .   ...  ...    . . .  .
..  . ...   .      .  . .  ..  .  .      . .  . .      .  . .           ....  .        .... .  ..   ..  . .  .  .   .
..  .   .   .     ..      . .    .  . .. ..        . ..  .   .   .   . .  . .        .    ... .  .   .  ..    .. ....
.. .   .. . . . . ..      .   .        .         .        .     . . .    .   . . ..   . .         .  .              .
.         ..  . ..   .  . .   ... .   ... ... .       .. .. ..     .                       . . .  .   .      ..   ...
.  .  . .     . ..     .        .    .  .     . .     ..        .    . ...   . .. . .  . .   ..     . .     . ...   .
. . .   .   . .   .  ..      .       .   .  ..          .  ..  .   .   .   ... .  .  .   .               ...  .  .  .
.. . . . .   .  .   .    ..    . .      ..  ...      r  . .  .        ....   ..  ..       ..              .    .  . .
. .   .       .. ...  .. . . ..             ... ..  ..   . .   .  ..     ..... ..  .. .       .   .  .      .... .  .
.  .  . ...   .   ..   ..   ..  . .     .        .      .    .    .    . . .      .  . . . . ..   ...   ..  ..   .  .
..    . ... . .    ..  ..    .    . .  .  .  ..   .. .  ..  . ..  .              ..   ..   .       .  . .  ..     . .
.  ..    . .   .   ...  ...  ..     .  .    .        .                  .    .        .   .  .   .      .   .  ..   .
.   . .  . .    .     .   . .    .  .   ..   .  .. .  .   .        ... . .  .   .. ...      . .   .  .    . .  .... .
. .  ..  .    . . . .     .  .  ..  .  ..    .  .. .          .                .. .    .  .     .. .       . .  .   .
.    .          .  .      ..           .  .      ..       .    .    ...           ..  .   . . .   ..        ...    ..
..  .      .          ...     .                . .   .      ..    . ..  .  . .   .         ....  ..     .    . .    .
.   ..   ....  .  .        .    . ..   . .  .     . . . .   .. .. .     .   ..    . ..  .. ..        . ..         . .
..          .    ...         .  .   .  . .    . .. .    .  ...  .    ..    .  . . ..               .  . .  .   ..  ..
. .... ..  .      .. .  . .     .. ... . . . .    .     .  .   .    .    . .. ...       ..       . . .... .  . .   ..
. .     ....      .. .    .  .    .    . .         .   .  .   . ..     .     . ..  ..  .  .. .   .  . ..  .   .  .  .
..  .  . .         . .  .    .   . . .   .      . ..       ....  .    .    .  ..  .   . ..  .. .  .  .    .      .  .
.    .   .   . .  .   .      .     .   ...      .     .  .      .     . .     .    ..    .      .  .  ..       .  . .
. ...    .    ..    .  .  .    .         . ...     ...   . .           . X .       .     ..     .   ..   ...     .  .
.. .          . . . ....      .. .    ..   ... .  ..   .    .    . .    .   .     .     .   ..   .     . .. ...     .
..       ...  .    ..   .   .       . ...  ....       ..   .   . ...      . . . . .       .  ... ..     . . . .   . .
..     .      ..     ..        ..... ...        . .      .     .   . .     . ...        ..     .  .      ..   .     .
..  .   .     .      . ... .     .    .   .  ...     ..  .  . .        . . .. ..          .    ...     .   .. ..  ...
. . .      ..    . .    . ...   . ..  .      .      .. . . ..      . ...     . ..    .        .. ..     .    . . . ..
...  ...   .         ..  ......    ......  .            . . ..  .... .       ..   ..    .     .        .  .... .    .
. .. .   . .  ..      . .  .  .  .           .... .   .            .   .       .... . .   . .  ..   .. .  . .       .
.   .  .            .   .  . .     . .      . .      .. ...   ..    . ..        .. . .. . . ..       . ..    .      .
. . .     .        . ... .     . .     .  .. . .   ...   .     . .    . ...     .        .     .  ..     .     .. . .
. . .       . .       . . ...   .   . .  . .   . . .   ..        . . .     .    .      . ... ...  .. ....   .       .
.    . .         . .  ..   ..  ..    .  .   .        .. .   .    . . ..   . ..  .        .. .        .   .   ..  .  .
.  . .       ..    . .. . . .. .        . .  .    .  .   ...     ..     .  ... . . .  ..    ....       ...          .
. . .   .   .    .  . .. .     ..   . . .        .    .  .    ..    .....         .      ...   ... ..      .        .
. .      ...  .    .        . ...       . .. .       . .       . .       ..  .  .  .    . .       ..     .    . .. ..
.  .     .        .. . .   . .   ...    .   .. ...     ..  ..    .. . ..   . ..        . . .     ..        ...      .
. ..     . .    . .  .        . .           .    ..  ..  .  .   ... .  .            .     . .      . .  ..    . .  ..
.  .   ...  .. .   .  ....    .  .      .   .           . ..  .  . ... .          .   .  .  . . .  ..   .      .   ..
. . .   ..  .  ...  .   ..       .    .   . .    .   .     .   .. ..  .    . .    .  ...  ..       ... ...   . . .. .
.         ..     .   .            ..      . .     .       .  ..    ...    ..  .              .           . .. .. .  .
.    . .   ..  .   ..                     . .      .  ..  .. .    ....  ... .    .. .. .   . . .    .  .    ...   . .
.     .   ... ... .  .   . .. .  .   . . .       .           .     ..  ..     .   .        .  .        ..  . ..     .
... ... . .     .   .     ..  .  . .. .. .    .   .  .  .   .     .   .    . .   . ..      .. .  . .. .    .   .  . .
..    .   . ..        . ..  .        .      .   .  .  ..   .   . ..    ..  .   .        ..      . .        .. .   ...
.    .... . . .           ...  ....  .     .. .      .  .   . .  .   . .   .    ..  .  .  .     .. .. .           . .
. . .   .     ...     . .     .  ..      .           .         ...      ...     . . .        .               .  .   .
.     .    .    .  .   .  .        . .  .     ..      ...   . .    . . ...  ... .. .       ..         .     .   .. ..
.   . .   ..  . .  ..    . ... .       . . ..    .  .  . .   ..   .         ..  . .  .    ..  .   .    ...  ..  ... .
.   . .     . ..   . .        . . .         ..  .    . ..       .     .. ..  . .  . .          .  ...     .   ... . .
.   ..  .         .  .                  ..  .        ..   .    . .    ..   . .         ..       ..  .           ..  .
.       ...  .    .    .        .  . . .  . .     .               .. .  . ..       .     . .  .      .  .. .. ..    .
.   .  .      .    .     .  ...  ....  .. .   .     .  .  .       .  .                    .   ..  .     . .  .   .  .
. .   ....   .     ..       .     ..         . ..   .  ....       . ..     .. ..   .         ..  ..          ...    .
..   .     ..   .    .      . . ..     .  . .     ..  .       .    .   .   ...  .      . .  ..  . ...  ....  . .  . .
..  ... ..     ..   .   . .   ..    ...  .    ..       .      .... . .       .  ..    ...  .   .     .   . .  . . . .
.        . ... .. .       .   ... .  .  .  . ..   .     .  .   . .      ..  ..     .    ..     .                    .
. . ..         . . ....         . ...    . . .  ..   .. .       .        .   . .        .          ..     .    .    .
. . . .   ..   .   ..      .  .   ...   . ...         ..   ..    .        ...   . .  . .  ..  . . .    ..    .  .. ..
. . ..  . .  ..   .  . ...   .  .      ...     ..    .. .   .   ..     . .. ...   .  .     . .         .     . . .. .
. .. ....    . .   . . .     ..   . ..      ..          . . ..   .. .  ..   .. .      . ..    . .   .    . .     .. .
.....................................................................................................................
