......................................................................................................................
.   . . ...  ......        . ... . ...    . . ....   . ..        . .. . .    ..         .           . .  X           .
.     . . .   .  .      .      .  .   .. .    .   . .           ..  .. .  ..  ..    ..   .. .. .          . ....   . .
.  .     . .  .     .    .... .     .       .  . .      .      .    .. . . . ..  . . . . . ..    .  .         ... .  .
..       ..  .    .     . .. . .  .  .         .   .      . .    .     .    . . .        . .    .  .   ..      ..   ..
... ...   .       ... .       .        .       .    . .      .  . .   .       . .   . . . ..  .      .  .. . .   .. ..
. ..      .. .  .  .... ... .  .         .. . ..      ...  .         .         .                  ..    .    .     . .
.     .  . .     . .   . .  .   .          .     . ..      .. .     ..         .   ..   .           .. . ...     ..  .
.  ...   ..    ..    . .  .   ..   ...    . ..  . ...  .         .   .   ..   .     .  .   .  .      .    . .  .  .  .
.   . .             .  .   ..  .      ..  . .   .   .         .           ... .   .   ....     ..  . .. ..          ..
. ...  . .            .. .      . .   ..  .     .      .    ......    .     . .. . .   .   ..   .         .   .      .
.           . .   .    .      ..              . .   ..  .  . . . .....      ..   . . .      . ....    . . .   .  .   .
.... . . .   ..    . .  .  ..   ....  .. .           .    .     .       . .   .            .   .      .   .. .     ...
.   ..   .   . ...  .  .. .. .     .  .    . .  . . .         . ...   . .  ... .. .....    .  .                .     .
.           ..    ...    .  .  .  .  ...    .    ..   ..  ..    .    .   ...  .. .  ..   ..  .   .. ..   .  .     .  .
.  . . . .  .  .. ..  . ..              .  .    . . .     .. .  .         .  .        ....    .   .           ..     .
.     . .       .              .. .     ..      .    .  .       ....     .. ...  .      .. .. . ..  .     ....    .  .
. .  .   .    .  . .. .   .                  ....  ..  ..    . .  .  .  .  . ..   .     .  .. .   .. ..   .    . ..  .
. ... .    .         .     .   ...    . .    .. .    . ...   . .... .   ..       .....  . .   .    . .  ....  .. . . .
. .. ...  .   .         .   ..     .    . . ... .. ..  ..       .      .   .     ...  ..  . .       ... .. ...   .   .
.    .    .   .   .  .   . ..          ..             .. .   .          ...       .  . .   . ..     .      . .       .
.    .  .  .        .  .  .  .   ..  .. . .  . .. . . .  .     .    .   ..             ..  .   .           . .      ..
...  ..  . . . .. ..   .    .   . . .    ...           .  . .              .  .  .   . .   .     ..     .   ...    ...
. .     . . . .   ..   .          . .      .   .  . . .   .  .    ..  ..  .. .  ... .       .    ....  .  .   .   . ..
.   .     .  .    .    . . . .  .            .         .   .  .     . .  .    .  .    .           ..   .  .   .      .
. . .       .  .      . . . . . .     .  ... .     .      . ..    . ..  r  . .. .  .    .    ...  ..  .. . .     .   .
..  . .     .   . . . .  . .      ... .   .   . . ...  .. .      .  .. . .  . ..   .   ..      ..  ..  . .   . . .   .
.    .      .   .   . ..       .       . .  .  ....  ..   ...  .             ..   .  ..  .    .      .   .    . ..   .
.    .  .            .  ..            .. .. . .       .   . ....   .  .  .   . ..   ...    .  . .          .   .  .. .
. .   .      . .  . ..   ....      . ..  . .   .  .     .   ... .  ...       ..      .  . .  .  .  .    .         . ..
.. . ..  ... .   .          .  .   . . .  . ..  . .  .    .       . .   .     .     ..    .  .      .         . . .. .
.  .... ..  .. .  .    . . . ..     ...... .    ..   ..  .          . .     .  .  ..  .       ..      .              .
. . .   ..      .    .    ...    .  . ..  .   ..    ...         . .  .. ..      .    .  .. . .  .  .. . . . .     .  .
.     .  . .      ..  .      .      ..             .  .  .   .     .    .   ....   . .. .....        .   .. ..   . . .
.   . .      ..     .  .  .. ..... .  . .   .. ..  . . .. .  ..   ..  ..          .            .  . .. .           . .
.    .    .   .      . ..  .   .. . .   . .  . . ..  ..       ..      .   .  ..       ..          . . .         .   ..
. .  .   .    ..  . . .    ....  .       . .       .   .. .. . .    ..  ....       .   ..  . ..    ...         . .   .
... .   .   .    .  ..              .  . ...     .. ... ..           . .  ..   .  . . ...  . ..  ..   .    .        ..
.     . .       .    ..      .  .    .       ....    .      . .  . . .               . .. .      ..   .        .     .
. . .              . . .      .  . ..     .     .   ....     .  .      ..   . . .            .       .     .     .   .
.      . .        ..      .     ... . . .  .   . ... ..  .  .     .. .... .  .    . ...  .  ..   .. ... .    .. . .. .
.      .               . ..     .. .      .. .    . ... .  .     .      .  .      .  ...     .                .. .  ..
..          ..    ..     . .  .          .     . .    .. ..       .  .      . . . .   .      . . .      ..  ..     . .
.  .             .  . . .      .  . ... ...     ..       .     . . ..  . .  .. .  .      .  .    .. .     .   .      .
...     . .    .   .. .. ..   . . . . ...    . .          ......      .  ..    ..    ....          ...  . .   .      .
.      .   .   ...      .   . .   . . ..  ...    . .    . .. ..  ..       . .   . . . . .  .           . .          ..
..    . ..    .     .   . .  .   .   .    .       .     . .    .   .       .   ..  .   .   .          .   . .  .  . ..
.    . .       .  . .  . . .   .           ..  ..      ..  .  . . .. .   .  ..    ..   . .  . . .   . .  .. .. ...  ..
.   .    .   .   . .      . .. .  .    .       . . . . .      . .      . . ....  .     .              .  .   . .    ..
.   .. .     . .   .      .   .. . .   .        ... ...    ...       .        . .  .   .   .      ..  . . .   . . .. .
..    ...  .   .     .. . .. .  . ..  . .         .     .   ... . .   .  . .  ... . ...   .  .. ..    ..    . . .    .
.          . .  . ....     .  .      .      ..        .  . .  .   . ..    .  .....      .       ..  .   .    ..     ..
.  .       ..  .   .. .  .          .   .         ..   ... ..   ...   .     . .   ..   .      .  .    . ..  .     ....
...     ..  ..  ...              .        .    ...  ... .. .   .        . .   ..      ... .     . . . .              .
.  .    .   ...  .  .    .     .  ..                    .      .   .. .   .     .           .            .     . .   .
. .  ..... .. ..          .       . .  .  .   . ...  .     ..   ..  .   .   .         . .     .  . . .. .          . .
.   .     .   .   .    .   .    . ..  . ..            .     .   ..       .   ....      .   .     . ..   .        .   .
.    .    . . .   ..     . .     ..          .  .   .  ..          .     .  .   ... .    .        ..  .     .. ..   ..
. .   .   .   .... ....  ..     .   ... . . . .     . .   ..   ..   .. ..  ...      .   .        ..     .   .  . .   .
.   ..   .. .  .    .. .   ....   ..    .      .       .  .. .  .     .. ..  .      ..     .  ...  .   .   . .  .    .
...         . .   . .      .   .     .. ..  .       ..   ... .   ..    ...    ..      .  ..  ...      .       ...  . .
.     .       ...    .      . .  ...   .        .. .          .      .....    ..   ....    . . ....      . ...   .  ..
...    . .        .        . . .  .    ...   .       . . ...  .    . ..   . ..   ...  .. ..     . . .        ..  .   .
..  ..    .    . .. .....   .     ..   ... .. .       ..   . ..     .   .     .  . . ..  . . .     .  ..  .   ...    .
. ..  .  ....   . .  .. .  .. .  ..  .    .  . . .  ..   ...   ...   . ... .    .  .. ....   .    .   .   .     .    .
.   .   .   .   .           .  ..  .      .. .      .      .      .   .   .     .. .  ...     . . ..  . ..  ... .  . .
. .  .   .    .. .. .    .      .   .         . .     . ..      ..       .      .   .         ..   .       .  .  .....
.  ..   ... .. . .    . . .    .  .   . . . ..     .     . .  ..    . .   .  . .  ...     .   .  ...    .. . .  .... .
.     .. .       . ..  .  ..    . . . .   .  .     .  .. ..   . . . . .              .    .   .  . .     .. .    .   .
.... . .  ......   .. . .     . .     ...   .. ..     .               .     .         .         .      . ...       ...
.   . .   .  .     .. ..  .        .   .    .   . . .   . . .       ..   ...     .   .      .   .. ... .       .   . .
.. . ..   .  ..   . . .     .   .     .. .          .   .  .    .    .    ..   .. . .  .   .        .  .  . .    ..  .
.  ..  ... . ...   ......  ...      .    .      .   .  .  .            .   .  . .          .            .         .  .
.  .   .           .. ...        .  ..     .   . ..   .. . .   .      ..   .             . . ...   . .  .   .   .    .
.       .   ..    .     .  .     .    . . . .       ...       .      . .          .   . ..           .       .   .   .
.   ..  .        . ..   . ..        .... .    . .   .     ...     .    .               .  .. .               . ..    .
.     . .   .    . .. . .    .   .       .           ... . . .      .    ... .. .. .   ..   . .   .    .  .         ..
.    ..       .        . . .   ..  .. .  .             .. .    . ......    .    .    . ..   .  .     .. .    ..   .  .
.  . . . ..    .           .     .  ....      .   .    .   .  . . . ..   ..  .. ... ..      .. . .     .  . .. .  .  .
.  .. ..  .   . ..   .    .    . ..         ....    .        .  . . .  .  ..  .      .     . .  ..             . .   .
. . .    .  .        ...             .   ..  . .           . ..          ...    .  ...   ... .  . .   . ...  ..     ..
. .    .    ..   .       ..    .     . . .. ..  .  ....   .     .    .  . . ..  . .. .    .  .    ....  . .       ....
.. ..      ..   ..   .       .. ...   .  .        .  . .     .   ..      ..        . .    .  .                .      .
.. .  .       .  .     .     .    . ... .                .  . . . . .    .        .     .         . .    .      .   ..
.  ..      .. . ...    . .. ...       .  . .     .            . .   ..   .   ..       .       ..  .    .     .      ..
.    .   .   .. .       ....     .     .    . ... . .. .    .   .    . .     ..     ..  .. .  .     .        . .    ..
. .. . .   .. ..  ..   .    .. .  . .   ..    .   ....   .  . .   ... . .    .     .     .... ..  .  .  . .  .  .  . .
.     .  .  .   . . .    .    .  .    ..  .    .  . .    . ...       . .   .   .      .    .       .  .   ... .  ... .
.. .   ..  .   .   .          .  ..    .. . ...    .     ..  ..             .  ..         ..   . .     . .   ....  . .
...     .    .. .   ....      .  . .    .                 .    .    .        .            . . ...    .   .   . .   ...
.  .             .            .        ..     .        ...    .  .      .  . .      ..  .   ...  . .      ...   .    .
.. .    ..    .   .     .  . ..   .      .    .. .   .  . . . . . .    .      ..       . .   ..   .  ..  .. . ....  ..
.   .  . ... . .. ...     .     . . ..   .       .. .. . ...  . .  .   .    . .. .      .     . . . . .  .. ..  .    .
. .    . .       .     .  .  .                .    ..  .   ... .    .  .   .         . ..  .  .       . ..   .   .   .
.  . .. .          .      .  . . .            .. . ... .  . .  .  .  . ..            .     . . .   .            .    .
.         .  ....   .     ..    .  .      .         .. ...  .   .  .   .  .. .     . . . .. . .      .    .. ..  ..  .
. .  .     ..        .  ..      .  .    .   . .      .         .   .   .   .  .    ....    .   ...    .  .    ...    .
.  .. . . .      ...   . .         .       .  .  . .     .   .     ..  . .            .... .  ..     .   .  . .    . .
.     . ..    ....  .      ....     ... .... ...     ...     .   . .    .   .  .    .     ..  .   . ..        .   .  .
...  .. .    .  ...  .   . . .     .  ...   .  .  . .   . ..   .  . .     ..      . ..   ..    .    .. . .  ...    . .
.  .  ... .. .    .. .  .  ....    .   .   .    .   . ...     . . .. ..  .     .        .   .. .     . .     .     . .
.        ..  . ..   .  .   .   .               . .      ...    ..        ..   ....... .. .     ..       . .  .    .  .
. .     .     . ..      ...        . .. .  .     . ..   ..   .    .  .          .  .       ..   . . .  .  ..  .     ..
. .  .  ..   .  ... .  ....    ..   .     .. .. . .      ..   .    .    .     ..... .    .  ..     . .. .   .   . .  .
..      ... .        .   .     .   .... .                  .  .     .  .. . .            ..      .         .  .   .  .
.  .     ..       .   .   .   .  .     .. .       ...   .  .                   .....   .  ..     .        ..    .   ..
... .        .  .  .      . .  .     .         .  .. .  .   ... ..   . . ..... . . .  .  .   .     ..          .   . .
.    . .. .  .  .   . .   . ..    .   .  .    .      ..   .    .    .. .  .. .  .    . .   .     .  .   .....      . .
.    ...   . .  ... . . .  ..   .    . .     . ..... .  .  .   . .   . .       ..  .    .  .      .    .    .   .    .
.  ..    ..   . . . .   .   ... .         ..   .. .       ..  .     ..    . . .     .          ....    .. .    . .. ..
..  . . . ..      ... .  .    .  .   . .      ...  . ...    ..    .          .  .        . ..   ..       . .  . . ....
.   .  . .   .    .. .    .         .   . .  ...      .    . .        .   .       .     . . .  .. .     ..   . .  .. .
..   .            . .  .  .     . .  .   .      ..         .       .    .      . .  . .      .  .     . .    .      ..
. ..     . .. .   ... .        ..    .   .   ..     . .   . .   . .    .    ..  .  .   .   .  .      . . ..       . ..
. . . . . . . . . ..   ..     ..  .   .. .        ...    .    . .    .  ..    .   .    .    .   .     ...   .. .  .  .
.   .  .. .  ..   ..   . . ..  .. .    .    .   . .        .  .    ..        .. .   . ...  . .    .  .   . .     . . .
.     .  .            .    ...    .      ...  .  .  . ..    ..       . .     ..   .  .. .        .           .   .  ..
......................................................................................................................
