.......................................................................................................................
. .. .....        .. .  ....          .     ..  ...    ...   .. .   . . .  .  . ..      .       ..    .    .. .       .
.            .. ..      .            ....   .    ..   ..  ... .  .  .    ..    .     . .  ..  .     ....  .. ....  ....
. .  .    .    .   .      .     .      ..   . . .  .    . .  .   .  .   .       .. .     .   . ...  .   ..    .      ..
.. . ..  ..   .  .     ..   .     .       .  .  ...    .   .. .  .   ..   ..          ...              .          .   .
..   .  .         .... .         ..  .  ... . .   . .  ..  ..   ..    .. . ..    .           ..       . .  ... ..  .  .
.  ....       . .    .   .   .  .     . .       ..  .. .. .   .   ..  . .      .     .    .      .    ..     . ..  .  .
. .. ... ...  .  .   .. .        .     ..    ..             ..    .   .         .    .       .  ...  ... .      ..    .
....  .. .     .. .      . .  . .  ..      ..    .     . ..     .         .         .                .          ..  ...
.    .      .        . ..  . .  .        . .   X.. .. .  .  .    .  .     ..   .  .     ..... .  . ..    .. ..    ... .
.     .. .  .  ... .   . .      . .    . .. .  .   ..   .   ... .  .               ... .  ..  .      .  .  ... .  .  ..
.  . .   .   .   ..    ..  . .     .. .   .   .    ...       .        . ..  .  .     .      .  .  .   ....          . .
.  . .   . ...   ..     .     ..      . .       .  .   .. ... ..  .     .  . .   .   ..       .. .     ..   .. .. .   .
. .     . .     .       ..  ..       . ..  .  .   .  .  . .. .   . ..  .    .   .. .  .   .  . .. ..  .       . .    ..
..    .      . .    ..       .    .  ..  .    ... .        ..   ..             .  ...   .  . ..         . . .  . . . ..
.  .  .      ..   .. ....  .  . ..  ...  ... .    ..   ..  .     .  ..  .  .  . . ..      . . .  .   ..  ...  ..      .
..     ..... .  .         . ..   .  ..      . . .    .      ..    ..   .. .       .  . ..       .   ..       .  . .   .
. .   .   .   ..  .  .. ... .  ....    ...... ..   .  .   .  .  .    .   .  .       . .   .  ..      .. .    .  ..   ..
.  .  ..      .      .   .   .  .  .   .  . .     .          . .   . .  ...          . .      . ...    ....   .       .
..  .    .  .  .     ..    .   ..  . ..  . .     .             .      . .   .. .  .      .         ... .    .  ..    ..
..    . . ..     .       .      .  .  .. .. . ..  ..  . . .    .....   .   . . ... .  ..    . .   .     ..   .  ..    .
.     . .   .... . .   ..  . .  .   .   .  .    ...        .     ..  .. .. ...  .  .   .      . .    .....          . .
. ...    .     .  ...          .        .   ..   .  .   .  ..   . . . ..     ..... .       ..   .   .     . .. ..    ..
..  . .  .     .   .    .. ..  .   .   .... .   .   .   ...  .  .  ..          .     ..    .     .         ..  .. .   .
.   .            ..        .  ...    .           .     .     .   .  . . .  ..      . .   .                  .   .     .
. .    ..     ...          .. ..  .  .  .    ...   .    .            ...  .         .      .     ..     .    .  ..    .
. .      .. .   .   ...   .  ... .   .   ... .  ..  . .       .                . . .     .   ..  .   .  . .           .
.  . .   .      ..   .      . .           .. .  .  .  ..     .  .           .    . .   . .  ...       ..    .   ..  ...
.  .    .. ..  .     .       ..     .   .. .. ....     ..      .  .     .     .. .. .   ...  ...  .. .             ....
. .     .       ..    .... .  .  .. ...     . .   .. ..  .    .  ...   . . .     .     .               ... .  ... .   .
.  ...      . .   .     . .   .       . ...     .. . .       . . . .  .. .. . .   .         . .       ..      .    .  .
. . . ..     .    .             .  .  ..   .   . ...  .  .  ....     . ...   .        .     . ..    . . .   .   .     .
.  .         .  . . . . .   . .     ..     .   .  ..   .      .           .       .. .. ..  .    .      .    .     .  .
.     ..            .    . ..        . .     ...  ...    .  ...    .   ..    .      .       .   .  .     . .   . . . ..
.   .  . ....           .      .   .  .   .   ..   ..     ..      ..... .. ...   .   .     .       . ..      . .      .
...       .  .  .        ..          .    .     .             .  ..  ..  ..     .     . ..  ..        . .       ..   ..
.   .. .   .  ..     .     .   ..   ..     .     .  . ..  .  .. . . . .. .       . . .  ..   .         .   .. ...  .  .
.  . ..      .. .  ....  .          ...    . .  . ... .  .      . .   ..  .....  .   ..      . .   .   .    ..  . ... .
..     .        . .    .           .  ... . .   ..  .   .. .            .   ... .   .     . ....       ...            .
.  . . ... .       . ....     .     .  .  ..  . . .   .    . ..  .. . .  .   . . .   .  ..      ...  ..   ..... ..   ..
.    .    . ...             .   .   . .   .    .   . .. .  .   .  .    . .. ..  .. .     .    .    ..     .     .     .
. .. ....   .  .....  . .    .     ... .   .   .  .      .   .  . . .  ..   .       .       .    . .   . .   ..  .   ..
...  ..       .    .  .     .. .   . . .. . .  . .        .        .. .   .        .        .              ..         .
.. .  .    . .   ..   .    .    . ....       ..   .     .   .  .   . ..   .. ..  .     ...    .   ... .      .  .     .
. . . . . . . ..  .... .         ....   .  .               ..     . .    .  . .   ..  .  .. . . .  ..     .  .. ...   .
.    .  .   .     .     .  . . .     .    .  ..    .   .  .   .  .    ..   . .    .. ..            .  ..    .  . ..   .
.    . .. . .         ..    . . ...    .      .  .  . ....   . ..    . ..  .  ..  .     . .     .   . .  . .         ..
..  . . .  . .    ..  .       .   .   . .  . .  .   .  .  ...        .   . .    ... .      .     . .    ...    .  .   .
..         .   .     . .  .    .   .   ...  .        .  .   . .   .       .     ..         .            .  .  ...     .
.  .  .      . .  ..    . ..  .     . ..   ..   .  ..    ..   ..   ..  . . ..  .     . .  . .   ..  .  ... .         ..
.   ..     .    .     ...  ...   . .    .  .        ..   .           .   . .          .  .  . .          .  .   . .   .
. .  .       ... ....    .   .  .         .   . ..             .  .    ...   .  .     .  .   ..  ...             . .  .
. ..      ..   . .          .    . .   .  .. . .   .        .  . .  ..   .     . ..      .    .  .  . .      .    .   .
.    ..    .     . ..   .      . .         ...          ..       ...          . . .  . ..         ...   . .  ... .    .
. .   .      .      . .  .       .. .. .... .   . .         .    ..       .        .    ... ..  ..       .    .... .. .
..        .   .....   . . .  .     ...    . .......    . . .        ..      .. .r ..    . .    .  ..  .    .      .  ..
.      .  ..  . .. .  .. .  . .. ...  ... . . . .  ..  ...  .  .  . . . .   .            .   .     .        .      .  .
... . .    . ..        .    . .    .  . .        .  .. .        .     ....  .  ... .. .  .    .  ... .      .    . .  .
.          . .     .  .       .      ...    .   .    ..    .  .       .  .   ...        ....   .  .      .      .     .
. .     .     ..   .    .       .. .  ..  .    .   .  .   .           .  .     .       ..... .  . .  .         . .    .
...      ...  ...    . . . . . ... ...   . . ..       ..   .    .     .  .       .    . ..  ....       .  .  . . .  . .
.       .  .  . .    .... .   .  .  .       .  . .   . .  . .      .     .    ....   . . ..  .. .    ..  .   ....     .
.      .   .   .     .  . .          .    .   .    .           ..   . .     .   ..    .       . .  ..  .  .    .. . . .
.  ...   ...   .  ...  . .   .  .     . .  .   .     .   . . . .  .  . .       .. .  .      .       ..       .    .....
.        ...     . .  .     .  .       . .             .   .... . .   .   .  ....  .   .....   ..  .       .         ..
.     .... . . .         ... .  .   .   .....      .     ... .        .  .  . .  .. . .  .  . .            ..   ..  . .
...     ...         . .   .              .        .  . ....   . .                 . .   .        .     .     .        .
... ....   .      ..    . . .  .     . .        .   ..   ..     . .    .  . ... ..... .   . ......  .. . .   ..    . ..
.   . .     .   .  .  .   .    .   .          ..            .   . . ..    . . ..      .             ..  .   ...  . .. .
. . .   .  ..   .   .   . . . ..       ... .   .   .. . .    . .  ...  .    . .     . .. .  .    .   . .     .      ...
.     .      .     .   .  .    .    ... .. .   .  . . ..  ..    ...            .  .    ....   .  .  .  .  .      .  . .
...  ..     .  .      .. .      ...          . ... .....    ..   ... . ..   .    .   . .  . .   .   . . ..   .      . .
.  ...  .  .      .. .  .      . .. ..    .  .   .  ...... .    .   .    .. .. .   .          ..   ..           . .   .
.     .     .    . . .            .. . .   .. ...      .       .  .   .      ..  ..    . ..  . . .     .    .. .. .....
.  .. .   ...     .. .   .    .        ..   .     ..      .. ..    .     ..   .. . .   . .     ..  . . .            . .
... ..  . ..    .  .   .  ..     .       ...  ... .. .. .   .   .  .  .. ...     .   .        .     .   . .  ..       .
..... ...  .   ..  .           ...     .   . .  .  .  .   . ..       .  . .       .        .      ..   . . .   .    ...
. ..  .     .      ..  .  ..  . ..  .     .          ..  .   .  .   .      . .   .  . ..       ... .      .     ..  . .
.    . .   .. .  ...  .      ..        .             .   . . . .   .  .   . .             .    .   .    .       .    ..
.      .. .    .  . .    .  ..  .   .  .     .. ..  ..      . .. .   ..               ...      .        .    .  .. . ..
.       .    .. ...    ..   ..  .     .  . .  . .    .   . .  ...  .   .   ..   . .    .         ..   . .       .     .
. .  ... .   .   .    . . .... .  .  .       ..    .   .   ...   .  .  .  . . .   .  .....          .             .. ..
. . .      .. .   ..  .   . . .       ..  .    .   . ...   .  .            .    .      .     .   .. ... ..          . .
..  .    .      .    .      ....           ..   .   . .  . .  . .     .           . .     ..    .  ..   . ..   . .    .
.   ...   . .  .    .         .        . .   ... .  .            .   .  .         ....   .  . .   ..       .       .. .
..  . .       . .    .  .    .. .  ..     .. . .   .     .  .. . . ... . . .  ...              .        .... .      . .
..       ...  . . .     ..    .     . .    .     ..  .  .     .    . .    ..   .. .   .   .    .     .        ..    ...
.    . . ..     ..   .....  .  .      .  . ..  ..  .    .    ....                    ..      .     . .     ..   . ..  .
...       .   ..         ..  .                .   .       . ...   .  .  .. .. .   . ....     .. . . .     .   .   .  ..
..  . .  ..             . .  .      ..      .    .   .         .        ..  .    .    ..  . ..    ...... ...  .. ..   .
...   .   .   .     .          .. .. .  ...        .  . . .  ...    . .  ..  ..    . .. . .. ..  .  .              .  .
..   ..   ..   . . .  .   . .     .       .  . . ..     . .      .             .   . .    .. .    .   . .  ..   . .  ..
..  .    . . .      .    ....          .  ..   .. ...      .  .  .     ..     ..    .        ..       ..  .      .  . .
.. .    ...   ..    .              .  .     .. ..  .   .. .  .       . .  ..     .  .         .  . . .   .. .         .
.  .      .   . .     ..  . . .     .  ..    . . . .  .      ..   ..    . . .    .. .     . .     . ..                .
...     . .      ..   .         .  .     .     .  .. . ..  .  .     .   . .           .  ...    .          . .  .     .
.  ...  . .  .. ..   .   . . .     .         .  . . .   ...   .  .    ......      .. ...  ...     .     . . .    .. . .
.       .. .      .    ..  ...  ..  . .  .   .          .   . .. . .    ..            .   .   . .       ..           ..
.     .. ... ..  ..    . .   ..  ..... .    ..  ..   . .     .    .. . ..   ...    .  .   . .. .    .. .     . .      .
. .   .    .  .        .        .    .   .   ...       .   ..      ... .      . .  .     .  ..  .  ..  .... .. .    ...
.  .         .... .        . ...  ...   . .   .  .    ..     .  ..  ..  .  . . . . .     .   .  .   .  . ...  ..   .  .
.     .  .                .     . .      . .. .  .   .. . ..   .     . .  .    .    . . .     ... ...    .  . ... .. ..
..  .   . ....   . .       . . .   . .    .              . .  .   .. .    .  .  .   ..      .. .      .           .   .
. .. . .     . .  .       .. .  ..    .  . .     . ....   ..  . . .. .     . . .   .. .   .. .  .       . . .      . ..
...        .              ..    .. .            .       ..  .  ..     .  ..       .   .  .      . .         . .  .    .
. .      ..   ...    ..    .    .     ...     .  ..  .. ..      ...  . .. .     .     .  .           ..    . .  .   . .
.      .  ..     . .  . ..   .  .  ... .. .  . .   .  .   . .               .. .......     .       .  . .     .      ..
..   .   .  ..  .    ..          ..  .    . ...   . ..     . ... ...    . ...  .  .      ..   .  .        .  .     .. .
.   .     . . .   . .  . .  ....   .       . . .. ..      ....  .   .    .  .                     .. ..  . .  .   . ...
. .       .  . ..   .    ..  . .      ..    .            .    .      . .          .      . .  . .          .   .  . . .
..  .   . ..  . .      .       .    . .     .   .. . .    .  . .  .. .   .  ... .. .     .   .. .    . ....    ....  ..
...       .     .  .  ..   .       .      .   . .    .   . .       ..              .  . .      .  .     .  . .      . .
.   . .   .      ..    ..   .    .    .. . .   .     .   .     .  . .  .  . .         .     .     .     .   ... .     .
...       .. .    . . . ..    .  . .       . .     .      .   ..  .. ...   .    .   .  ..  .  .   .     .          .  .
.   . .    . .      . .   .       . .        ..       . . .   . . .  .         .  .   .             ...         . .   .
.        .   . ...   . .      . .  ..                 .  .  .      .  .   .         . .  . .. .     .. .   .   . .  . .
...     . .    .    . . ....     ... .    .   .      .. .  . . .       .       .   .  .  .            .. .     ..     .
.  ..  .    ..  .  . .  .       .        .. .   . ..     ...     .  .  ..       .    .   .    . .         .     .     .
.......................................................................................................................
