...........
.  ..     .
.    .    .
. . .    r.
.  .X    ..
.  . . .. .
. .  . ....
.  .. .   .
. ..      .
. .      ..
...........
