........................................................................................................................
..     .  .  . .      .  .   .              .      .    .   .  .  . ... .  ... .  .        . . .   .             ..    .
.  .  . .  .  . .  . .. ...  ... .  . .    .     . .. .    .        ..     .   . . .       .  .   .. . ...  .  ... .  ..
.  ..   .    .  . ..  . ... .    .    .  .      .    .  ..       .        .   . .   ..  .  .     ...        .  .. .    .
.      .    .    . ..       .    ..     .      .    ....      .. .  ..       . .   .  . .      .    ..   ...     .     .
.     .        . .       . .      .     .     .    ..    .  . . .        ...  .    .      .   ....        .  ..   .    .
.. . .. . . .   ....  . .    ..   ..   .  ..  ..    . . . . . .  .      . .     .  ..    .  .       ..   .    ..    .  .
.  .   .. .    ..   .    .   .    . .   .     .  . .        .. .   .   .   . ....   . .. .  .   .  ..  .    ..  .   . ..
. .. ..   .     .    .. .     ..    .   .   .         .  .   ..    ..    ..    .       ..    . ...     .  ...     .   ..
...  .. . .    . . .. ....   .       .    .  .. .     ..  .       .  . ..    . ..     .. .    .     .       ..    . .  .
..   ..      .   .    .         ...  ..  .  . .         .. .       .  .  . ..    .  ....    . . .    .     .   ..  . . .
.    .    ..   .   ...  .. ..              ..      .  .      .. . . .   ..     .   .   . .  ..     .  . . .            .
.. .       .      ..        .    . .. ..    .     .     ..       .   .      . ..   .   . . .  .   .    ..        ..    .
.   ..... .   .     .  ..          ..     .   .  . .   .  . . .   .  ..          ...    ..  . .     . .  .      .   .  .
.  .. .      .  . ... . ..  ....  ... .         ..        .    .   .     .. .       .        .  .. .. . . ..  ..      ..
.      .          .... . ...     .        .       .  ... . .  .           . .  .  .  .    .      . .   . ..    .       .
.     .  .  ..  .  ... .   . .  .    .  .       .   .   .    .    ... . .   .. .           .  .. .     ..... .  .   .. .
. . .. . .        . ...     .         ..   .   . . .    ..     .       .  .    . .   .. .  .         ..  .    .  . .  ..
.   .       .   .  .      . . .    .. .     .   .     .... ..        . . ..   .. ..  .       . . ....       . ..  .    .
. ... ..  ..   ..   .   .   ..  ...  ..   ....              . .   .            .    .         ..    . ...      .       .
.    . .  .    .    .   .  .   .      .      ..   .        . .. ..  .    .     .            .        .  .          .   .
..        ..  . ...  .   .   .. ..  ...        .    .   .  .          . .      . .  .  . .  .   .. . .  .  . .    .    .
..      . . . . .  .   .   .  .   ..     .  .  .   ..  .    . .. ..    ...     . .. ... ...   .   .    ...  .  .   .  ..
.  .   .... ...  ..   . ..     . . .  .   .       .  ..   .  ..  . .   . .   .             .        ...  . . . ..  ..  .
. ..   . ..   .  ..  ...        .       ..     .  ..   ..  ... ..   ... .      ...     .. .  .  . ..    .    . .       .
. .    ..             .         ....  ... .      .      . . .. ..  .           ...          ...    .     .  .       .  .
. ..       .      . ...  .   .   ..    .       .   .  .      ..  .       .       ..  .     .   .. .   . ...  ..   .   ..
.. ..      ..    .     . .  . .    .. .      .. ....  .  .   .    . .   .      .  .   .     .. . . .             .  ....
..    ..     . .   ...   .  .   ..        .  . ..    ...  ..   .    .  ..     .  . .  . .  . .  .  ..     .  .  . .  ...
.  .       .. .     .    . . . .. . .  .   . . .    . .  . ...  .      ..  .... .  .  . ..      .  . .     .  .      . .
.  ..     .    ... .      . . .   .            .     . .  .    ..    . .  . .....   .        . .        . .     .  .   .
.      . . . .   .      ...   .     .   .   .. .     .   .   .   .  .    .. .      .   .  ... .  ..  . ...     .  .    .
..      .   . ...   ... .   .    .. .    .....   ...  . .         .. . . .   . .     .         .    ..    ... .    .. ..
.    .      .  .  .. . . .    . .    ..   ..      . .  .    .  .. .    . .  .    ..        ....  ..      .   . r .    ..
.   ..           .  . .        . .               . .  .    .         ..      ..   ....    . .   .  .   . ..        ... .
. . . ..    . .   .   .    ..  .  .  ..   .     ..      . .   .  ..     .  ...   .   .....    .  . .    .   .   .  . ...
.  .  . ..       . .     . . .      . .   ..     . .       ..   ..... .  .   ..   ...         .    .     .  .   .      .
..       .    .. .   .  .  .      . .  .         .   ..    . .. ..       ... ..   .  . .  .   ..    ..      .   .  . . .
.      .. ...     .    ..  .     .  .          ... . . . .    .           .. .   .           .   .  . . .        .    ..
...   .    ..  . .. .       . . ..  . .       ..        .             .   ..  .  ...     ...         .. .   ..  .      .
.   .      ..   . . . .              . .     .     . .   ...  .   . ....  .   . .  .   ..         .  .      .  . .     .
..    .   ..   .   .   .    .        .  .  . . .  .. .  .. .      .  ..      ..    .  . .     .. .  ..     .  .       ..
. .. . .      .   .    ...   ...  ...     ...    .        . .       .  ..        .  . .  ......    ..    ..     . . ....
.   . .  .  ..   .. .   ...  . . .   .   .          ...  ..   .     ..           ..    .  .     ..    .   .. .   ...  ..
..                .  . . .   ..   . . .     .  ..         . .           .  .                ..   .        .. ... .   . .
.   .   ..   .  . . .  ..           .. ...       . .   .. .     .       ...      .    .  ..  .    ...      . .  . ..   .
.  .   . .      ..   . .      .      . . ..    .. ....  .... .   .. .    .. .    .    .   .  . .  .  .. .   ..   .  . ..
....       .  . . .....    .       .          .  . .   ..            .  .         .  . .. .     .       ..  .   .    . .
. .   . .. .  . ..  ..          .  . .     . . .  . .   .   .  ..  ..      .   .    .  ...   .       . ..      .  . ....
. .  .   ..     ... .  .. ..X   .  .    .  .    .     ..  ..     . ....   .          ..  .   .   .  ..  .    .    .  . .
.   . .   ..    .    .    .  .   ..    . . .      .   ...   .   . .  .   .  .   .       .  .. .  .   .  .  .      .    .
...  .  ..     .   ..    .  .      .  .. .        . . .  . . . .                     .    .     .     .  . ..  . .     .
..         ..     .      .  ...   .     .     .    ..   .. .  .    .  ..       .  . ..   ... . .            .  ...   . .
.             .   .   .      ...  ..  .....       . ....     .    . ..      . .   .. . .    .    .    .  ...       .   .
. ...       ....  .     .  .   .    . ...  ....    ... .  .        . .           ..  .  .  .. ..            . ..  .  ...
.     .     .     .   . .  .. . .   .. . . . .        . .                 .      .  .     .    .        .   . .      . .
. . .  .  .   .  .  . . ......   .          . .         ...  .     .      .   . ....    ...   ... ..   .  .   .    . . .
..    .    . . .    . . .. .   .     .  . . . .   .      . ... . ..   .   .. .   .  .     ..        . .    .  ..  . .  .
..       .     .  .            .      ...   ... .    . ...      .    .. . . . .    .               .  .    . .   . .   .
. .    .    .    .  ..... . .... .      .  .   .. .         .    .     .        .. .    . ...     .   . . .  . . .   . .
.           . .....       ..  .    ...  .  . .    . . ...       ... .  .  . . . .. .               . .  .        .... ..
..  . ..    ..    .           .          . .      . .  .     .     .       ..       . . ..  .           .  . .      . ..
..   .        ... .  ....  ..   . .  . .         .   .  .    .       .  . ..  .  .   .   .  ..   . .  .     .  .  ..   .
.  . .... .... ...  ..... .   .    ..  . .       . ..   .. .    . ...    .         . ..  .   .     ...          ..  . ..
.  .   . .         . .   .     .         .  . ..  . .  .    .    ..  .  .        ..   . . ..   . .  .  .  .    ..      .
.    .       .   . ..         ....       .           .     . .      . .       ..   .. ... .     .    .. .   ..     .   .
.  . .    .        ...  . .     ..      ....   .  .   .      .. .   .  .     ..   . .. ..  .        ..  . . .    ..   ..
..  .          ....      .  . .. .  .. .. ..  . .        .           . ..    .. ..  .. . .  ....    .    ..            .
.    .   .      ..    .    . . ..  .    ..    . .              . ....  . ...       .     . .   . .  . . .    .   . . . .
. . .    ...      ..     ..     ..  .     .  .    . . .   ..     . ..          . .     .   .      .  ..  .     . ....  .
.  .  . ..        .    .. . . .   .  ..     .   .   .. ..           .      ...   .         ..  .  .. ..  .    . . ...  .
.      .      .   .  . . .            .  .     .. .. .. ..      . ..        . .    ..         . . ..   .   . .  .     ..
.  ...   .. . .  .   ..   ... ..      .         .   .       . .       . .   . .   .   .  .  .          .   . ..   .  . .
.  ......    ..   .    ..      .    . .          .     . .       .   ..        . .  .   .. .. .     . .    . .    . .  .
.  . .... ..   ..  . .    .. ... ..   . .   .. .  .      .   .  ..   . .  .. . .   .    .. .     ..  ..    .   ... . . .
..  . .          .  ..   .  .        ...  ..  . .    .    .     .  . .       .... .      . .     . .. ..  .      .  .  .
.     .. .         ..            .      .  ..   .  .   .   .    .    .        . .    .   . ...   .  .   . .         . ..
.  .  .    . ..  .         .     ..     ... .   ..  ...         .   .        ....     ..    .  .   . ..    . .    .  ...
.       .    .  . .. .   ...       . .  .   .. . .  ..              ..  .  .    .  .   ... .    .  .  . . . .  .   .  ..
..    . ..    .  .  .                     .....  . .      .. .    . ..    .     ...  .  .    .. .        .      .      .
.   ..    .. . . ..    .         . .        .   . .  .     .                .    . ...   ... . ...     .          .    .
.  ..    .      .  ..         .  ..  .     .     .   ..  . . .   . .   .  .  .          . .      .   . .  .   .     .. .
.  .  .. .  ..  .   . .           . ..        .  .    ...  ..    . .. . ...            .. . .    ..  .       . . .. .  .
..  . .... .      .   ..    .   .              .            .   .    ..   . .   ... ..    ..  .   ..   ....         .  .
.  .    ..   .  .   . ..  .    . .     .    ... .   .. .  .     .   ..  . . .    .   . ...  .   .     .       .   ..   .
.       .                 .  .  .     .   .  . .    . .  .   .  .     .    ..    .   .   .  .  .. .   .       . .     ..
.... .  ... ..     .  .       .   .  . .     .   . .. ...        .. ..   .           . . .    . . .    ..  .. . .      .
.  . .  .   . .  ..       ..  . .          ...   . ...   .        .. .      ..    .  . . .   .    .   .  .  .   .     ..
.  .   . .     .. . ..... .. ...      . ..    . ..  .  .     .     . ... ...  .                   . ... .           .  .
.     .  ...       .   ..  . .    .   ..  .   ...    .. .   .  . .  .    .  .   . . .   .  ..        .     . . . . .   .
..   .   . .    .    .        .   ...    . ...        . . .   ..   . .   . .  .   ... ..             .  .     .        .
....  . .    . .            .   ..    .           .   .    ..     . .  .. ..   .     .    .         ..  ..       .     .
... .    . .    .  . . .   . .        .    .  .    ...  .  .. ...        ....           .. .      . . .            .  ..
.          . .  .    ..  .     .  . . .   .  .    .  .. .  .. .  ..  . . ..     . .. .     .    .. .     .. . ..     . .
.             ..   ..   . .    . .  .   ..   . .. ...    .      .. . .  .... . ..     . .   .  .    .     .  .         .
.  .     . ... . .   ...     .   ..   ..     .       . .....  .       ....  .      .   .    .  . . . .    ...   .  .....
.   ..      ..            . ..  ..   . .     .         .   .  . .  . .     .  .      . .  . ..   .   .. . .   ..       .
..   . .  .  .  . ... . .. ..   ..          . .            ..  .   ...    ..      ...   . .    .    .   .   . . . .  ...
. ..  . .   .     ...        .       .      .        .   . ...  ..   ..           .     .. . ..        .               .
. .     .     ....      .   .     .       .      .      ..  . . .      . .      ....    . .    . .   . .      .  . ... .
.    ..   .... . ..    .   .     ..     ... ..  .      .     .    .. .  ..     .        .. .     . ...  . ..      .    .
..  ..  .. . .      .. .    ..       .  . . ... .   .    .  . .       .        .      .  .  . . . .      .  .   ........
. .    .    ..   . .     .      ...       ..     . .  . ...            . .      .       . .   .   .  ..... .   ..  . . .
.   .    .    .  .         ...   .    ....      .. .        .  .            .  .       ..           ..    .       ......
.     .  .. .. .    . .  .  .      ..            ..    .    . .  ...    ..  .. .  .. .   .   .  . .     ..      .   ....
. ..  .   ...   .  .   .      ..  .    .  .    ... .     .      ..  . ..   .... .    ...      . .  .   .     .  .    . .
.   .        .  .   .   . ...  ..     .... .         .  . .  .     ...  ..  .   ..     ..       ..                .  . .
.     .  .  .    .  .   . . .    ...  . .  ....  .   .  .  .. .  .  ..    .      .   .   .                 ..   .  .   .
..  .  ..   ..... .  ..  .   ..     .         .   . .   ..   . .     ..  .  ..   .           ..  ..       . .  .    .. .
. . . . .    ..      ..  .      . ..           .  .  .  . .. .    .. . .    ..  .. . . .     . . .. . ..         . . . .
..    ..     .       .     ..    ..         .   .       .    .. .  .. . .  . . . .    ..       .  .  . . .    . . .. . .
..            .    ..   .  .  ..  .             .        .   . .  .   .      ..  .       .   .  .    ..        .  ..   .
.      .. .. .. .  .  . ..   .             . .    . . . .  ..   .     .  .            .    .   . .. . .  . .  .  .     .
. .... .       .          ..... . ... .    .      ....   .       ..   .   .             . ...  .  .       ......    ....
.    .   .       .     .    .                  .   .   . .    ...  .  . .   .     .  .      . . ...   .  .    ..   .. ..
. ...  . . .  .    . .  . .      .  . .        ..  .  .   ... .      .     .      . .       .    ..   ..      .      . .
. .   .    .   ...    ....  ..        .  .    .  ..    ..... .   ...... ..  .. .          .  .  .    ..   .  .    .  . .
.     ..  ..     ..    . .      . ..      . ..  . ...  .. .  .    .       . .     .    .  . .. .  .              .    ..
.   . .  .       ....   .   ..         .     .  . .    .   .  . ..   . .   .  . .  .    . ....  .. . ....        .. ....
........................................................................................................................
