.........................................................................................................................
.                 .       .  .. . . .   .     ..        .   . ...   . .   .   ..  ..  . .  . . . .     . ..    .. . . . .
.. ..  . .     ..     . ..   ....   .    .. . .    .....        .     .  ..   ..    .  .   .        .        . .   . .  .
.  .  .  .       ..     .     .  . .... ....    .  .   . . .   .   . ...     ..  .  ...     .             .        ..   .
.     .  .  .  .    .. .  .. . .   ... ..              ..  .         .      .               .. .      . ..   . . .    . .
..  .         .      . ...      ..   .     .      .   ..   .               .   .    .  .   .   .      ...        .  .   .
.    .      .           ..   ... .     .     .   ...    .      .  .  . . .     .       .  .   ...      .  .  .      . ...
.   ..       .. . .       . . . .   . . .    . .   . .      .     .  .  . . . . ..  . ...  .  ...        ... .. . .  ....
. .        .      .       .     ..     .                      .    . ..    ..        . . . .   .   .      .  .  .. .    .
. . .  ..     .   .        .         .   .  ..  .  ...          .   . . .    . .    ... ... .      .   .  .       .. .  .
.  ... .    .     .          . ..  .   . .   .      .     .     ..  . . .  . .     .   . . ...      .   ...   .  .     ..
.. ...   .    ..  .. .     .            ..   ..  . . ..   . .   .   .   .    .  .. .   ..           . .  . .  .  . .    .
..  .. . ...      .  ..     ... . .  .. .  ..    . ..   .           . .     .           .     ..        .        . .    .
. .      .  ..     .   .. .....  .  ..  ..  .  . . .    .  ...     .   . .. .     .. . . ..  . .  .      . .        .  ..
. ..    .  ..  .  .   .   ..   . .       . .     .    . ..      .      ...          .  .      .   . .        ..      ....
.    .  .    .    .   ..    . .    ..      .     ..     . . .      .   . .   .   ..   .  .  .. .  .     .  .   .        .
.       . . .    ...       ..       ..   ..  .  .       .     ..  .           . .  ...   .          . . .  ..    .  .   .
. .  .. .. ... ..     . . . ..   .    .  .    .  .    .. .      . .   ...  .. .    ..     . .   .        .. ..     . .  .
..           .   .... . .   ..    ..   .   .     . .             ..  .  .   ...  ... ..  . ...   .     .    . . ..  .  ..
.  .  .   .     .      ...   . ... .    ..         .. ..  . ... .  .. . ... ..   . ..  . .    .   .  .   . . . ..     . .
. ..  ...  . .. . ...       . .. ...   .          ..    .   ..    .   . . .  .  . .      ...    .    . ...     ..     . .
.     .  . .   ..       .   .       .. .       .          .      ..  .         ... . .   .  .   .        . .            .
.   .   .  . . ..     .. . . . . .  . .  .  .  . .. ..       .  .   .    .               .   .   .         .    . .   . .
.     .    .. .  .      . . .     .    .. .    .  .... .  ..       . . . .        ... ..     ..       .   .  . .        .
. .     ...    .   .. .     ...    ...  .             .. ..      .  ..  .   ..   . .. .   . .    . ...        .         .
.   .        .  . .. .   . .  . .     .. .   . .         . .      . . ..    . . .   .   .   .  .  .. .      .  ...  .. ..
. . .      . .   . ..   .     ..                ... .   ..       ... ..    .....  .    .   ..  ..    . .   .  . . .   . .
..  ..        .          .    .  .   .. .. ...        .        .  . ..  .       .  .          ..       .    ..  . .  .  .
. .       . ..  .     . .   .     . . . .. ..  .   ..     ..     ...     .            ...         .  . ..       .   .   .
.  .. . ....               . .    . . .        .     .     .    ...      .   .   .  .    ..    .    . ..  .    ...     ..
..     .      ..    .     .  .           ..  ... .  .   ...  .   ..           .      .  ..        .. ...         .   ....
. . .      .            . . . . . ..      .. .  .     .  .. .  ... . .. .  ..     .  ...   . .             .       .    .
.      ...  . .. . .   .  .  .   .  .  . ..       .       .        . .  . ..    . ..     .    . .         .      ..     .
.    .     . .     .   . ..   .  .     . ..   .      ..          .  ... .  .. .  . .    ..   .  .   .   .   . ..   .    .
.   . . .   .     ..  .  .. ..         .. . . ...   ..   . ....    . .        .   .  .    .   .. . .  .  . .  .     . . .
.. .   .   .   ......   .            .     .  . . . .     .   .  .   .  ..   .        . . ...     ...      . . .  .  .  .
.    .   . . .  .   ..  ...   .   . ..          .      .      . . ..   ...      ..   .         .   .   ..  . ... .   .  .
.  . .....    ..  . .   .. ..  ... . .   .. .       ..   . . .         .   ..               ....   . . . . .  .    .  ...
....   .    . .              r         .      .      .   ..    . . .  . ...  .  ..  .  ......          .   . .  .  .  . .
. . .  . .   . ..... ..   ..     .       .....  .               .    ..  . .   ..    ....  .  .    .    .    . .        .
..       .   .  ...     .   . ..  ..   . . .   .        . .    . .  .  ..            . .    . .       .  .  .    .    ...
.   .  .   ... .    .   .   . .  . . ...      . . .  ..    ...   .        .  .  ...            ..  .     .  ...      . ..
.  .    .       .         . . .  .    .   ... . . .       .  .    ..... .  .    .  ..  ..  . . .              .   .   ...
..       ...    ..   ..    .    . .  .   . . . . .. ..        .   .    .    .   .   . .  .     ..    ...      .   .  . ..
. .   .. .    . .. .  .     .   ..    .    .    .  .       ..   .  .     .       ... ..  .    . .        .      .    .  .
..  .     .  . ..    .          ..   ....  .      .     .. ..  .   ... ..     ..        .... . ..    . .  .  .     ......
.  . .   ...    ..       .  .      .  .  .  ....                       .  ..     ..   .  .   .      .      .  .    .   ..
.  .      .  ..    .  .   .   . . .       .   .. .       ..      ..  .    .             . ...  . . . ...  ..   ..   .   .
.      .    .         .   ..       .     .   .    .....   . .  . .  .     ..     .  .    .  . .  .  . .    . .   .  ..  .
. .. .       . .. . ..  .   . .  .   .  .. . .  . ..        .       .. . .           ...   ...  . ...     . .    . .    .
.         . .          .       .    .      ..... ..         .   .  . .. .    .   . .  . .   . ..     ..    ...   . ... ..
.      . .      .   . .. .  .  ..          .    ....         .     .  .         .     ..  ..  . ..     ...      ..    ...
.           .   . .  ..        .. ..  ..      .        . .      .  .  . .     .        .       ..    .  ..      . .  .  .
....  .... ..    . ..  .        . ..    .    .   .        ..   ..   .    .  .. .   ..   .  .      .. .  . .. .       .  .
.   . .. .      .   ..  .   .. .  ..   .  .  .. .  .     .    ..   . .. .    .  .  .  .     .  .. .     .    .. .      ..
.  . .    .   . .  ....   .     .         ..   ..  . .   ..  .   . . .    . ....    .......    . ... .  .  .    .      ..
. ..   . ..        .       .   .     ..      . . . . .       .      ....       .  .    . .. .       . .    .     . . . ..
..          .  .       .  .    .  ..         .  ..  .        .   ....   .   .  .         ..       .    .          .  .  .
. . ... .  . ..  . .  .  . . .. .   .   .. .   .       .  .       . .  . .     .         .            .   .  .       .  .
.   .. ...    .    .     . .   ..          ...       ...   .     ..    .  .     .. . .     .. .    . .  .   .   .  ..   .
..    .. ..   .. . ...   .    .. .   .   ..    .. .. .   ..   .   .  . .      .  ...              ..  .  .     . .  . . .
. .    . ..        ....       .   . .  ..  .     .  .. ..  .   .     .    . . .  ...  . .  ...        .    . .        ...
.    .  ...  ..  .    .       .       .. ...    .    . .      .  .     .         .... .      .    .   .    .  ..    . ...
.  ...     ... .         .   .. ...  . . .          .         ... . .   .   ..  ....    . ...   .   .   ..     .   . .. .
.   .       .          ..   . .           .  .  .      .. . ..  .  .         ...         .  ..  . .  .. ..     . . .    .
.  ...  .    .. .    .    ..    ..          .   .        .   .. .   .   . .  . ... .        .    .  .        ..  ...  . .
.     .. .    .    .  . .   .... .  ..        .. .      . ......       ..        ..   ..  .  .        . ..  .  ..       .
.      . ..  .  .   .    .   . ... .  .     ..    . . ..  . . .  . .       .   . . .                  .  .    .   .  .  .
..      .. ..    ..  .... .     ...    .  ..     .. . .       . .      .           ...      ...          ..  ... .  .   .
. .    .   . .  .    .    .. . .... .. ...     .   ..       .  .  . ..  ..... .   .           . .  .. ..   .          ...
. . . . .      . .  .                 .   .  .   . .   . .   ..           .   .  .  .  .   ...  .  . . ....   .     . . .
...         .        ..  .      . .   .   ... .      .      . .       ...  .    . .         .  .         ..  .  .     . .
.         ..   . .  .  .  . . .   . . . . . ..  . . .  .      .   ....   .. .  .           .   .             .      .   .
..  ... .  ... . .        . .  .   . ..   .   .. .  . .    . ... . . .     . . .  ..   .. ...   . .   .  .   ...    .....
. . . .    .        .  .   .   .        .           ..     ..  ... ..    . . .     . ...    . .   .   . . ..   .    .. ..
.     . .         ... ..  .. ..      .            ..         .    ...   ... .    ...      .    .     ..  ...  .   .    ..
. ..  .       .    .  . .        .. .  . . .  ..    . . .  .   .  .. ... .      .  . . ..  ..   .  .. ..    . .  .  . . .
..   .       .   .   .   . . .   . .  .      .  .       ..  .            .    .    . .   .   . .    .     .  .   .   .  .
... .     ..  ...    .   . . .    ..  ...   .  .. .      ..    .   .. .         .   .    . .   .  . .. . .     .    .   .
.. .  .       .. .  . . ..   ...... .    ...   .       .        .  .       .          .  . .. ...  ..        ..        ..
.   . .    .   ..  . .      .. . ..  ..   .   . . .   .    .  . .    . . .  .. .        .    .          . .  .  .  .    .
.       . ... .  .   .... .          .    . .      ......... .   . ....  .  .      ..   .  .. .  ..   . . .  ..      .  .
. .            . .       .. .. . . ..    . .....   ...   .    .   .  .   .        .   ..        ..       . . .     . . ..
. ....    .   .      ..  .  ...   .   .   .  .   .     . ..  .          ....        . ..    .       .         ..  .   ...
.. ... .   .   . . ...   .   .  ....   ..  .        .      . .     ...                .           .  .. ... . . .     . .
.    ..  .   .  .    ....       ..    .   . ........            .     . ......    .   .       . .     . ..  .  ..       .
.  .        ...  .   .   .  ...  .  .    .        . . .    .  ..       .. .. .     .   .     .. ..  . . .   ..   .  .   .
.  .    ..    ..  .           .     .     .    .   ..  ...            ..              . ..    .. .    ..  .   . .       .
. . .       .. .       . . .       .     .      .  ..       .      .  .    X  ..           .  .  .. .       . . .   .   .
. .   .          .....     .          .   .            ..    .   .... .  .. . .   .   .  ... .      .. .  .   .. . .. ...
.     .   ..  ..... . .  .   ..  .    . .. .       .         . .  .  ...  . .  .  ...   .. ..       .     .     .. ..   .
.      .     .   ....   .  . ..                   .     . .        .. .. . . .   .    ...  .      .    ..           . . .
.     ..  .  . .  ...   .. . .   ..   .. .  .                  .. .   . .   ...     .   .   .    .   .   .  .     .    ..
.     .  . .   . . ..    .    . .    .   .. . ..      .   .      .  ...           ... .   ...  .      .  .       ... . ..
. . .  .   . .  .  ... .  .        .       ...    ..  . ..      . .    .. ..   .   ..   ... ..  .  .. . ..    .     ..  .
...        .   .  .  ...          .... .   .    ...  ..    .  .    . . . ...    .    .  .  .    .       ..  .    .    . .
.       .    . . .          ...  .     .   . .  .   .    .        .... .    .    .   ...  .   .    .   ..  .    .. .  ...
. .              .   .     . . ..         ..   . .    . .   ...    .   .     .   . ...  . .   ..  . ...              .  .
.  .  .  .  ..    ..    . .  .    . ..  ..      .   .      . .  .  . .. . ....  .    .  . . . . .. .  .                ..
.   .     .  ...     .   .   .     .    ..           .            ..  .. . .. .. .. .. .  .  ..  . .. .    .. .    . . ..
..     ..  .         . .  ..       ..             . .    ...    . .  ..    .     .   . .    . .     . ..      . .  ..   .
.      . . .  ..    ..       .   .    . .   .  .     .. .   .   .  .  .  .    .   . .    .....    . .  . .  . ....  ..  .
.  ... ...   .. .  ..  .       .   .    ..     .       . ..      ..         ...    .    .  ....  .   .    .     .  .  ...
.  ...    .    .  .  .        . ..     ..              . .           .         .    .      ... .      ..    .    . .. ...
.  .   .. ..  .      .       . .      . .   .   .     ...    . ..     .  .   ....  . . . . .    .  .    .. . .   . . .  .
.  . .       .. .   ..     . ..  .  .          ..     ..      .         .    .    . . .     ...     .        .     . .  .
....  . ..   ..  .       .         . .   ..       .    .     . .   . .   ..      .   .  .    .      .      . . .     .. .
.   .. .      .    ..  .  .     . .   . ..           ....     .  . . .  .   .      ...   ...   . . ...    .    .  ..... .
.   .          ..  .     .  ..  . .   ... .  ...     ...     .  .  ..  ....    ....     .  .  . ..  .    .       . ......
.      . . ...     ......   .   . . ..     .   . ..    .     . .   .      .  .   ..   .  .       ..        .  .  . .  . .
.    .  . .    .      .     .      .   . . ..          . . ..      .   . .   ..  .         .   ... . .  . ... ..    . . .
.     .         ..  .   . ....  .         .   .     . . .    .  . . ..  .     .          ... ...  . .                 . .
...      .        ..   . .  .   . ..  .      ..   .       .     .  ... ..        ...  .      ..   .. ...       ..  .   ..
...      .   .     .       . .  ....  . .     .              .. . .    .   .   .    ..  . .  .  .         ..    .  .    .
.  . .  .  .     .  .   . .      . .. .. ..    .      .    .   . ..  .    ....  . .      . .  .  .     .  .    .  .  .  .
.. ..        .   .. .  .  .    . .. .  ..     ..   . .    .  .  .   .  .  ..  .   .  . .                   .         ....
.   .    .         ..    . ..   . ..  ..  .    .      .    . .  .    . ..  ..   .      .     .   .   . .. .   .   .     .
.    ...  .   . .   .    .. ... .  .  ... .           . .        .          ....     .    .   .          .   .   .  ..  .
....  .    ..          .      .       ..  .    .....         .       ..  .. .    .   .. .  .            .    ..   ..... .
.   ..   .  .  .     ..  .. .. ..    .  .    .       . .    . .  .        .. .  .  ..  .  .. .          .. ..   .  . .. .
.........................................................................................................................
