..........................................................................................................................
.  . .   .   .        ..  ....    .    .. ...  .      .  ...   .   ...      .     . ..        ..      . .   ...  .  .   ..
. . . .... .     .  ..  . .   .  .. .    .    . . .  . ..     .    .   .           . ..      .  ..  .  .   .        .    .
...  .   ..   .    .  .   .    .... .. . .   .         .  .          . ..   .   . .  .  .     ...      . .  .  .     .   .
.. . .      .    .             .... . .     .         ... .  ..  .   . . .          .        . .  .  .    .   . .    .  ..
.     .    ..       .. .      ..   .   .   . ..     .. ..  ..           . . .  .   . . .               ... .  ... . .   ..
..   ..  .    . ..     .        .    .   . .   .          .         .  . .  .   .  . .. .   . . .   . .    ..         .  .
....     .. ..      .   . .  .    .     .            . .   .  .     ....     .. .     .      .           .. .  .  . .   ..
..  .  .   .    ....          .  .   . .             . . ...   .     .         .  .      .. .  .   .  .     .  ...  .    .
. .....      .. ..   .       .   .    ...        ..    . .    .   .. .  ..      ..  .    .   ...   .  ...  .     .   . ...
. ..   . .   .. . ..  . . ..   .  .   .  ..  .    ...    .    . ...    .    . . . ..    ..       . ...  ..      .    ... .
. .. ..           .  ...   ..  . ... ..            ..    .      . ..       .   . .   .... .           .    . .. . . .  . .
. ..    .  .     ..   . ....     ..  ..   .   .      .          .   ..    .  .  ..     . . ..    .   ..      .  .. . .  ..
. .  .      ..   .    .  ...  .      . ..           . . .     .  .     .     .   .   ..  . .  ...   .  .   .       . .. ..
.  .   ..      .   .  . ..  ..              .           .   ..    .     ..  .... .  .  .  .. ..   .  .   ..      .  . .  .
.   . .      .           .        .. .  . . .    ....      .    .      .    ..         .     .    . ..      ..           .
.    ..     .        .  .  .    ..  ...  .  .          . . . .  . .  .  .           ...   .    ... . .    . .      . . . .
.    ...     ... .  ...  . ...     .       .. . .  . .. . . . .   .  .       .   . ...    . .      ...        ..         .
..    ..    .  . .          .       .   .  ..  .  ..  . .  ...   ..  ..          ... . . ..     . .  . .  .   .         ..
. ..  .    .   .       .   r .           . ..    . .           .       .  .  .. .    .      .    .   . . . ..    ... .   .
.         .  ... .  .           . .    .  .  . .             ...      . . ..    ..       . ..   .. .  .   .   .     . .  .
.... . . . .  .       .      .    .  .    . ...       .    ... ..  .. .. ..        .. .   .   .  .      . .   .        . .
.  .        .     .   .    .. ...    . .        ..  ..    . ..      .  ..   . .   .    .    .. .    . .     .     . .    .
.. ...  . ... .    . ... ... ...   .  ..    .   . .              ..   ......   .     . .         .    ..    ...  .    . ..
.   .  ... . . ....           .   . .   .   ....    ..    .. . ..    . . .       .       .  .  ..  . ..    . ..     ...  .
. .    . .  .  .  .. . .     .        .   ..  .   .    ..      ......   .. .. .  .    . .  . . ..   . ....             . .
.      .. ... .    .   ...  .     .  .  ..      . .    .     ...  .    ...    .      . ..    .             . .       .   .
. ....   . ..     . .     .     . .      . . . .    .     .   .  .    . .   . .       ... . .   .  .   ..    . .       . .
.... ..   . . .  .   .   .          ... .     .     ..  . . ..     .   .  .    ...     ..  .. .    .               .  .  .
.   ..   . .         .    .. .    ...   . .  . ....     ..    ..      .  . ..     ..      . ....    . .   . ...       .. .
.  . .   .  .   . .  .    .   ..     . . . .. .  ..  ..  ..     ... . ..   .         .    .  . .   .. . .  . . .      .. .
.     . . ... ..      .. ..   . .       . ...    .. ..  .  ...  . ..   . .. .         .    .   .   .  .  .   .    .    ...
.  ..   ....     . .  . ..  ....   .     .      .    .     .  ..        .  .. .  .      . ..... .     . .      .  . . .  .
..    .   .   .. .  .    .    ...  .  .. ..     .      .       .   .  ...              . .  .  ..   .   . . ..       .  ..
.   ... . . .  .... . .  .   ...      .              .     . . .  .         .   .    .   ... ..      ..   .  .       . . .
....  ..   .      .   ..    .             ..        .   ..       . .... .. .. .    ......  .. ..  . .         ..    ...  .
.  .        .  . ..         . .. . .       .    ... .    .  .. .       . .      . .  ...  .    .. .    .         ...    ..
.   .   ...     . . ...      .  . ..  .                  .    . .     . .    . .   .  .              . .  ..   .      . ..
. .    .   .. .  .   .        ..        .     ..      .. . ..  .  ..      .    . .          ..  ..    . ..  ..  .      ...
. . ..       ...     . ..          .        .. .  .   . . . .  .. . . ..   .        ..   .  ...     .           . .      .
..    ... . .  .  . .  .    .   . ..          ..    .             .... .  .  .   .                   .     ..   ..... .  .
. .  .            .   .  .          .         .      . .     .. . .   ..        .. ..        .. .     ......      .. .....
.  . ... .   .     ...      ...       . .   ..      .      .  .      . .          .     .    ..  .   .. .     .  .. . .  .
. .   .  . ... .... ...   .  . .            .  .    ..  . .    .    .    .... ..   ..     .   .. .. .   ...    .. ...    .
. .   . . . . .    . .   .. . .    .   .      .    .   .  .. . .   .   . .         ...      .       . .  . ... ..  . .  ..
. . .  . .  .... . .    .        .  .           .       .     . .       .. ...      . .   .    .  . .   ..  ..        .  .
. ... .. .   .       . .. . .... . .      .      .. .    ..    . .   ..  .  .. . .    .      .  .   ..  .    ... . ..   ..
... . .  .. .  ..   ..  .   ..  .. .     . .. .    . . . .  . . .        .   . .  .. .. .. . .  ....  .        .   ..    .
. .    .   .  .          . . .. .. ..         .      .... ..     . ..     ..       .        .   ..      .. . .        .. .
. .  .       .   ..   . .  .  .. ..  .          .             . . .          . .    .                .  ..      .. ..... .
...  . . ..  . .    . ..   ..     ..           . .      .. .  ..      .   .        .   .. ... .   .  ..         . . .   ..
.    .    .     .....      .  ..  .    . .  .   .     .. .     ...     ..       .  .      .   .  .       ..    .     ..  .
. .  .   ..     .. .      .    ..   .   .       .     ... ..       .     .   .    .         . .      ..    .  ...   ..  ..
.        .      .      . .   .  .   ..       .. .  ....    .. .  . .    .    .. .   ..  ... . .   ..   ..  .      ...  ...
..        ....      . . . ..   ..           . ..     . .     .       . .         . .. .      .  ... . .       ....    .. .
... .    . . .  .      . . .  .     .  ..   .  ...     . .. .  .  . . .     ...  . . ..   .     . ..    .   .     .      .
. ..     ..   .   .    .   .         .     .   ..    .   . ..  .. ..       .   ..      ..  ..     . .  . .     .   .   . .
.    .  .  . . . .  . .    . .        . .     . . .   .          ..    .. .              ...              ..     . ..    .
..    .     .       ..   .. .      ..    .  . ... . . .     .  .     .    .      . .. .. ..          .     .    .    .   .
.  .   ....   . .  .  . .                             . ..     .   .      .   .    .    .  ...   .         ..       ..   .
..     ...  .  .  .  .... . . . .  ...         .  ..   . .  ...  . .     . .     .  ...    .       . ..  . .   ..  .   . .
...  .   .   ..  .    .     ..   ..     . ..   .    ...  ..  .   .. .   .   .  .    .        .         ..    . .        ..
. .  .   . ... . .   . .  .     .    ..       .        .      .  .. . ...  .  .      .           .  .  ..   . ..         .
... .  .       .      . .          .    .       .       .       .     . ...    ..    .      .   .   .           .      . .
.  .   .  .. .   ..     .    .... . .  .   .  .     .   .     .    .  .    .. .           . . .  . .      .    . .  .  . .
.. ..          .  . ...   ..  .            ....   .. . .    .    .  ...  .   .  . . . .    .  .       .      .     . .   .
.  .   .  .    ..      . . .. .  .    . ... . ..       .    .     .    ..   .     .. .  . . .  . ...  .    . .. . . ..   .
.  .  ....  .  .   .. .         .      .    ....            .     .         .  .   ..   .             .. .    ..    . .  .
. . ..     ..           . .  . .     .     ..     ....    .. .        .  .       .  ..  . .. . . .        ..          . ..
..  .. .  .   . .   ...          ..    ...     ..     .         .   ..  ..  .  .. . . .        . .    .  .   . .   . .   .
...      . . .  ..       .  .                   . .            .. .  ..   .            .  .  .         .   .    . ...   ..
......  . . ..  .            .   ..    .              .            .  . . ..           . .   . . ..  .  ... .  . . .    ..
... ...   . .  .    .  .       .     ..    .  . .   . .    ..    ..  .. ..  .... ..    .   .. . .              .   ..  . .
.   ..  .  .   .   .. ..    .      .    . .            . .. .  .       .   ... . ... ..     . ..   .   .             .   .
. ..   .. .  .  .     .   ..  .      .    . .  .. .   .     .   .  .  ..   .    .   .   . .    .     ..  .  . .     .    .
.. .  . ..  .        .   . .     .   . . . .     .       .  ...     .  .   .....     .   .        .  ..    . ..   .     ..
.   . . .       .   .    .                        .    .. . . .      . .   ... ...        .. . . ...    .     . ..      ..
.   . . .        .       .... .    ..  .  .... . ...        .     ..         .     ..     . ..          .. ...           .
..     .    .   .         .  .      .  .          .    .      .  ....   .    .          ..    .           . ..        .  .
.  . .      .    .  .   .       . .    .   .   . .  ..           . .  .  .      .    . ..   .   .    ...         ...     .
. .      . .   ..  . .    .      ... ..   .  . .  . ..   . . .             .    .       .     .   .        .       ..  . .
.. ..   .      ..         .  . .  .      .       .       . . . .   .  .    ..    .        ..    .            .  .. ..    .
. .. . .. .    .   ...  .... .                       ..   ....      . . . . ... .         .   ..    . .    . ..  . ...   .
..        .   .  .    .       .  ....   .........         .    ..      ..    .  .    .   ... .   .     ..  .  .       .  .
.  . .  .    . . ...   ..   ...  .     ..         .. .          . . . . .         ...  . ..    .  .       .  .     .     .
.     ...    .     .   .     .     .  .     .    . . ..    . ..  .  . ...         ..  .  .  . ..... .   ..          ..   .
. .      ...  . ..    .     . .        .  ..  . . .  .   .     .     . . ..  ..     .   .   .  .  .  .  . .    .         .
.           .  . .     .  .   .     .     .     . .       .  ...  . .    .  .     ...  .         . . .     .   .       ...
.      .     ..    .  . ... ..        .. .      .  .   .  . .   .   . .  .     ..   . .  ..  .. ...  . . .               .
..      ...   .      .  .     . .   ...  .   . .        .      .    .     ...  .. ...   ..     .        . . . .  ..    ...
...  .  . . .  ... ..          .   . .  . .     .. .  .      . .    .       .  .     . ... .  .   . ..   .  .   . . .  . .
...   . ..    .           . .   .  .         .. . .  .  .   . .  .  .      .  ....    .      ..   .     . .  ..  .       .
..    ..            .  . ....   .         .  . ..  .      ..        ...   .          .  .   .     . . ..  .  ..   ..     .
.  .  .      ..    .  ...    .  . . .  .      .        .         .          .. ..    .  .  .      .        .    .  .  .. .
..     . . .     .         .  .   .    .    .  ..  . .   .  . .  .  .   . .   .   . .         ...  . .  ...  . ....      .
..    . .  .  .    .  .    .  .  ..      . . .  .  .    .   .     ..       .. .  .   .   .  . .   .    .   .             .
. ..  ..  .  .. . .        . ...     .  . .   .    ..   ...  . .  . ..  . ..     . .   .    . .           .. .        .  .
.       .   .  .          . ..        .. .       . ..          .     ...  .    ... . .  .. . .    ..... ..     .   .   ...
.        ..   .     .. .   .      .   . .. ..    ....     .  ..  . ...   .. .  .      . ..   .   .   ... .      .        .
.  . ..   ..        .   ...    ..     .      .... ..  ..           . .   ..   .   ..   . . . .               .......   ...
.  . ... .       .   . ...      .. .   .  .  .   ..    .  .    ..       ...  . .   ... ....   . . . . .   .  . ..    .   .
. ..     ..  .    .  . .     . .      . .   . ...     .    .  .. .      ..  .  ...     .     .    ..  .  .       ..     ..
..      . .  ...  .       .....   .. . .        ...    .... .     .      .        .   . .  . .  .        .    .   .  .   .
. .. ..  .   . ... .   . .      .          .  . .       ..      ...   .  .     .     . . .      ...       .   .  . ...   .
.         .. .         ... .      .       ... .    . . . .   ..   .        ...   .  .    .      .... ..  . ..     .      .
.... .    . .    ...   ....   .   ..   .  .. . .   .      .  .  . .. .     .. ..  .  ..   .          .  .   .... ..    . .
.  ..   . ..     ... .  . .     ...   . .  . .  .     ..... . .    .  . .         . .     .  .  .   .    .   .  ....     .
. ...       . ...  ... .       .   .   .   .  .  .   .. ...  . .    . ... . ...  . .  .. .X     ..   .   .. .      .     .
......  .   ..    .  .  .  .    . .  .    ..   ..     ......     .. .        .      ...   .                  ....  ..  . .
.    .  ..  .    ..   .   .       .  .  .  .      .     . ..     ... .. ..  .       .       . . .    .  .       ...     ..
.  ..  ..  .       . .  . . . .  .  .. . .   .     . .      .     ..   .      . .  .   .  .   . ..  .   . .       ..  ....
. .  . .   ..  .   .   .    . . .. .         ...   ..        ..    .  .    ..      .. . .     .. . .  .    .  ...        .
.   .  ....    .     . . ..          ....    .      ..    .          .     . .   .      ...        ..    . . ..    ...   .
.. .      .   . .  . .. .          . .   .  .. ..  .. . . .       ..    .. .      . . ....       .    .                 ..
. .  .  .    .  . .. ..   . .      . .   .. . ..    .. .  ..  .   .    .          . .  ...  . .       . .  .  .   . . . ..
. .      ...   .  .         . ..      .    .      ..  .  .    .   .        .  .    .   . ..  . .   .    .    .         . .
....        . . .  .      .   .      . .    ... . . ...  ..   . .  ..    .  .       .  ..    .       . .        . . . ....
.    .. ..  ...   . ..         . .         . .    .   .    .. ..   .      .   . .   . . .. ..       .    . ..    ...     .
.             ...       .      .   . ..   .. .   ..     ...   .    . .     . .. .  ..    . .     .     .  ...   .    ..  .
.      ...  . .  .  .     .   ..  .     ..    .. . .   .  . .  .  .  ..    ..  ..  ..   .  ....    .    .. ..       .    .
.  .   ...   .. ..  .  .      ..          . .   .. ..          .    .   .      .  . .  . . .     . ..   ..    . .     . ..
..........................................................................................................................
