...........................................................................................................................
.  . .  ..     ..         .  .. .     .     .. .     .  ..  . .   .  .           .   .   ...     ...       . .   .      ...
... ....   . .    . ....                       . .  .       .   .  .    .   . ...  .   .    . .   .        . . ..      .  .
.  ..   .     . .             ..    .    . .  .      .  ..   ..     .. .       .      ..   .      .   .  . . ...          .
. . . .   .     .   .          .. .     ....  ...      .. . ..  .   .   .      .        .       ..  ..        ....      ...
. .  ..   . . ...     .      .    .. . .   .  .  ..  .    .  ... .     .. .. . . .  . .  ..   ..    ..  .        .      . .
.. ...  ..    .       . .  ...  . .  . ...     . .   .      .   .      .   . . ...          .  ...      . .  .   . .   .. .
.  .        ....  . .  .     .. . .      .  ..  . .          .                   ..  ..   . . .  ... . .   ......  ..    ..
.  .  . .  ..    .     ... .   .   .  . . .   ..    . .  . ...  .      .    . .   ..    . .      .  .  .   . ..   .. ..   .
. .  . .       ..  . . .     ..... . .   ...            . .. . . . ..       ..            .    .  ..   . .   .            .
.     .   .. .  . . .        .     .. .    . .    . .  .    .    ...  ..    .   .         .          .. ... . .   .       .
..  . .  ....  .  ....     .            . .   .  . .   . .     . . .   .         .   . .     .        .    .        ..  ...
. .  . .......  .   ...  .  .  . .    . ...     .. .           ..            .  .  .    .    .  ... ..          ..  .  .  .
. .    .  .   .                      . . .   .  .  .     .  ...              .  .      .       .     . .. .       .      ..
.  ..  .. ..       .      .  .     ..   .  .   .  .  .. ..      ...    ..    . ...  .    .. .   ..      .  .  .   ..     ..
.   .   ..  ..  ....    . ...      . . .                .  . .   r   .. ..  .  .     .      .    .. ...  . .  .. . .. .   .
..   . . .                 . ..... . .     . . .   ..           .             ...          .    ..   . . .  .      .      .
.  .  .     ..   ...   . .    .     .                       .  ...   .    .  . .   .      . . ..     ...    . .   .  .   ..
. ..     ..  ..  . . .     .. .   .  . ...  . .   .  .    .    ....                 ...         .   ..   ... ... ..    .. .
..  . ...            .    ... ...       .                       .     .        ... .   . . .      ..   ...   ...   .     ..
. . . .      . ..           ... .          ..  .     ..     .    .. ..  . .      .                   .  .     ...  . . .. .
. .    ..  ....  .   .. . ..  ...   ..         . ..       .   ...         . .  .          ...   . .  . .      .   .  .    .
.   . .. ... .   .  . ..          .      .   .    .    ..  .  .    .     .. .    .    .    .  ..    . ... .   ..    ...   .
. .    ...  .    ..  ..        ... .      . ..  . .. ..    .   .   . ..  . ...    .     . ....  .     .  .       .      . .
.   .  .  ..         .   . ..  ..   . ..  . .  ...           ..         .  . . ..  .    ..  .   ...      .    . .   .  .  .
. .     ..    .   . .   ..     ..   ..  ...   . .      .    . . .    .  ..   . .       ....     ..     .     ...  ..    . .
.   ..     .   .  .     ..      .. . .  .    . ..  ...    .  .  . .  . . .      . .       .  . .. .  ...   . .    . ... . .
. .   .  . . .    .  ..    ..  . .. . .  .     . ..     .   ..       .          . .  .  . .    .  ...   .          .      .
. .          ...  .  .  . .      .       . .          .   .  .. .       .  ..  .      .  .       .   .  .     . ....   ....
.. .  . .. ..      . .    .       .       .    .  ..      ..  . .. . .... ..  .   .        .  ...     .   . .. ..      .. .
.     ..     .  .       . .      . .    . . .    . . .    . . .   . .  ...   .  .          ...  .. .    .   .        .    .
. .   .         .        ..  .  .... ..    .. ..              . .   .  .. . .     ..        ...  . ...    .     .   ..  . .
. .... ..   .. .   .      ..    .  ..   .. .   .        ..     .    .  ..                 .. .  .        .  . .. .  .     .
. ...        .  ..  . .     . . .       .      .       .     . .    ...      . .. .  . . .  ... .  .  ..     ...    .     .
.      .   .    .  .      ..   .    .  . . ..  .    .  .   .    .. .      .      .     ...  .  .               .  .     ...
. .   ..    .. . . . .       .      .. .. .    .          .   . ..   ..              .     .  .. . ..  .   .  .    . . .. .
.               .  .   .   .   .     .     ...  .     . . ..  . ..  ..    .       .  .  .   . ..    .       ..  . .       .
.    .    .   .   . ..    .   .....  ..  .  ..     .   .. . . .    .     . .     . . .  .     .      .         ....     ...
..     ...   .  .       ..  . .   .  .     . ..  .   ..        .  .  .  . .      .    .        ...  .       ..   .    ..  .
.    ..    .      . ..     . .  ..      ..    ..  .        ..  ..                             .         ..  .   ...     ...
.  . .       .....        . .   .      ..... .  .   . .  . .          . . .    .  . . .  .         .    ..  ..         .  .
. . .  . .    . .     .     .     . .    .  ..       ..  .     .    .    . .   ..  .. . . . ..   .   .  . . .. . .        .
. . ..  ....   .  ..  .             . .  ..   ..     ..                    .       ..  .  .     .    ..    . .   . .     ..
.    .  .   .       .  ..  .   .  . .        ..     .    .    . .       .. .       .      ..       .    .   . ..          .
... . ..     . . .....        ... ... . . ... .         . . .         . .        . . ..       .     ..   .       .. .     .
...  .   ....   .    . ..  ..     ..     ....    ..  ..   . .  .     ..    .    .    .  .   .        .         .   . .   ..
.  .. .    ..   . .    ... ... . ..     .   .      ..  ..                 . ..   ...    .  .   ..  ..    .  .          . ..
. ..       .     .  .. .             .  ..  .     ....     .        . ..    . ..  .   .   . .   . .    .   .         ..  ..
.   .               ..  .... . .      .    .   .   ..  .      .    .      . ...     .  ..... .        .. .  .             .
.     .  ..       .   .   .  ...   .   . .   .        .. .        ..   .     .           .       ..   .           .    .. .
.      .     .. .   . .  .    ...     .     . . . . .      .     .  .   .            .     . ..  . .   .. . .  ..     .  ..
.    .    . ..    .  . .        . ...  . .  .       .   .     .   .    .  ...     . .. ..  . ..       .         ....      .
...   .     ...  .  .  .       ..  ..  . .  .  .   .. ..  .             ..       . ... . . .. .    ...  . ..  . .. .      .
.  .       . . .     . .. . . . . .   . ..   .   .         .  . .... .       .  .  ..      .   .        .    ... . .   .  .
.  . . . .. .    . ...  .   .    .       . .     .        .. ....   .  ....   .  ....    .. .    .      ..     .      . . .
.. . .    ...  . . .      .. .     . .      .  .  . .    .  ...    .  ..  ..  . .                .     .  ...       .    ..
.    .     ..    .  . .   .  .    . ..    .       .   ..      ...       .   .     .    .  .. .  .           .         . . .
.         .    . .. .  .. ...  .  .         .   .        .. .  ..    . .     ..   ..  .  .       .    . ..      .  . . .. .
..       .   . ..   .  ..  ..     .  .  . . .. .  . .      ..  ..... .    ... .  . .. .       .  . ....    .. ..   .      .
.  .   ... ..     . .     . . .  .. .           .    .    . .  .         ..            .      ..  . . ..    .   ..   .. ...
....  .....   . .. ..            .. .     ...    . .  ..   .   .   .          .     . . . . . .    .   .      .       .   .
. .      . .  .. . .   .            .    ...       . .        . .   .     ..     ....  .  .    .       . ..    .    ..   ..
..     .       .   .  .   . . .....   .. . .. .  ... .      .  .     .        .. .    . .  .. ..   .  ..         .       ..
.. .    ... ....  ..      .   .  . . . .      . .    .      . . .        ...   .   ...      .       .   .          .. . . .
.  .  .      . .  ..  .             .  .      . . ..    .         ..     .   . .   .  . .             ..  .    .      ..  .
. . ...  .  .  . .       .       .      .   .   .       .. ..  .       .   .  .  ..        .  .     .   ..  . .    .  .   .
.. .   .      .   .  .   ..          . .   ..            ..   .  .          . .   ..     .  ..  . .    .  ..  . ..  .  .  .
.   .   . .   . .. .       ..  .     .  ..  .... ...  .    .. .                 .  .        .       .  . ...   . ..  .    .
.  .  . . .  .  . ...  .. .  ..  .  ..  . . ..   .    .. .  .  .  .              ... .  .                      ... .    . .
.     .   ...  .     .  . ..      ..     .. .   .  . .... ..  .   .     .  .   . .. .      . .  .   .    ..  . .          .
.  .   .  .          . . . .      .   .    .    .  ...     .  . ..     . ... .  .. .   .      . .. .            .  . .    .
.   ..  .  . .  .  .      .      . .          .   . .   ..  ..   .    . ..   .  .  .    ..   .  .      .   .    .   .     .
... .. . . .      . .   .. .       .   .       . . .  . .       .     .  .      .  .     .  . .     .   .  .  . ..  ...   .
.    . . . ..  ... . .. .    ..                 .         .                 ..    .      . . .   .  .    .  .      .    . .
.  . .        . ... .. .   .   ...    .   .       . ...   ...     . .  .      .     ..  ..   .    ..  ....   .      . . ...
.  .. .     . . .     .    .... . ... .        .     .       .  ..     . . .     .   ..  .   .   .    .    ..     ..    ...
.   ...     . . .  .....   . . .           .  . ...    ..             . . .   .       . . . .     .       . .         . . .
. . ..                 .   ..  .    ...        ..   .  . .. .     ..             .       ..   .   .. .        . .   .  .  .
.   . .   ..   ..     . .  .         . .     .   .  ..... .. .   .         . .  . ..     .  ...    . .       . ..  . .. ...
.. ....     ....    .   .   . .    .     . .        .   . .      .    .    .     . .   .    . ..   . .   ..  . .         ..
.    .   .      . .   . . .   ... ..  ...   . .   . .. .  ... .     .   .  .. . .  . ..     ..      .    ....      . .  ...
..     .  ..                   .    .  .  ..         . . .           . ..   . .   .  ..         .. .. ..    ..    .  ..  ..
.            . .  .   . ..      .     . .       .       .   .    .    .     ... .   .     .   ... .    ..          .  ..  .
.. . . . . .  . .     .  .....    .. ..         .    .  . ... . . . .  .  ... .    .. .       . . .  .   ..   .           .
.  .       .   .      . . .   .  .     . .. ..    .   .     .  .  . .. .. ...         .      .  .   .  . .  . .    .      .
...  .     ..  . .             . .  . ..      .         ...  ..    . .   .  .  . ..    .    . ..         ..     . ..      .
.   .    . . .    ..   .. .  ..    .  .  . . .   ..  . . .  ..  ...    .  .      .   . ..     .     ..  .   . .   ..   . ..
.    .  .  .. .    . .. .. ...  . .      .        .           .   .      .      . ..  .  . .    ..   .   ..   . .  .  .   .
.      . .    .      ..  .   . .. . . . ...    .      .   .     .       ...    ..      .. ... . ..       ..   . . .      ..
.    . . .... ..   .  ..  . .             ..         ....  .        ..  .       .          ...  ..      . .. ....    .    .
. ..           .      .   . .     . ..    .   .     .   .       ..  .  ..  . .. .. .    . .     . .       .   .      ... ..
..    .. ..    .   .    . . . ... .  . ..  .. .. ...    .     .      . .   .. ..    .  .   .  .     .  . ..     ...  .   ..
. .... . .    .. .. .  ....    .  ..  ..  . .  .     .   ..    .... .   ..   .  . .       .     .        .   ...   .   . ..
.. ..   . . ..   . .   .        .. ..  . ..        .     .  .  ...     . .       .     ..   . . . .       . ..  ..  .... ..
.  .    . . ...     .  ....     .  .               .  .            .. .. .. . .  . .  .    ..  . . . .    . .   .   .... ..
.     .  .  ..       .         ..  . .. .    .    ... .   .  ..   .     .  ...... .  ... .   . . .  .       . .   .  . .. .
.  .   ...   . .    .  . . .   .   .  .   .     .. .   .. .      .     .    .. .      .  . .  ..   .    . .    .. . .     .
..   ..  .  .   .   .  ..   . .      ..  ..   .   ..    . ...  ..   .  . .            .     .   . .  .      ..  .. .   .  .
...    ..       . . ..      ... .      .  .    .      .     .   . . .     .  ....    .  .    .         ..   .  .. . .     .
.    ..   . .  .. .    ... .        .   ..  .   . .    .   .         .  .          .  .   .              . . . .. .  ... ..
..   .  ..        .  . ..   .... .  .   .   . . ...   ...        . . ... . .   ...  ..             .   .    . .    . ..  ..
.. . .    .      ..                 ... .    .       .        .  .       .. .       . ....    .. ..     ...  .. . .  . .. .
...  .   .      .   .  .. .     . ..  .     .  ...          . ..      . ..      ..     ..    ..  ..     ..  . . .     . . .
.   ..  .  .. .    .. .       . .     . .  ..    .         .         ... ...     . .. .     ..      .   . .        .   .  .
..        .  .   . ....  .    .  . .. . . ..     . .  ...    . .  . .  .  .      .     ...      . . ..   .         . .    .
..       ...    ....            ..  .. .  .       .    .. ..     .     .  .     ..    . .. ...   . .         .   ...    ...
.. .   . .. ... . ..     . .   . ..            . .    .  .. .   . .. . .   .. .   .  ..  .   .      .  .  ..  .    .  .  ..
..   . .        . .    ..  . .  .          .. .   . .   .    .  .  ..     . .     .             . .    .   .  . .    .... .
.  .     .  .  . .  .     . .....   . ..  .       . .  .      . .    .     .  . ..  ..  X               .  .  ... .   .   .
. ..          ...    .      .    .   . . .    .  .  .  .  ...                  . .    .  .  ... ..         . ..    .   .  .
.     .. .             ...  . .    .....  .     .      .  . .            .....    .. . ...  ..   .      .   ...  ..      ..
. .   ....   ... .  .           ...        ...  .    .   .   . . ..  . ..   .    .    .. .  .     . ..   .  ...    .    . .
.   .  . ..  ..   .  .    .        . .  .      .  . ..  .      . .  .    . .  .  ...     ..       .    ...                .
.. ....  ..  ..  . .       .  . . ..      .     ...  ..... .     ....     .       .   .  ..    ....    .   .  ..        . .
. . .  .     ..      ...  . .  .   . . .  .   . ...  .       .  .  ... .  .     . .  .   .... .   .    ....    .       .  .
. ..      .      .     .      . .    .    .      .    .  ..   .. ....  . .   .  .....      . . ..  . .    . . .    .  .   .
... ..                 .      .     .  . .   ...    .. .   ... .  .     ..    .   .     .    .  .  .  . .    .  ..     .  .
.   .   .. ...    .   . .  ..             . ...  . .   .   .  .     .. .   .    .   ....     .      .         . .      .  .
.    ..    .. ..   .. . .. . ...      .  .  .  .  .    ..  . . . .     . .     .    .          .. . ..  .. ..       .   . .
. .     ..  .   ...  . ..   .  .       .. .   . ..       .  .   ..    .... .     .   .   .  .  .      . ...          ..   .
.       .. ..  ..  .  .. .        .   . .     .  .    .     .  . . .  .    .  . .     . ...            .  . ..   .   . .  .
.. .  .        . . ..  . ..  .  ...  .  .  .     .        .    . ..       . ....  .  .  ..            ..    .   . . . .  ..
...........................................................................................................................
