............................................................................................................................
.    ....    .  ..  .        ...  . ..   ..   .   .    . .          ..  .  . . .     . ..  .      . .   ..    ..  .   ...  .
. .. .   .   .       .  . .   . ..      . . .   .. .    .  .           .      . . .   .    .   .  .        .        .. ... .
.  .  .. .. .    .  .  ...  .   ....         . .   ..        .    .                   .   .       .        . ...       .. ..
.  .   .    .     .       ...        ...       . .   ...   ..  .. .      .  .  .    .       ..     .      . . .   . . . . ..
.   .  . .     .  ..   . .      .... ..    .. .   ..... .  .   .       . . .    .   .      . ...   ...             . .  . ..
.   . ...  .  .. ..   . .      ...       . .  .  ....  .   .              ..  ....  .      ..   . ..  . .     .         .. .
..  .  .   ..  .   .  ...    .         .  .   . .      ... . .     ... .  .  .     . . . ..  .  ... .  .   .           .  ..
. .       .  ..  .   . ..              ..   .     .       .  . .     . .     .    .  ..     . .....   .       ..   .   . . .
.     ..       .    .  ...      . . .   .. .          . ..   .....  .   . .          .   . ..    . ....         ... .  ... .
..  ... . . . .  .   ..   .   .  .  ..... .. .    .  ....      .  ..   .  .    . ..  ..  ..      .   . . . .   ... . ...  ..
.   .     .. .        . ..     .          .           . ..    .  . . . .   .    . .          .         .  ..   ..   . .    .
..  .   . .   .   .   .        ...     ....        . ...          .    ..  .       ..   . .. .  .       .... .    .       ..
..     .     .      . .      .      ..   ..    .  .     ..    .  . .         ..   .      .   ..         ..  .  .  .    .   .
..     .     ..  .     ..  .. .. ..        . . .    ..      .    .  .   .    ..    .    ..    ...   ....     . .. .   ..   .
.   .  .    . .    . . .         .  .    .  .. . ...   .  ... ..     .   .   .     .  . . . . .   ...    .           .     .
. .   .  . .   . ..  .   .. ..  ..  .      . ..     .    .   .   . .....  .  . ..       .        .  .. ..  ...  .  .. .    .
..  .. .  .    . ..  .  .   .    . .   .       .  .   .     .   .    .      ... . .      ...  . . .       .   ..   .  ..  ..
.  . .     .. .    .      . .  .    .     .  . .     . .   ...  . . .       .. . ..     ....     . ..     . .   . .   .    .
. . . .  ..           .   . . .  .    ... .    .  ..   . .. ..   .. . .  ..  . .     . .. .  .    . . ..        ..     .   .
.... .       .     .. .           . . ..     .           ..   .    .    .    .  .        . .         . .         . .     . .
. ..  . .        .  . .            .     .  .   .. .  .  .           .. .          .   . ..  .  .  .  ..         .  .  . ...
.  ..   .  . .  ..            ..  . .     ..      .    .      . .   ..     .  . .   .          . .  .. ...      .... ...   .
. . .   . .   .          ..    .    ..      .     .     .. .      .      .  .  ..        . .       ...          . .        .
..   .      ..      .  .    .  . ..   .  .....             ..    .  ..   .       ...      .    .. .   .             . .    .
.   .  . . . .   .      .     .  .    .   .    ....         .    . .. .            ....       .    .       .  .       .  . .
.  .     . .    .  .    ...      .    . ...     .      .  .  .        . . .  .    .    . ..   .    .  .  . .. .     ..     .
. .... .    ..  ...       .    .   .   .    .   . ..    .    . .  .  .             .  ..  .   ...  .  .   . .    .    .    .
.      ..    . .        ....   .      .. .  . .    ...  . .   . X ..                  ..    ..   .      ...  . . ..        .
.   .  .  ....    .   .  ..    ... .      . .. . ...  ..          . .            .   .      . .   ...   .   .    ...    . ..
.. .     .    .. . . .  ...  .   . . .  . ...  ..    . . .      .     .   .  . .        .   ..   .  .. . . ..            . .
.   .  .     .       .   .         .. .    ..  ..    . ..   .     .         . .  . .   . .    ..     . ..  .. ...       .  .
.     . .  .. . .. .  . .  ...        ..    .    ..  ..    .. .   .       .             . .    ..  . .     .  ..  .    ... .
.    .      ..  ....       ..  .         . ....  ... .    .   ..  . .   .        ... . .   .  . . . .   . .    .. ...  .. ..
.      .      .   ..  .  . .  .       .               ..     .  .    ..  .. .  .    .   . .        .  . . .     ..   . .   .
.      .    .    . .   .   . .    .       ..    . ... .       .  .     . .     .    . . ..  .   . .    ...      ..       . .
.      .. .            ..   ..  . ..   . .  ...    . .     .  .     ..   ..   .  .   . .     .. .   . .. ...   . . .  .    .
.    .   .  .. .  .  .   .        ..  .. .        . ..  .. .  .  .    .         . .        .. .   . .  .          .. .   . .
...  ..     . .    .      .. . .   . . ...     . .. .    . ...     .  .       . .   .  . ..... .. .  ..     .       . . ....
..    .    .      .    ...   ..    .  ...    .    . .. .   ..  .     .      .  . .  .          . .       ... ..  .  .. . ...
.    ..  .. .  .    . . .         . ... .    .   .   .   ..        .   . .  ..       .     ...    ..     .     .         . .
...   . .      ..   .                 ..     ... . ...          .. ..   .    .   .   .. . ...      .      . . ..  . .  . . .
..    . ..   .. .          .. ...... .      . . .     .       ..    ....  .    ...   . ... .  .    . .        .  . .     . .
. .       .     .    . . .   .. .    ..   ..    . ...   . .  .        . .      .        ...  ..  .      .              .....
.. ..          .. .   .  ..  . ...  .. .        ..  . .  . .  . . .   .. .             .    .. .  .    ..    .. . ..  . . ..
. .  ..    .    ..   . .  .       ..  .       ...   .  .  . ....    .   .  . . .  .... . . ..          .. .   ..  .. ...  ..
.. . .        ..       ..   . .  .. . . .....     .  .    . ..          ..  .  . .   .     ..  .     ...  . .  ...  .     ..
.        .   .     .       ... .    . .               .. ..             . .   . .. ..     ....      . .       . ...       ..
. ..   .  . .        .   .  . .    .   .      .      ..       .  .     ..           .       .....    .        .  .  .  .  ..
. .   .   . ..    . .          . ...  .  .   .  .            .  .   .  .        ..             . . .    . ..   .     . .   .
..        .       .  .    .     ...    . ..          .. .    .  ..  ....  .     .      ....      .    .      . ...  .. .  ..
.  .     . .  .   .   . ..  ...  ..      .      .        ..    .  .  . .  .          .       ..  ...  .   .  .     . . .  ..
.  .   .  . . . .   .  . . .  .   .   .  .. ....    .  . .  .     . .                   .    .  .. .  .  ... ..   .  ... . .
.. . .        .   .. .       .     . ...    .          ..     . . . . .         . ..  . .  . .  .   .      .   ...  .. ..  .
. .  .   ..      . .    . .  .. ..    .  ..     .  .   .  ..    .       .       .   ... .       .  ...   .    .. .. . .    .
.  .   .    .  .     .   .  .      ...   ..        . . ... .  ...   ... .    .. ...         .       .    .. .    .    . ....
.    .   ..     .  ..  . ..   .   .. .   .  .   . .  . .   . . . . . ...   .    .    .  ..        .  ..       .    .    ....
.       ...  .   .  .   ..  ...    .. .  .    .. .    .   ..            ..  . . .    ..     ...    .  ... .  .    ....  .. .
.    . . .    ..  . . . .     .          .   ..  .   .    ..  .    .  ..     .    .   .    .     .   ..     .    .  .   .  .
..        .  . ..  .. .     ...   .  . .   .   .  . .  .          ..    .        ..  . .       ..  ..   .   .    ... .   ...
....       . . .   ...       . ..   .  .  ..    . .  .. .         ...     .   .   . . .  .        ...     .  . . .   .     .
.  ..    .  .     . . .    . . .. . . .  .  .  . .         .   . .          . . .   ..   . . ..         . .   .  . . ..    .
.    .  . .    .     .    . . ...    .     ..    .   .   .     .   .. . .  .         .   .   . ...      .   .  .    . ..  ..
. .    . .   . . .        .   . .  .... .        .  .   ...    .   ..    .. ..   .  ..    .   .      .  .     . . .  ....  .
. .    .       .   .    .   . .          . .      .  .     .     .  .      ... .. . ..  .  ..   .                         ..
.  . .          .      .    .         . ..      . .. ..  .  .    .      .    ..     .  .  ..   ..   ...     . .    . .    ..
..  ..      ..  ..    .     . .  .     ..   ....   . .         .    .   .    .     . . .       ..    . .. .    .     ..  ...
.  ..   .  ..         .. . .     .             . ..   .      . .  .              ..    ....    . .                 .. .    .
. . . ....        .      .     . .        ... ..  .    . . .   . .. .  .  . . ....        .     . .. .     .    .  .. .. . .
.. .. . . ..    ..  .         ....           .     ..   .  ..      .  ..       . . .  .   .   . .  .    .    .      .  ..  .
..      .  . . . .   ... .    .   ..     . . .      .    .     . .. . . . .. ... .    ..   .     .  .  . .    .     .     ..
. ...          .  . ...      ..     .      .      .. ..     .     .  . .    . ..   ... .  . .   . .   .... . ..   .    ... .
.     ..      . . .  .    .. .   ..  .  ..   ..  . .   .       . ..      ... .         . . .        .  ..   .. .   .       .
. ..  ...     .        .    . .      .  .. . .  .   .   . .      .   .    .. ...       .           . . .    . .         .. .
.       . .       ...  .  . .           .      .    .   . . .   .    . ..     . .        .  . . . ..   .        ..        ..
.   .    .  .  .. . . .   ..   .    ..         .. .  .            .  ..     .  ... .         . .  ...        .   .    . .  .
.      ..         .      .   .   .    .   . .   . ..  ..    ...            .  .     .   .. . ...   . . .     . .  .        .
. ...     .  .       .. .    .        ..   . .  . . ... .. . .  .  .      . . .        . .  .  .    .  .   .  .  ..  ... . .
...     . .  .      .   ..                 .      . .      . .  ..         .  .        ..   . ..  .   .       .       .  . .
..       . .     .      ...  .  .  .  ..  .   .     . . . ..          . .  .  .    .    .     ..   . .. ..  .     .   . . ..
. .       ..  .  .     ..        .  .        ...   .       ..       ..   ..  .   .  ..     . .. ...  .     .    ..   . ..  .
. .    .     .  ..      .  .    . .    .  .    . ......   .   .   ..   . .    .        .  .   . . . . .   .    . . .      ..
.   . ... ..               . .                  ...      .  ..            . .  . .   . ..  . .  . .       .   ..   ... .   .
.. .....  . ..           .. .  .  . .          .  .. .        .  ...         . .     .  .. .    . ..  .      . ...  . .    .
. .        ..   . .   . ...         . .  . ..  .      .    . .. .  .  .   .       ....       .. ..    .    .  ......  . .. .
.  ..  .   . .    .   ...      .  .    .   .    ..                    . ..     ..   . ...  ..          .      ..    .. ..  .
.           .          . .   .  .  .  . .   . .    .    .. . .    .     ... .       . .   ...    . . . ... .         ....  .
.            . .       .  ...    ..  .    ..  .         ..                   ..   . .   . .  . .  .. . .          ...  ... .
. . .   .   . .     . . .  .. ..      ..    . .  .... .  . .   . .   ..  .  ...    .    .    .  .          .    . .        .
.      .  .  ...... .    . .   .   .  .    .  .             .    .  . ... .    .     .  .       .  .         .   .     .   .
.. ..  .          ...   .            . . .          ..   .  . ..   ..   .   .      .   . . . .. . . ..  . ...   .          .
. .   .   .     ..      .   .  .       . .  . .  . .  . . .   . . .    .. .    ..            ..     .       .        ..    .
.   ......     .    ..    .  .    .     .    .     .  .   .  ..    . .   ... ...  . . .  .    .         .   .    .       ...
.    ..  .   .     .     ..   .        . .      .. . .  ..  . ..        . . ..   .   ..        .           .    ....   ... .
... ...   .  .   .  ... .  ..   .    . .  . .   . .    .     .  . .  .     . ..      .. ..     . . . .. .          .. .    .
.   .   .  ..   .    . ..  .     .      .  ... .. .                 .. .  .    .      ..   .  ..       . .            .   ..
..     . .  .          .      .. .  .       ..  . . ...     .  . .      . ...  ..   .   .  ..  . .       . . .  .    .     .
.  ..      .    ..      ..  .   .   .     . ...     ..    . .   . . .  .  ...    .   .    ..   . .  .   ..     ...     . . .
..   . . .     .   .   .. .   .  . .   ....          .  .   .. .. . . . .  .  .    .  ...   ....  ..   . . .    ..      . ..
.. . .    .   .        .  .. .     .....  .    ..     . .. .  .  . .    .. .        .              .   ..   .. .  .    ..  .
.... ..      . ..  .. .    .  ..      .       . . .       .            .    .        . .  .   .   .    ..  .    ..  .     ..
..  .  .     .. .        . .       .  .   .       .  .  . .  .   .         ... . . ...  ..   . .       ..   .   . ..  . .  .
.  ....   .   ..     .    .       ..  . . .  . .      .      ...   ..    .  .        ..  . . .    .  .          .   .   ....
... . .  .  .      .  . .    ..      . .. .           ...   . .       . .  ..  .   .    .. .        .   .  . .  . .       ..
.  .  .  ...  . ... ..                . ..   ..  .      .. .      . .    .  .   . .   .. . .   .  ..  . .  ..  .. . .  .   .
..      . . ...    ...    .. ..  . .    .      ..     .    .     ..       ..   . ..   .    ..  .          .       .   ..   .
. .          .  .           .       .. ..  ...  ..     . ...  ..  .... .. ...  .  .    . ...  ... ..  .     . .  .. .  .   .
.  .. ..         .. . ..  .             .    .        .  . . .    . .     .   ..  . .     . .    ..         .  .  ..     . .
.. . .     ..  .         .            .  ..  .  ...           ..  .  .           ..     .          .      ...  .           .
..       .     .   . .   .   ....     .  .  . .      ...   .   ....     ...  .    . . ..  . .    ..  .       .... .  .     .
.    ..  .       ..  . ...       .  ..  . .  . ..  .  . .  . ..     ... .    . .  .    ..        .   .      .  .   .   . . .
...   .. .   .   . .      . ....  .  .             . .   .   .. .     .     ..  . . . .          .  .      . .     ...    ..
.  .   ...       . .  .  ......           .    . .   .   .. .. .    .      .  .   . .     .       ..            . ...      .
.   .    ..   . .  ..  .    ..     .   ... .       . .   .  .. . . .   .       .      .. ....  .    . .    .      .     .  .
. . .  ...   . .     . r.. .  .  . .. . . ...  ..   . ..   .  ..  . . . .      ..   . . .                 ..     .  .      .
..   ..   .. .   .  .. ..     .. .   . .  .   .   .      .. ... ...     ... . ..  ..   .       .     ..    ..  . .  . .    .
..   ..  ..     .         ...  ..  . .    .       .  . .  ..   . ..  ..        .   . .     . .     .  . ...   .   .      . .
.    .. . .     .. .    .  .  .    .    . .    . .. .    ....     .   .   . .    .  . ...  ... .... . . .       ..    .   ..
.   .    .  . .   ......  .. .        ..  ..  .    ..  .. .           . .  ...   .   . ..     . .       .        .   .  .  .
.  . .  .   . .. .  . . .  ..    .     .  ...     .  ..    .... .. .  ..  .        .      .     ..  ..     . . ... ... . . .
.    .. . . .    .  ..   .     ..     .         .   .  .   .     .. .     ..  .    .  .     .  .   .    . . .   .         ..
.    .. .    .        ...      .     . . .  . .     . .    . .          ..   .    .             .    ..           .  .  .  .
.  .. .      . .  ..    . ..     .   .   . .  ...          ..         . .  . .... ....        ..    . ... .     . .      . .
............................................................................................................................
