.............................................................................................................................
. .   ... .       . . .. ..      . .. . .   .  .  .  .  .. . .     .  .   .  . . .       .   .        .. . .      ..   ..   .
.   .... .   . .   .  . ...  .   .       .  . ..     ..    ..  .    .       . .  . .   ...  ..   .           ...    . .. .  .
.  . . ...  . . . ..     ..        ... .             .  .   ..   ... .  ..  .   ..       .    . .. . ...   .. ... .   .     .
.  ..  . .  .     .. .  . ..  .    .   .    .     . .       . .. ...       .  . . ...  .. ..      .       .          .  ..  .
.            . . . .        ..  .     .. . .    .   ....    .. ..   . ..  .      .     ..   ..        .  .  .. .    .    .  .
.    . .   .        .   .     .  .  .  . . ...    ..       .....  .. . .  . .       .  .   .   .        .  .    .. .        .
..     .    .   .     .  .    .   . .        .  ...    ...           .    ...  .     .     ...   .  .       . . .   ..    . .
.  .  .  ..  . ..    . .  .   .             . .    ....   ..        .. .    . . . .. ...          .      ... .   .   ..   . .
.   . ..      .  . ..                  .      ..      ..    . .  ... ..  .   .. .       .  .... .    .  .   .      . . .. . .
..  .  . . .      .    .      .      .  .    .     .  .   ..      ..  ... . .. .  . ..   . . .   .  .. .. ...  ..      .  . .
.      .     .      ..  ...   .   . .  .  ..   . .  ..     .  .. .     . . ..     . . .         .    .  . .   . .  ...    . .
. .  ...        .    .   . .   .     . .... .      .          .  .  .  .  .     ..          .     ..      . .  .    . .  .. .
.      .  .   .   .   .  .  . . . . . .      . .   .  .. ....  .  .     .         .  .  ..  .      . .    .     . .    .... .
.     ...  ..  .. ......   . ..  .     . . .....   .  . .    .           .    .     . .  ..  .        .       ....       .  .
... ...     .  .  .     .      .  ...  .      . . .    ..     ...   .  .  .  . .         .    .  . .   .   .  ..    .      ..
... .  . ..    ...        .  . .       .. . . .   .     . .      ..  ..   . .    .  . . .  . . . .       ..   .. ..   ..  . .
.      .     . .. .  . .  . .. .        .            .       ..   .      ..    .   .   .      .          .         .      . .
.     .    . .   . . ..          . . .  . .  ..     .    ..    .  . . ..   . .. .  .        .  .      .    .    . . .  ..   .
.  .       .     .    .   . .   .     .. ..         ..         ..   .       .            .. ...       . ... .  .     .. ..  .
... ..            .   ..   . ..   .      .     . .        .  ..     .     .   ..  .    . ...     .   .   . .  ..  .  ..  .. .
.  ...   .    ..      ..  .  ..   .    .   .. ..  . . ..  ..  .          .     . . ..      .     .      .   . . .         . .
. .. . .        .....     ....  .    .  . . .  .  .   .. .  . . .          .. ..  .  .    .     . .. ..     ..  .  . .  .  ..
..          . .. . .. . ..   .   .    ..   ..   ..    .    .  .   ..               .  . ... .      . ..     .       .    . ..
.  . ... . .       .. . ..    .  .  . .      .   ... ..     . .  ... . ..         .      .  .        .   .     .   ..  .   ..
..  .   .   ..  . .  .  . .         . . . ..   .   ....  .    . .     .   .  . .    . .       .        . .    .    . . . .  .
. . .              . .    .    .       .. .    .   ...    . .       .  .  ..      . .    .. .   ... .     .       ..   . ....
. ..         ...        .   .  .   .. .    ..   . . .   .  .         . . .       .   .    .      .     .  ..       .       ..
.  .     ..  ...   .    . ..    ...    .... ..        ..       ..    .   .  .        .      ..  .  .   .  .    . ..    .    .
.  ..  . .  .  .       .    . .   .   .   .  .  .     . .... .. ..  .         .  .   .      .  .     .      ..     .     .. .
.    . .     . . ..    ..      . .  .        ...     ..   .     ....  .   . .         .   .   . . .       .  .    ... .   ...
. . .    . . .... .      .    ....  .  ..    ...      .   .  ...     ..  .   .      .    ..     .   ..   ...   .  .  ...   ..
.  .  . .. ...  .         . . .     ..       .           .                .   .    .  .    .   .  ..  . .     .             .
.. .   .  ..  .  .   ...           .     . .  . .     . .        . .    . .. .    ..        .  .    .  .... .      .   ...  .
...  .  .  ..  ...  ..   ...    .  .    ...  ...  .     .           ..     .     ..    .     ....   .   .. .   ..  ..   .....
.     .  .  .  . . .   .    .    .  .  . .. ..        .            .     .   . .    . .  .    ..    . .  .  .  .  ..  ..    .
. .   .  .   . . .     .      .    .  .      ..  ...    .         .  . .  .   .      . .   ..   ..     .  .  . .  . .  .    .
....  .. .   ....    .      . ..    .    . .  . .  .   .  . . ..   .               ..   . .   .    . .  ...  . ..   . .    ..
.    .   ..  ....    .    .....    ..   ...         .   .. .        . ... .          .  ..            . .  ..          .    .
.  .   .    ..    . .. .           . .  . .     . .   . ..         . .    . ...        . .     .    . .    . .  .. .  . . ...
.  .    . .     .  .. .   .  ....  ....     .   .     .. .   .         .           .   .   .  . .         ..      .    .    .
. .   .   ..   ..  .  ..        .  .   .   .. .  . .. .. .    ..     . .      .             .        ...  .   .  ..   .     .
. . .  .   . .        .      .. . .  . . .  .   .    .......  .       . . . ..    .     .. .      .           ...    ...    .
.  . .      .  ..  ..  . . ....   .   .  .   .  .. .  .   ..   .   . . .  ..         ... ..   .    .....                 . ..
.. .  .   . .  ..  ..  .   . .   ..     ...   ..        ..  .      .. .   ..    .   ..  . .        .       .  ..  .  . .    .
.     .  .   .. .  .   .    . .    . . .     .      . .     .   . . .  .        .  . .. .  .. ..  .   . . . ..      . ..  . .
.  .  .     .   ...        .   . .    . .     .    . . .  .    . .   .  . .  .     .  .      . . .        .       .  .      .
. .  . .    ..    .  .     .   . .  ...   ..      .    . . .  .  . .  . . . .    . . .        .  . ..  . .    .    ...     ..
...    . . .  . .      .  . . .   .        .    .     ..  . .    .      . ..    . .  .           .. .     . . . .  . ....  ..
. .   .  .   ..       .  .      ..    ..      ..  . ..   . .   ...  .  . .           .        . .  .   ..       . .         .
..     .. ...   .. .    . .. ..                 ... . .   .     .         . .   .  .   ..   ..             .       ..  .  . .
.. ...  .      .    .      . .     .    .    ...            .  .     .... .. .  ...       .. ..    ..        .    .     .   .
... .      . .  . .. .   . . .     . .  ..    .     .    .....      . .  .   . .   .   . . .      ....     .  .     .       .
..   .    ..  . .  .. ..       .    ..              ..     .    .   .        ... . .   ..     ..    .   .  .     .. . .  .. .
.     .     . .. .  .  .     ...   ..  .  .     .   ..     .     ..   .   .. .       .  .    .   .   .  .  ..  .     .     ..
....         .     .  .       .. ..      ..       .  .     .  .  .      .  .   ...  .      . .  ..  .  .     ..  .  ..     ..
.    ...   ..  .  ..      .   ..  .   .    . ..         .. .       . .   .   ...   .      .   .  . ..    .  ..  ...     .   .
.   ..... .  ..    .   .     .    . . . .  .   .   .   .  .        .          .    .  ..... .   . .   .    ..  .    .. .   ..
..  .    . .    .   .  ..   ..    ..      .   .   ..    .. . . .     .    .       .   .      .  .  .   ...... .    . .    . .
..          .   .. .  ..            . . . .  ... .   ...     .   .  ..     .   .    .  .. .    .      .. .   . .    .      ..
.    ..  ..      .   .         . .    .   .  .  .    . .      ...      .... . .  . ..   .    .   ....          .....  .  .  .
.    . .       .  .  ...      .  .        .  . .      ..        .   ...   .   . ..    . .   .  .   .   .   . .  . .  ..     .
. .             . ..         . ...   .     .       . .     .    .  ... ..  .     ..   .              .      . .             .
.     .. .    ..      . .  .   ...   .    ..    .            .       .        .        .   .   . .      .         . .   .  ..
. . .      .      . . . ..          .    . . .        .  . .    . .         .    .    ..  .. ....   ....  . .   .    .    ...
. ..   ..   .   .  .  ...    .  . .   ..  ...  . .   .    ..   ..  .  .  .   .    .. . ..       ...       .     . .  . .. . .
.  . .. ..  .  .  . . ...  .     . ..  .   .       .    .  .  . .. .    . .    .. . .  .    ..  ...      .       . ....    ..
.       .. ...      .. . .     .     . . .  .    . ...  ..          . .. ..  .       .     ...    .  .   .  . .    .        .
..      .  ..      .       .    ..  .    .       .  .  .    .    .    .. .  . ..  . ...   .. .      ..  .. .      .  . ..   .
..  .   ... .     .    ..      .  .     . ..       .. ..     .        .   .  . .   .  . . ..     . .      .  .. .     ....  .
.     .  .       .       .    .     .      .      .  .  . .   .  .. .      .  .    .   . .. ..      .  .   .     .. .  . .  .
.  .        .. .  .  .       .  .       ...  . . . .  .  .  .. .. . .   . .   .   .... .  .  ..    . .     .  ..         .. .
.  ..   .  .. . .  .            . . .  .  ..  .   . . .    . ... .. ..   .   .       . ..  .     . .. .      . . .  .     ...
.  . .        .    .. ... .    .  . .. .    .  .    ... ..   . .   ....    .. .  .    .  . .  ...  .. . ..  .   ..       .  .
..    .         .   .. . . . .    .  ...   . .    .. .     ...     ..   .. . .        .  .    ..    .  .  .       .  ....   .
.   .   ..      .   .            ..    ....      ..      .          . ..   .. . .   .  .   .    .. .    ..  .   .    .  .   .
.       ..   .         ..  ....  .  .   .      ..      .              .    . .    .  .. .   .    .    .  .          .  ..   .
.... .. ... ..  ..  .. .    .             . .  .   .    ..          ..    .   .     .  ..     .   .   .... ..      .  .    ..
...  .  .. . ... .. .  .  . .. .   .    .  ..  .   ..  . .  .... ..   . ...   .   .     . .  . .  ..     .. ..    .  .      .
.     .. .        .....       .     .  .  .  ..        .  .. .   .    ..   ....     .  .    .    ..    .  .             .  ..
.  .   .    . .        ..     .   . .   .  .   .              .     .  .  . .  .  . .   ..    ...  ...   ..  ...    ..   .  .
.  .           .    .. .     .    .  . ..      .   ...   ..  . .   ...                  . . ...     .. ... .   .     . ..  ..
. .  ....    . .  .   . .    ...     . ....  .      .     ....  ...  ..  ..       . ..     ...     . .. .  ...        .   . .
...        . .    . . . .      . .     .   . .  .  .         .      .  . . .     ..  . ..  ..       ..        . .         . .
. .  . .. . .            .   .   ...  . .... ..  .     .. .  .        .     . .   . .     . .  .   .  .  .. .       .    .  .
.    .  .  .     . ..  . ...  .      .. . . ....    ..              .  .            ..   ..   ..       ..      . .    .     .
. .. .      .   . .      . . .   .. .. .   .  .. . .   . .   .      .    .       .  .            .  .  ..     .. .    ..    .
.   .   .  ..  .   ...          .   .  .   ...     .      .    ..     . .. .      . .   .   .   . ..  .       .. .     ..   .
.   .    ... .. ....         .  .                   .. ...  .      .. .           .   .   ..   .   ..   ..  . .     .     . .
. ..    .  .     .. ..    . ...    . ..    .  . .   . ..        .  .    .     .  .        .    .....  .   .   .    .     .  .
.   ..    .. ...    .         .   .   .    .  . .  .  ..              .         ... .   . .  .     .          .  .  .       .
.       ..    . ..  .  .  .     .          .       .   .   .     .  .    .   .  .  . ...     . ..  .           .   .     . ..
..      . . ..   ..            ..    ..   . .  ...  .    . . .. .      . .      ..   .. .                .    . ..   ..     .
.  .      .               ..   . .    .       .  ... .        ......  .      .  .   . . .        ...  .   .   .    . ..     .
. .         ..     .     ....  .  .  . .. ..   . . ..   . .. .  ..   .  ..... ..   . .  ... ...  .  .        ..     .   .   .
.  ..   .            .  .  .  .    .  . .      ..   .    . . .  .  .        .     .   ..  ..  .. .        .. .. .  .  .     .
.  .   .  . . ... ..   ..  ..       .   ..         . .  .    ....   ..   .. ..                .     .  ..  . .           .  .
..    .  .... .  .    ..  .  ..  ..  . .   .   ..  . .       .     ..   ...   ..     . ..   .  ..    .  . . .. .    . . .   .
. ...  ..  .   .    .         . ..    ..  .. .       ....     ..  .    . .  .     .       .   . .   .   .  ..   ..  ...   ...
. . .    .  ....    .. .   .     ..... .   .      .   .    ..    .             .  .  ..  .  . ..   .      ... ..   .     .  .
.. ..  ..    .      .     .  .  . . . .     ...       .     ...        . .     . .            . ...  .  .. ..  . .       .  .
. ..  . .     . ... ..                 .    . .     . .   .. .    .  . ..   .      . .. .. .  . .    .  .  .        .. .. ...
.. .. .. . .   .     .   .. .  . . . .. .     .  ..  .   .  .. . .. .  ..       .  .    . ..                  ..   . .   .  .
. ..   . .         .          ..     . ....    ....     .  .  .     ....  .  .      ..    . . ...      .. .       .  .. . ...
.  ..    .    .  . .                  ..  .    ..  .  ..         . .       ..   .  .  .         . ..     .    ... .      .. .
...  . . .    .    ..  .  .     .    .  . .   .  . . .   ..  .. .  ...         .   .   .   . .. .     . . .          .   .. .
..  .   ..   ..    .       .    .  ..  . .   .     .    .  .  . .       .    ..   .         ..   .    .     . .   .       . .
. .  .  . .     .   . .. .     . . .     .   .    . .  . .    .  .  .   . .        .      ...  ..  ..    ...    ..   .  . . .
. .     .     ..   . .     . .   .  ..      .  ...     .  .  .    ..  .             . ..                . .    .. .    ..   .
..    .    . .      ..      ..     .      .    .    .        ..             .  ..       . . .  . ..  . ..    ..  .   . .    .
.    .  .  .  ..  .   ..   .     .....  . .   ..... .        .    .   . . .       ..     .  . .. .           .      .     ...
.   .  .  .  .     . ...   .   ..      ..    ...   .   ..   . .. .    .   ..    .....  ..     . .  .   . . .     .  . ..  . .
.   .....    . .. .   ..    . ..   ...   .     .    .      .   .     . ...    .    .     .    .  . .  . . .  .   .  ......  .
.   ....  . .  ..  . ..    ..                . .    .. .  ...   .            . .        .     ..    .  ...           .      .
...   .. .       .      .  .       .         .  ...         .   .   .    . .  . . ..    ...    .     . X  ..         . .    .
...   . . . .  .   ......    .. .    .  .. . . .      .   .   .    ...         ..  ..   .  ..   . .   ... .      . .       ..
.  .    .  .    ....  ... . ...   .  .. .               .        ..    .    .              . .  .   .   .  .  .       ..    .
.. .  .             . .     ...   .      ..     ..    ..        ..   ... .     .. .  ..  .      . .    .    .. ... ..       .
.. .  .    .  .   .  .. .   .. .  .  .          .r.  ...    .           ..            .       .    .. .. .             .   ..
...        . . .     ...  .    ..  .. . . ..  .                 .      .      .   .    ..  ..     .      . ..   . .  . ..   .
. .. . . ...  ...      ..  .. ..  .  ...   ..  ... .     .  . . ..    .              .    .   .   . . .  .     .      . ... .
.   .....     ...  ..      .  .   ...  ..           .        . ..     .    ..   . ..   ...     .     . ..  ..      . .      .
.  . .  .   . .    ... . .            .  .  .           .    ....         ..   .. .      .  . . ..          ..    .   ...   .
.        .  .  .      ..  . .   .. . ...   .. .      ....  .      .  ..       .     . . . ..       . .   .          . . .   .
.............................................................................................................................
