..............................................................................................................................
. . .       . .. .    . ..          ...        . .    . ... .     .. .     .       .           .    .  . . .  ...  ..  ...  ..
.      .  .  .      . .  .   .  .. ...... . ... ...      . ..  . . . .   . . .. .  ..                     .      . .    . .  .
..   .    .      ..   ... .           .        .  ..        .       ..            ..          ..           . ....      ...  ..
..         .      .    .     ....  ..         .    .      .               . . .      .  . .   . . .    .    ...    .      . ..
.  ..    ...     . ..      .     .        .  . .     . .  .    .  . .. .     . . .     ..       .  .      .   .   .. .  .  ...
.      ..      .     .       . .         .  .    .       .           . .   ..    .  . . .   .       . . .. .. ..         .   .
. .    .. ... .. ..    .     ..       .      .  .   . .  .. ..    ..   ..    . .             ...  . ..  . ......    ...      .
..  .     ..    ..   ..  .     ..       .    .           ..  .   ..       .... ...     .. .         .       .. ..   .  .    ..
.. .     .  . ..        .  ...  ..  . .  .   .       .     . ...                 ..   . .     ...    .         .....  . ..   .
.    . .  .     .     ...   ...       .       . . .        . . .   ...        .    .      .         .          .       .     .
.. . .   .   . . .   .  .  .  .   . .     . . .. .  .    .    ..     . .  .      .   .     ..    .   .. .        . .     .  ..
.         . . . .  .   ..  ..    ..    . .  .   .   ..  . .   .    . ..     .   .       .   .     . .    .   . .      .  .  ..
.  .  ...     . .. ..    .. .    .    .. .      ..   .  .    ..     .   .         . .   .. .    ....     .. .  .. .. . .    ..
.     .   . .     .. .         ..     . . .     .    .    ..      .    ....   .. .   .     .        .  ..  .. . . .   . . . ..
.. ..     .        . .  .    ..    .   ..    . .. .   . ....         ..  .   ... .  .      .         .   .      .           ..
.. .  .  .. .  .   . ..  .  ..  .      ..  .     .   . .  .     ..  ...  .  ..  . .  .  . ..    ...   ....   ..   .   . ..   .
...   ..  .  ..  .   ..  .. .    . .      .      . . .   .   .      .. .  . .  .         ..   .    .       .    .   .  .  . ..
..   .   .     . .    ..       .. .    . .    .      .     .     .. .        .. ...  ..       .    .   .          .   ..     .
..       .......    . .           .        .         .     .   . ..        .     .   .           ...        .  .       ..  . .
.     . .  .  .... . .     ..  ...       .   ...    . ..  .     ..  ..  ...  ...        . .    .   .   ..    .  ..     .     .
.     ..  . .      .     ...      ..  .   .    .  .    . ..  .  . .  . .       .  ... .  .            . .  ..  ...      .. ...
. .. . .       . .  .    . .       .  .   .. .   ...     .. . .  .        . . .   .. .      .  ..  . .    .  ..      .   .  ..
.    .      ... .          ..  .   .  .. ..                .... .  . .     ..  . ..   .          .   ..     . .      . ..  ...
.. .      ..   .     .  .    ..     .      ...  .   .. .. .  .  .   .. ... .          ......     .  .. .              .   .  .
.. .             ..        . .   . . .          . .  .  .     .    .  ..       ..   .      . .           . . .. .   .    .. ..
.. .  .     .      .    .. .   .   . . . .   .          .  . .     .    .  . . .   ..  .   .           .  . . .     . . . .  .
.       ..  .  . ..  .         . .    .  .  ...       .   ... .         ..       .  ..   .. ..              .  .         .   .
.. .    . .  .   .    ...    ... .      ..   .       .  ..   .    . .  .. .  .       .... .. ..  .  .    . .  .    .       . .
.  .  .   .. . .    .      ...   . .        ..  .                    .   .     . ..... .   . .. .   ..   .   ..              .
.    . .  .. .     .   ...  .   .  .         ..  .  ..   .  .. ..       .    ..   .     ..    . ..     ..   .. . .   . ... . .
.. ... .   .     . .   .  ... ..   ....   .  .. . . ..  .   . . .              . .  .  .  . .  ...... .    ..    ...        ..
. .. .        ..  .     .        .  ... .           .. ...    . ..    .  ... .. .. .    . .          . . ..  ..      .     . .
..   .         . . .   . .... .   ...  .. ..  .. .  ..    ...  .       ..  .. .   .  . .. . . .  .      .     .  .   .    .. .
. ..   ..  .  ..       .  .  ..  .       . .   .   . .   .    .    .  .        ... .   .  ..         .  .   .      . .       .
.   ..   ..     .         ...   . .  .  . .  .       . . . . .  .. .          ..  . .       .. ...    .   .   ...     ..   ...
.     ..     . . .            ...      .  . .  . .  ......       ...   ..    .     .   ..   . . .     .  .. .. . .  .. . .   .
. . . . .   .  . .   .         .   .         ...  ..  ..   .    .  .   . .. .  .    .       .        .   ..    . .. . .  . . .
.  .   . .      ..   .    ..    .. ...      .        ...   .....    .  .     .  ..       . ..      .   .  .  ..   . .. .  .. .
....  . . .        . .   ..     .   ..  .  .  .    .  ...  .... .....    .   .. . .     ...  . . .   .    .   . .....      . .
.   ..       .     ....        .    ..  .         ..  ..        .         ..   ..... .  ..      . .   .     . ..         .   .
. ..              .   ..  .    . .  .      ....    ..  .   .    . ..      .  .    . .   . . ... .. .... . .        . .  .   ..
. .               .   .    . .     .  . . .      .  X .  . . ..  .    .   ...    . .  .   ..  .          .        . .. ..  . .
.    ..  ..             .            ..       .... ....       .        ..          .      .     .      .       .     .  .    .
. ...    . .           .. ...   . ..  .  .  .   . . ..   .   . .  .  .     .  .  .  ...         .         .   .     .        .
.     .. .. .      . .        . .   ..      ..    ...   ..   . ...  ...            .  .        ..          .  ... ..   .   . .
. .   . .... .   ...        . . .     .    ...      . . .... .. ..     ..  ..   .     .      .. ...  .         .. . ..       .
.        .    .   .    .  .      .  .  .        .   .          .  .  .   ...  .   ..          . . .    . .    ..   .  ...    .
.      . .   ..      ....    .    .         .. .  .           .      . ..  .   .        . .  .    . . ....    .     ..   .....
.      .    . .    . . ..   .            .  .. . .  .  .. ...  .  .   .         .  .  .      .  .  .    .      .    . .   .  .
.   .    . .   .. . . .    ..  .      .  .      . ..      .  . .  . .. .  . .   . .  .   .  ...            .. .   ..    .    .
.. ..        .   .  .     ....    ...   .   ..    . .  .  .    .    .     .  ..  .    .     .      .  .  .    .   ...  .     .
...     . . . .  .. .   ..  .    . .          ... ..  . .  .  ...  .  .  .  .  . .     ..   .   .                  . .. .   ..
...  . .  .    . .  . .    .                   .. ..     .       .      .. ..          .  . ....     ..     .          .    ..
.    .  .     ...      ..  .           ..     .     .   .. .        .  . . .               . . .  .   .    .   . ..        ...
.         ..  .  .        .      .  .   ... .   . .       ...  .   .   .. ..  .  . ...   . . ..  .  .    .  ..     .    .    .
..     .    .. .  ..    .  ..                          .         . . .  .  . ...   .  ... .       . ..     .  . .  .   . . ...
.  ..     .     ..   .  ..  .   .  . . . .    .  .      .    ...     .. .  ...   .  ...   . .... .  .    .  .    . .    ...  .
..  .  ..   ...  .     . .    .  .           ..   .         .      .       ...                 .    . ..      .   . .  . . . .
.      . .  ...   ..    ..   .  .  ... .         ..  ....   .    . .      . ..   ...      . ..... .       ..... .... ..  .   .
...   ..            .... .   .  ..  ..... . ..       .. . .    .    .   .    .  .  . .       .     . . . . ..       .        .
. . . .   ......  ..     .   .....  . ..     .      ... .. ..    .    . .    .            ..       .   .   .     .  . . .    .
.          ..       .    .  .  . .  . .         . ..          . ..       .   ...  .   . ..   . .   ..  . ...  .  ..   .     ..
.. .        .     .. . .   ..    . . .      . .  . .  . . .   .        .. .. ..     .  ..    . ...    .  ...     . .   ...   .
.      . ..    ..  ...  . .  . .  . ...  .     .  ..         . . ......    . .     .  .  .      .  .  .  .. ..     . .    .. .
.     . . ...      . .     . . .. .   . . ...    .    .. .  ..  .       . . . .... .  .    .  .   ...   . . .....       .  ...
..  ...   ..        .      . ....   .  .       . .  .      ..  .     .. .   .       .   ..   .    .      . ..   ..  .        .
.  ..    . .  .   .   . .    .. . .        .   .. .  ..  .   . .      .    .... .    .     .     . .. .      . .   .    . .  .
.  ..   .   . ..       .    .  . ..... .  ..  .    . .        .  .  .  .   ..  .   ....    .            . . .....   ..   .   .
. ..  .     . .    . . .   .   .  .       .     .   . .     .. . . .         .        .    ...     . . .  .   .  . .     ..  .
..  ..           .  .         .  . ...      .  .  .     . .           .   .             ..     ..   ..    . . .    . .  . .. .
. .   ..  .    .   .    .  . .  . .     .      .  . .  ..     .  ..... . . .  ..... .   ..    . .       .    .      ..       .
.  .             . ..       . .. .  .  . ... .             . ...    ..     . .. .        .. .      .  ..  . .. . .  . .   .  .
...  .   ..  .      .  .      . .  .           .       .   .    .    . .     . .  ..  ..  .  .   .  .       . ..  .  .    ....
... .     .   .   .   . ....     . . ... . .           .   . . ..        .    .     .  ..r  .   ..      . ..         . ...   .
.. ..  ...    .         .    .  . .       ..  ..         . ...   ... .    .  ..     .    .     . ....   .     .   . .   .    .
......  ..     .     . .      ...  ...                   .    .    ..  ... .   . .     .      . .      . . . . . .. .    ... .
.  . .  .  ...          .    ..     .   .   . ..  . . .. .....  .     . ..      . ..   ..   .   ..    .   ....  ..    ..     .
.   .            . ...  .   . .     . ...   ..    .       ...     .  . ..     .       .. .     ..   .  .     ..   .      .  ..
.    ....      .  .         .    ..  . .   .    ..   .  .  .  ..     .     ...    .  ...  . .       .   . ...  . ..  .       .
. .  ...   ..   .  .. . . .   . .  .    ...  ..         .  .  . . . ... ... . .       .  .    .. ..      ..       .... .  .. .
. .  .   .          .  . . . .   ..  . . .  . .         . .  .     ...... .     .    . .        .            . .      .     ..
.   ..       .    ...       . ..  .    ... .    .     . .  .  .    . .  .. .  .  ..   . . .      ..  .   ..   . ....  .      .
. . .            . .         ..  ..  . ..           .     .  .  ..        . ..   .   . .  . .  . .         . .     . .. .   ..
..      .            ...  ..  . .  .   .    .      .       .     .. .. .   .  .    .     .  .  . .   .   . .       .         .
.    .. . . .. .       .    . .   .      .    . ..   ..       . ..        .. .  ...      ...  ...      ....      .  .     .  .
. .....  . .  .. .    .    .        ... .. .      ....  ...  .  .       .  .   .. . .      . .    . .    .     ..    .  ..  ..
.   .. ..     . .   . .     .      . ..  ..   .   ..  .  .  ...   ..  . . . .   ..          . .  .   .   . ..  .        .  ...
. .  .      ..   .        . ...  .  . .  ..      .  ..        ... .  .    ..  .      . .      .   .  .     ...   .   . .     .
.       . .  .. .         .     .      ..... ..   .  . .  . ..  .     .     ... ..         .         ....       ..    .     ..
.  .  .  . .  .          .  ..          .    ... .   ... .  .  ..     .  .     . .   . ..   ...    .           .  . .  . .   .
.  .  ......      .   .  .             .         .. . ..     .  .                ... .....    ...        .  . .   .  ..      .
.    . .           .   ...  .        ..   .     .  . ..   .     .  ..      . .     .   .  ...   .  .   . ..  .  .  .   . .....
. .    . .  . .  . . . ..  .   .  .  .    ..         .    ..  . .  .. . . . .      ..       ..         ..       .     .. .   .
...  .   .      .  .  . ...  . .     .                   . .  ..       . .       ..    . . . ..   .             ... .   .. . .
..     .        .      . . . .  .   ... .  .    .    .   .             .      . .    .    .  .  . .          . .  .    .   . .
.  .  .  .     . .      .    ..  .                  . .    .       .   .       .    . . .  .  .  .  . . .        .  .    .  ..
.... . .      .   .   .. .   ..  ..  ...       . ... . ....    . .    ...   . ..    ..    .    .        .                  . .
.   .  . .   .   .  ..              . ......  . .   .    .       .  .      .    .    ..          .  .    ..    ..     .      .
.      .     . .    .   . .    .     .    .  ...    ... . .      .    ....   . . .   . ... .  ....    . .    .   .   . .     .
.   . .    ..       .     ..  .. .     .     ..      .. ..   ..     .       .. . ..     . .    .     ...  . . .  . . .       .
... . .     . .      ..   . . ..   . .    . .         .. .   . .       .    .       .  ...     ..     .      . .     .  ...  .
. . .  .  . .   .     ..            .    .       . .. .   . . .    . ..   . . .  .    .   .     ...     ......       .   . . .
.. .        .. .      . ...      . .. .      . .           .       . .    .      . ..      .. .     .           ..  .. .  .  .
.   . .       .. .    . .  .. .. .  . .   ... .  .   .    . . .     .       .. ......      . ..   .  .        . .  .       . .
. .. ... .  .   .       ... . .  . ...    .   . ..    .    .       .      .  ... .     .  ....     .. .   . .   .    .   ... .
.. . .....    .  .     . . . . .  .     .  ..        . . . . ..      ...    .  .   ..     .   .       .. ..       . ..   ... .
. .  .   .       . ...     .  ...  . ...   .   ..    .        .  .  ....   .   .   .    . .  .. . .  . .   .       ..  . .   .
..                     . .. .  .      ..    .. ..      . ... .         . .       .   ..          .   .   .   . .      ..     .
.       . . .  ...    .          ..   .    .  . .  ....     .  .     ..   . . .  . .            .  ..     . .    ...   .     .
.       .    .  . . . .     . . . .  .      .  ..   ...   ..  .. .  .   .  .. . ...      .  .  . ...   .   . .      .  .. .. .
. . .       ..        .  .       ..  .....   .     .  ..  ...  ..       ..   . ..  . ...       ....   .          ....        .
.   ..        . . .   ....   .. .  . ..  .     ..  .    ..  ..    ..   . .     .  .  . .           .   . . .   .        . .  .
.          .   .  ..     . ...  . .           .   .   .   .   ...     . . .        .       . .  .  .     .      ..  .     ....
.    .....  .       ... ..       .    .    . .     .    .. . .. .   .   .. .   . .      . .. .          . .     . .  . .  .. .
.      .      .   .  .    ...  . .   . . .  ..            .       ..  .. .           .          .     .     ....       .     .
...     .     .   ....    .       .  .   .            .     ..  .  .     .       .         ..     .  ..               .    ...
..  ....  .    . . .    . .... ...    .   .   ..   .  .     .. .          .  .           .  .. . .  . . . .     .         . ..
.. . ....   ...      .       .. .. .      . .    .          ...    .. .. .        .  .               ..    .  .    .  .  . . .
.       ..  ..      .. .     .   . .  ...  .   ...  .            .   . .. . .        .   ....     ... .        .       . .   .
..    . .  ..  ... ..... .      .  . . ...     .  .  . ..     ...     .     .   .   .   .          .  . . . .  . . .  .     ..
... .      ..      . ..  ..  .    .  .    ...  ...   .   .    .        ... .  ..      . . .  .  .        .. ...  . ..   .   ..
. .   .    .. .. . ..  .   .   ..  . ..        . .   .   .  .            .   .  .    ...        . ..  . . .     .   . . .. . .
.     .   ..   .. .. .    .. .   . .  . ..  .      ..    .   .           .  .   .. ..  .     .....   .  .     .   .  .       .
.     . .  ..   .    .    ...     .   .    .    .       . .   ..   .     .. .              .. ..    .        .     . . .  .  .
..............................................................................................................................
