...............................................................................................................................
.  ..    . . .... . .    .   .      . .   . .     .  .   .       ....           . .   ..   .  .      . .  . .  .. .           .
.     .. ..         ..   .     . .  ..     .  .       .     .. .   . .   .  .  .... . . ..   .     ...                .  .    .
. . .  .. .         .  .       . .          . ..        ..    ... .  .    . .  . .    .  .               .   .   ..   ..    ...
..  ....   ...   ..                  .  . ...   . . .  . .  ..   ..       .   .    . .  . . .. ..    ..    .  ..  . .   .  .  .
.      . ...         .     . ..       . .   .  .... .    . .  .. .  .        ....        ..   .            .    ...      .   ..
...   ..         .        .  .  . .   .   . .     ..  .    .    .   ..  .  . . ...   .            ...  .    .  .          .   .
.           . ..  .   ..     .  ..  .. .. .  .   .  .   . .     ..         .. ..  .                .  . . .  .      .    . . ..
.. . .  . . .  . .. .  ..  . .       ..  .  . ..          .   .. ...  .  .   ... ..   .          . ..    . .   ..        .. ...
.   .   .  . .          .    ..       .    . .  ... .    .  . .. . ...        .         ...    ..  ....         .  . .     . ..
.. .    .   .  ..     .  .  ... .   ..    . .     . ..  ..         .    .  ..  .       .     ..   ..   .   .     .  .      .  .
..  .     ...         ..  ..   ..  .  . .    ....     ....            ..      .   . . .    . .  .. ...                 ... .. .
..   . .        .    . .   ..  .         .  .     .        . ...   .    .  .            ..  .   .      .   ....  . . .. .     .
.. . .  .   .. .  .   .     .    .   ...      .  . .   .     .  ..... ...  .  ...    . .  .  . ...  .       . .   .    ..    ..
...  . .. ..  .   .  .   ..     .           .  . .  . . .  .. . .   ...   ..   . ...  .   . .  .          .. . .  ...     .   .
.    . . ... . .     ...   .. .  .... .       ..       .      .  .   ..     .         .      . . .  .  .  .. .  .    . . .  . .
. .. ....   .                .  .. ...  .  .     .   .    .   . ..  . ..    ...  .   . .. .        . . .    . .      .   ..  ..
. .   . ..  .      .       .. .. . .     .  . . . .  ..     . ..    ..    .  . .     .....         . ...   ..   . ..         ..
..               .   .  .   .  ..     .. . .   .     . .   .     . .  ..    . .   .      ..       .    .  . .   ..  . .  ..   .
.   .      .  .  .  ...    . ..   .        . . .......      .....            ..   .      ..  .   .. .   .....  ...   . .    . .
.      . .. .    .      ..         .. . ..  ..         . . .   . . ..   .. . . . .       .   .   . .   . . ..     .      ...  .
.      .    ..        .      . ..      .  ...    .      ...... .    ..   .  .            .  .     .      .  .   ..  ..    . ...
.  . .     ..  .   .     ..  .    .   .       . ... .. ..          .    . .           ..          .....  ..              .. . .
.  .  .. .  .. . . .....  .   .      ..   . .  .   .   .   .       ..   .    ..  .         . ..    ..    . .    .      .      .
. .    . ..       . .  .    .. ..  .  ..  .    .  ..     ..           . .  ...  .   . .  .   ... ..    .      .    .  .       .
.  . .    . .   .   ..   .    .       ..       .    . . .    . ..   . . .  ...... .  .    . .  .       . .   . .  .    .   .. .
. .   .           .      .  ..   ...          .  .   .  .  .        .     .             .  .        .   .. .    . . .  .      .
.  ..             .  ....  ..  .   . . .. ..  .  .    .         . .       . . .    .   ..  ...  ..   . .  .  .   .   .  .   . .
....   .  .. ..      . .    . . .   ..  .  . .   .     ...           ..  .    .  .        .      . ..     ..         .   ..   .
.      .  ...              ....   . . .      ..  ..        .   .. .     ..     ..   . ..  .. .   ... .         . .            .
.  .          .. .      .  . .   ..    .  . ..  ..  .  ..    .. .      .            .   . .    .        .   .  .   . . .    ...
.   .    ..             . ..  ...   ..           .   .  ..  .   . .  .  .      .  ..   .  .       ..    .         ..   ..     .
.... .     . .          . ..     .  ...    .        . ...               ..       ... . . .     .     . ... ..    .    . .  .  .
.   ...    . ..     .                  .  .   .     .     .  . .   ...   .      . . .     .     ...  .    . . .  .. ..... .   .
. . .. .  .     .            . .    ..         .      ..    .  .  ..  ... ...  .  .  ...    .      .   . .  .  . .          . .
...   . ..   .      .    ...    .   .   . ... .  . .  .... . .  .  .....     .   . .    ...  ..         . .  ...   . . .  .   .
..   . . .  .   .       .  .       .  ..             .. ..  .  .   ..   ... . ..    . ..   .  .  .       .    . .   .   .     .
..   . .        .. .   . ..  .. ..                      .. .. . .   .     .    .  .   ..  . . ..       ..  ...     .      .   .
.  ...   . .   .   ..   .      . .  .  ...      ..    ...  .  ..  .   .  .   . .  .     ...   .  .    .  .         . .  .   ...
.. .     .     .  .  ...... ..   .   .      ....   .     . .       . .      . .      ..      . .          .. ..               .
..  .   . . . . ....    ..       .   ..   .     ... .    .    .. . .     ..  .  .  ....       . .       ...            . .   ..
. .   .  ..  . .   . . ...      .     .  .     .. .    .           .  ..   .   ......    ...  .  .       ..     .        ..   .
. ..   .   . .      .  .     .  ...  .     .  ..        .  ...           .   ....  .      . . .           .     .   . .   .   .
.  ....   . .            . .... .    .         .  .  .   .  .         r  .    .. . .  . ...       ....   ... ..  .  .  . ..   .
. .  ..   ..... ..    .  ..  . .  . .. .  . ..   .   .  .   .      .     .    .             .   .      . . .     ..           .
.  .   .  .  .   .. .  . .   ...       .       ..  .. .                     ..    .       .            .    .  .    ...     . .
. .        . . .  .  ..  . .   ..    .  . ...    . .. . ... .   ... ..   .. .    .            . ..    .      .   ..  .      . .
.  .  ..      .   .  ..         ..       .       .          .  .       ... .   . . .  .    .  .      ....      . .  ..  ..    .
.    .   .   .  .   .  ...  .  .   .       .   . . .  .           .    ......           ..  .       .  .   ..      .  .  .  ...
..   ..  .   . .   .     ..    .  ..            .   .     ...      .   .        .     . .  .      .   .        ..  .          .
...  ...  . .. ..... .    . .         . .   .  .  . .   ..                  ..   .        .  .... .     . . .    . .   . .... .
.   ..  .      . .       .  ..   ..        . .  . .. ..      .    ..     ..  . .  . .    .     .            .... .  .  . . .  .
.. .    .. .  .       .  .       . .      .        ..  .  .   ..    . .  .. ....       .....  .    .  .  . . ..     .    .    .
. ...         .. . .. .....  .       . .. . .   .      ..  .   ..       .. . .                 ..  .      . .   .      .  ... .
.      .      .    ..       ...   .          . .. ...  .  .     .    . ... . .  .  .. .       .       ..   . .  ..  ..... .   .
.      .  .     .   . .   .    . . ..   .   ..      .            . .. .  .  . .         .       .    .   ... .  . .    . .    .
. ...  . .   .     . .   ..  .    .   .    ..      .    . ..       .  . .         .       .    ..   . . .  .           .     ..
..    .. . ..  .  ..   .. ..   .   .       .    . ... . .. .. .... .  . ...     . .          .  .. .. .     . .  . .   .      .
. .  .   .     ..    . ..   .         .    ...  .  .  .. . .....               .      .  .      .. ...     ...    ..    .     .
. . .  .        ..  .   .  .  ..    .   .        . .   .     .                   ..       .   . . ...        .. .  .  .       .
. . ...... .       .  .           .    ... .. .        ..      ..         ...   .  .   .  .       . .   ..      .    . .   ....
. ..   . ..      . ..  .. ... .. .    . .  .      .. . . .       .     . ..     . .. .     .   .      .  .. . . . ... .   . ...
..        . .     .     .    .     ....      .    . . .      . ..  . .   .  . .           ..  .    ..           ..        .   .
.    ..   .     .  ..    .. . .   .      ..        ...    ..  . .  ..      .  .. .. ..        . . . ...  .       .      .   ...
.   . .          .     .    .. .      .   .  . ..   ..    .    ..  ..   .. .   .  .  .   .  ...  ..  .    . .  .. .  .    . . .
. ..       ..     . .   .      .  .    .    ...       .    .     . .       .        .. .     . .   .  .    .    .. .       .. .
.    .. .... .. ....  . ..  ..  ... ....       .  .. .     .  ..  .          .    ...    .    .     .   .  .    . .  .        .
.   .      ..  ..       .    ...    .    .  .   . . .        .      .           ..     .    .. .         .  .   . ..    .  .  .
.  .       .  .       .   .   . .   ..  . . .. . . ......    ...  .  .  ...  ... . .   .         .   .   .     ... ..        ..
.. .    .  .  .  ..  .  .   . . .      . .          .. ...       ..     ..   .    . ..    .   . . ...       ..  .   .         .
. .    .   .. .  . .   .  ..   . .     ...      ..  .  .  .   . . .       . . .    ...     .    .  . . .     .       .  . . . .
.. .       .    . .. . .      .. . .  ..   ..   .      ...  ...    . .  .   .  .        ..    . . .  .   .  ..   .. .    ..  ..
....  .  .         ..    . .    .      .   . .  ... .  ... ...  ...     ..          .     .  .   .   .   .            .  ...  .
. .     .  ...    . .   .   .. . . ..  ..  .    . .    ....  .      .   . .... ... .    .. .       .    .  . . .            . .
.    .    .  ...         .       .   .. .     ..  . .   . .  ..           . ...   .... . .. . . ..        .   .      .    .   .
.   .   .. .        .. .  .  . .. ... ..           .       .    ..     ..    ..    .....    .. .     .  . .      .    .    .. .
..  .. .  .  .    .   . ...       .. .   .   . .      ..  .   ..  . . .          .   . . .    .         . .    .    ..   .   ..
.  ...   .  . ..   .. ..  .   .   .      .  .           .   .        .   . . ..  ..    .     .  .    .  .  .          . .    ..
..   ... . ..      ....  .  ..  . .             .  .  .   ...  ..  . .      .. .  .. . . . .   ... ..   . ....      .        ..
. . . .    ..     .           .         .    ..   .. .  .          .  ..  ..... . .. . . .  . .. .    ... .  .  .    ...   .  .
.    .. .     .    . . . ..           .          .          ..    .     .... ..     .. .         . ...    .               . . .
..          .  X.     .. ..  .     .  .     . .   . ..     . .  ...   ..  . .  .....  ..    ..    . . .  .  ..  . .  ..     ...
.    ..     .  .   .     .    .               .   ..      . ..  . . .   . .    ..  .  ..  . .    .          .    . .  ....  ...
. ...   ..       . ..    . . . .  . .                ..  .               .  .       .  .  .   . ..      .  .  ..       .... . .
.  .   . .  . .   .. ....        . .       .. .  .        .   . .       .        ...   .     .  .    .. ...      .  .  .    . .
.  .      . . . ..     .   .  .  .   .    . .      .   . .      .  .. ..  .  .. .. . .   .   .  . . .    .   .. . .   . .     .
.      . .  . .   .. . ..           ..  .     .   .           ..   .  . . . .      .   .  .     .  .. ..... .  .  .   . ...   .
.  . .  ... .      .  .. . ...        .     ..     .      ...  .   .      .        . ...     .           .     ..  ..   . .   .
.  .  . . .        .. . . . . .   . .     .    . ..     . ...   .  .   .  . . .  .    ......  ....   .     . .                .
.  ....    ..  .         .  .  .    .     .   .    . .  ..  .   .     .   . .    .  .   ..     ...    .  .    ..   .. . .. . ..
..     ..... .    .  .   .     .    .  .        ..    .  ...   .   .   .         ..  ..       ..    ....       .. .   .      ..
..     .            .   . ... . ..    .  . ... ..           .  ..    .  .   .     ...   . ... .  .    .  .    .        . .    .
. . .   .   .         ..          . .          ..  .    . .  .   .  . .. .     . .       ..     .. .  .      ... ...  .  .   ..
. . .  .       .   .. ..     .   .       ..      .. .  ..    .  .                .  .  .  .   ...  . . .            .. .. . . .
.       .. .     .    .. .  ..      .     . . .      .          . .  .. .   . .    .   .      .       .        ... .. . ..   ..
. .        .. .  .   .   . .  .         .. .  .      ..    .  . . . ..  .  .      .. .     .      . ..      . . .  .  .       .
. .  . .. .     .. .          . . ...      .    .    ... .   .    .  ..     .        ..    . . ..  .. ..    ..     .    .  .  .
.        . .          ....   .     .. .       ...   .. ... .. . .  .  . ..          .  .   .         ...      . .     ..  .   .
. .   .   .   . .     ..  .  .  .  .    .  .. .     ..      .     ..         .  .. ..     . . . .    .  .   . .. .   ..  .    .
.. .. ...  .     .     ..         ..   .      .   . .  .   .    ...  .     .. .  .    .   .  .  .          . . . .  . . . ..  .
. .   .. .   ... . .. .  .     .            ..  ..      .  ..            . .  .  .              .    .  .     ..    . . .     .
. .   .  .. . ..    ..      ....  .      .    ...   .  .          .  .       .        .  .          ..    . .   .     .. .    .
.  .   ..    .   ... .  .    ...    .     ..   ..   .      ...          ..    ..   .    . . .  ..    .  ....          .   .   .
..  .  .  .      .  .       . . .   . .  .      . .    ..  .   .    .   .            ..   . .  ..             ..  . .   .    ..
.         ..    . .     .  .    .. ..  .         .   . .   .      . .   .    .    .  ......      .. ..   ..     .   . .      ..
.              .   . . .    .  .  .  .. .  .  .            .    ..     .  ..  .  .   ..   . .      .  . .    . ..  .   .     ..
. .  . .      ..  .    .    .         .       .   .   .  . .  ..  ..        .   . . .   .  ...     . .        .       ...     .
.  .    .....  . ..    .  .  . .     .  ..     .  ..     .   .  ..  . .. ..    . .   .        . .  .. ..   .    .  . .   ..   .
. ....          ..     .      .     .. .    . .  ..  .    ....  .   .  . .  .  .   .            .     .  ..       ..  . .   . .
.   . .        .   . .      .      . . . ..   ..    .       .  . .            .  .   ..    .   .  . .   ... ..  ..      .  ....
..    . .   . ..  . .        . .   .  ..    . . .      .. . ..  . . .  ... .   .    .      ..      .  .  .   ..      ..       .
.  ... .. .   .   .                .  .    . ..    .  . .        .  ..  .      ... .      ..   .        .... .   ..  .......  .
.. ..    .. . .        .  . ..    .            .. ..     ..   . .  ..   .     .  .    .  ...  .. .       ..  .     .. .     . .
.. .   . .     .   .      .       . .   . ..         .  ....    .    .         ....   . ..  ....  . .     ..      .   ..  ..  .
..  . .  .        .  .  .  .   . ..    .  .... . .     ....    .   . . .     .      .      .     .   .  . .     ......        .
..      . ..     ..    .. .  . .. .  .    .      .   ..     ....     ..    ..  .   ... ..    .  . ..     .  .   ..  ..  .     .
. .       ..    . . .  .  .   . . .  . . .    ..        .. ..   ..        . ..        ..    .        .   .. .  .  .  ..   . . .
. ..  .  .    .....      .  .  .     .       .         .....  .  .         ..    ..   ..  .  .     .   .         ..   ..      .
.   . .   .     .  .  .      .   .  . .           .      .  . .    .   ..  . .  . .  ... .        ..  . .  .           .     ..
....     .    .     .  ..    .  .  . .     .   . .     .    . .  .. .    .   .   .   .  ..  .           . .     . . ..  .     .
.  .    .    . .  ..                    . ...            .  .     . .  . .    . . .   ...    .  .   ..     .       .....   .. .
.  . .    .      . . .      .   .. .     . . .      .. ...    . ...     ... ..  . .   .       .      .. ..       .. ....      .
.     .   ..     ...     .. . .. .  .   ... .     .   .   ..     .   . .... .        ...  ....     .    .     .      .    .   .
.  .  .  .  . ..        ..    .    ..     .....   . .      .. .    .       .  .          ..   .     ..   .. ..  .  .. .  ..   .
...  . .    .    .      .   .  .    .  .    .  .   ..  .    .   .  .   .... ..       . .  .  ...  . .    .. . . .       . .   .
. .   .    .. .      . ..  .  .    . ..  .. .. ...  .     .. .. .. .   .      .   . . .      .  .     .  . .     .     .. .  ..
...............................................................................................................................
