................................................................................................................................
.  .  .  . . .. .. .   .  .     .  .  .       .    .   . .. .    . .       .  .     . ..  .    ....       . ..   .   . .    .  .
.  . . ...    .       . .   ....  .  . . .    ... .     .      .   . .   .          . ..              .         .. .  .     .  .
.  .           .    .            .  .    ..      .     ..  .      .   .             .  .     .. .  . . . .. .. .   .  . . . .  .
..   .. . ...       . .  . . ..  .    .  .  .  ..    . .. . . . .  . . . . .      .  .  .    .  .  .     ... . .     ..       ..
..   . .   ..    ..   .     . . .   ..    .    . ..  . ..    .     .   .   ..       .      . .       .  .. . .        .     .  .
.   ..   . .       .  ..          .   ..    . .   . . .  .   .    .     . .. . ..       . .. .   . . .         .    .  .   .. ..
. . ....  .   . .   .        .      .    .       . .  .    ..       .    .  .   .          ..      . .          .  .      .   ..
.             . ..  .         .       .     .      .  ...    .. ..     . .   .. .   .    ... .  .. .    . ..  .    ...  .  .  ..
. .  .    ...    . ...     . .   .      .  . .      .. ..  .  ... . ....  . ...    .      . .  .       .         .    . .. .   .
... . .  .. .      . ..    .       . ...   .. . ....   ..  . .. ..   ...      .     .     .. .   .             .      . .   .  .
.             ...  .        . .   . .     .  .  .  .   . .    ..      ... ..    ..            .. ...  ..  .    .  .       ...  .
.    .        .. . . .  .   ....  ..  .  . . .    .     .  . ...     .    .   ..  ..    .   . ...         ....        . .... ...
.         .  ..   . .    .     .       .   .   .   .. .  .  .    .   ..  .    . ..      ..    .            .              .  ...
.             .....   ..  ..  . .         . .    .. ..   ..    .       ...  ...  ..   ..  . .   .  .   . .            .. . ..  .
..                ... . .       .       ..  . .       .  .  .          .   . ..  .  . .       . .. .      ... .  .  ..        ..
.    ..  . .  ..      ..  .     .    . .      .      .             ..  . .          . .  ...   .     .   ..   ..    . .  .   . .
..  .       .  .  ..   .  .      .   . ..    ..       . .       . .     .   ...     . . .   .   .       .      .. ..   .. .... .
..           .  .   ..       ..   .  ......  .       .  .. . ... . .   .  .   .      .   . .   .    . .  .. .   ...   . ..   ...
..     .  .      ..           .     .  .  ..  .    .  . .            .     . . ..      . .  .    .. .   . .  .         .       .
.    . . .  . .        ..    ..  . .    . .  .   .     .       .   ..     ..  ..    .  .   .      . ... ..   .        .      . .
...      .  . .   .  .. . .    . .    .. .. .  .       .       ....    ..  .    . .     .  . ...  ..      ..              .. . .
.          . .   .        . .. .       .     .. ....    .    . ..        ..  ...     . ..   .  .. ..      . . .      .     . . .
. .   .  ... . ..  .        .          . .   .            .   ..   .   .    .  .    . . . .  ..    . ..        . ..            .
..     .     .   .   .    ..   ..     . .. ..   .    . ..   .  .  .   .       .    .  .      .  .. . .     .    .    ..... ..  .
. .   .. . ..    .     ...    ..    . .   .   . .  .     ..  .    .  . ..  .    .     ..     .   . ...    .  ..     .... . . . .
.    .   .X ..  ..   .. ..     . ..        . .  .     .      .    . .            .  . ..  .    .      .   .   . .       ... . ..
. . .   .     . . .      .    ..  .   ...    . .           .. ..  .        . ..    ..  ...   .  ..      .. ......      . ..   ..
.     . . .   . . . .  ..     ..    . . .  .  ... .       .   . .. ..        .    .       .  ..       .       .  ...    .     ..
..     .  .    . . ..             .     .   .. .  .  .   . .    ..   ..  ... .   .   . .   .   . . .  .. ...  .   ..    ..  .. .
.    . .  . ....  .. .           . .   .     ..  .  .   . .  .   ...   . .  ..     .     .             .  . ..     .    . .  ...
. .        .  .  . . .  .  .       .  .  .         .              .. ..   .   .. . .    . .   . ..  .    .    .  .   .      .. .
.. .  ..     . ..    . .        . .   .  . .. .      .  .. ..     ..   ...   ..   .           . .  .. ..  . .        .. .   .. .
...  .         .     . .    .  .  ..   ..            . .     .     ..  . .           . .  . ..  .    .. .  .  ..    ..     ..  .
.         .       ..   .   .        ..   .  . .  . ..  .     . .      ..   .         .        . .          . . . .        .    .
.      ..   .   .  .  ..    ...      .     .         ..    .. .  .     ... .  ..      .... . .  ..   .     ...       .        ..
. ....  .    .  .    .   ..   .   .           . ..        .  .       .  .        .......  ..      .   .   .    .  .  ..      ...
.   .    .          .. .   .  .       .   . .   ....   . .      ..   .   .   .         .   . .    .  .    ..   ... .. . ..     .
..  . ..    . . . ... . ..   .....      .    .  . .  . .   .. .  .   . ..  .   ...   .   . ..     .  .... . .   .    .  .. . . .
.     ..     .         ... .      . . .     .  .. .  ..   .    .   ..           ..            r  .     .     .     .    .      .
.. . .  ..  .      . ..  . ...  ..      .   .     ..    .   .    .           .       . ..    .  .     .  .      .      .  .    .
.     . . .. .  ...    .     .    .   .    .  . .    . ..  .            ..  ..    .    .             .       . ..  . .      .  .
.     .     .        ..               ..  .     . . ...      ..  . ...   .  .       .   .      ....                 .. . .   ...
.    ....      .    .   ..    .            ..    ...  ..  .    . . . .  . .        .    ..    .   ...    .                 .   .
.  . .      .   .   .     . .  .        .  ....  .    .    ..  . ...... . .  .   .   ...    .     .  .    . .    .       ..  ...
.          . ..  . .       ..   .. .   ..    . .    . .   . .     .       .   ..   .   ..         .      .. . .        ..      .
.  .  .          .   .     .    .    .   ..  .   ... .  .  . .      .   ..     .    .. .      ....  .          .        .   . ..
.. .        .   .   .       .   ..    .  .  .  . ..           ..     .  .  . . .. ......   . .     .. . ..    .. . .          ..
.   .  .          .    ... ...   . .     . .      .    ....         .  . . . . . ..   .  .      . . .           . ...   .. .   .
. .    .     .   .       .     .  . ..  . .      . ..  .  ..          . .  . ..         ..     .   .   ..  ..     .   ..  . .  .
. .  . .  .     ..  .  . .. . . ..  .. . . .    .  .. .  ..     .      . . . .. ..    . ...... . . . ... . .   .   .    ..   . .
. .                   .     . . .          ..          .  . .    .      ..  .        . .   .   .   ...   . .  . . .. .  .. . ...
.      .  .       .. .              .. . .    .     .    .   . .    ..  .. . ..  .     .  ..    .  ..        ....    .       . .
..     . .     .. ...  .   .    .  .       .   .  . .....  . ...  .  ..  . ..           ...  ..  ..    .  ....  ....    ..     .
.  . . .    ..   .    .   ..    .   ..  .    . .   . .      ... ...   . .  .  . ..      . . . .    .  ..  .         .          .
. .    . .. .    .     .     ..       . . .    .... ..  .   . .        .. .   .  . .  . .            ..           . .  ..  . . .
.... . .    .  .    . .    .   ..  .    . . . .. ..   ..       .   . .  . ... .  .     ....   .    .  ..  .               . .. .
.        .    . .  ... .  .  .  .... .     .  ..      ..  . .       ..  ..     .  ...  .. .  . .  . .      .  . . .      .     .
. . .  .   .   .  ... ..  ..  .    .  .  . .     ..     .    ....     .....           ... .     .     .  .  .. ..       ....  ..
. .  .  ...  . .    .    .         ....      .   ..       ...  .     . .    .      ..  .  .  .     ..   . .   ...          . . .
..   .      ...   .  . .  .  ...  .  . . .... .     .... ..   .   .. . ..  . . . .    .          ..   .   ..    ..  .   .     ..
..  . . .. .     .       .  . .  ....     .  . .    .    ...   .     . .. . .. .     . ... .     .    .    . ... .  .  . .. .  .
. .   . .      ...  .  . . . .  .  .      .. .  .          .  ... . ..  .      .       .     . .     .   ...    .    .     .   .
.   .   . .     . .    .. .  ..    .  .. .   ..  .       . .      .. .        ..   .  ..  .  ..    . ..    . ...    .      .  ..
.   .  ... . ..    .    .  .    .   .   .    ....  . .        .  .  .   .. . .    .    .. .. .     .  ...  .   .. .       .    .
.  .  .  ..    ..     .    .     .         .   .. .   .          . ....     . . .  ..    .  .         ....      . ..     .    ..
... .     .    . ..... . .    .      .   ..  .     .            . .  ..  .  .. .   .  .          . ...             .    ..  .  .
.     .   ..  . . . ..         ..      .. .. ..        ... ....   .. .    . .    ...    .     . .        . ..            .    ..
. . .. .. .  .. .     .    .   .      .. .       .  .   .     .   .      .    .  .....    .  . ...           .  ..    .    ..  .
.        .   ..  .  . ..  .    ... . .   . ..... .     .     .         .    .   ... .. .   .   ... .  .    .      . .  .  .... .
..      ...      .  ...    ..   .. . ....  .        ..       ..     ..  .          .    ...  . . .   .    .  ..      .  .  .   .
.  ..        .      .  . .  .       .     ...    .  .     .. .   .   ...    .  . .  .. ...     .. ...    .......    .      .   .
. .    ....    .  . .  .     .   .     .       . .  .   .  . .   ..  . .  .. .            .  .   . . ..    .  . .. .  ..       .
.   .   ... .  . ..   . .    .  ..   .  .        ..      .   .   ...   .   .. .   ..        . .     .          .  . .   ..  . ..
.    .      .       ... .   . .    .. ..        ..   .. .    ..   ..        ...   . .   . .  . . .  ..   . .  ...  .  .  . .   .
.       ...   . .. .   .    . .     .. .  .    .  . .  .     ..  ...   .    ..    .      . ..        .     .  .    ..   ...   ..
.  .     .     . .    ...       ... .   .    .. .             .   . ...         . . ..           .     .         .  .    .. .. .
. . ..             . ..   .  .          . .   .           .   .     .  . ..  .   .       .        . .    .  ..   .   .   .     .
. .       ..... . ..      .  .  ..   .   . ....     ..     .    ...    ..   ..   .    . .     .     . .     .    . . .... .. . .
.   .         .       ..    . .   .  .         .   . .  ..   ..   ..         .  .    .   . ..    .     .  . . . ..  .          .
. ...   . .           ...      ..   .  . .  .  .  .        .  . . . ..  .  . . .       .  ..  .. .  .   ...     ...  .   .     .
..     . .    . .  .   .  ..          .  .  .  .       . .  .       .. ...    .  ..  .. .   ..     . .   ..                 .  .
.      .  .    . ..   ..          .  .       .        ..  .    . ..  . ..    . . ..    ....    .     .         .  .  .         .
.    .    ... .    . ..  .       ..                     .             .  .       .     .....      ..      .. .   .. .      .   .
. .  ..    .     ..             ..  .  ..      ... .    ..        ....        .... ..     . .     .   .  .      . ..           .
. .     .   ..          .   . .. .   ..  .. .          . .  .    .  ...  .    .     .  . .. ..      ..        .       .. .  .  .
.      . .     .. . . .         .     .        . ... .. .   .. .        ..   ... . .      . ..  .    .        .     .          .
.  .  .  . ...  ..      .   . .    .. .    .       .  . ..    .   .  .. ..  . .                  ..    ..    . .   . . .      ..
.        ...     .   .     .           .  . .  . .  ... .  ..       .  . .       ..        .   ... .  .    .       .. .   ..  ..
.   .     ..       .    .      .  .              .  ..   . . .           ..     ...           .    .   ..       .   . .  .    ..
.    .   . .    ..   ..... .. . ..   .  ...  ..  . .. .  .  .. .....   ..     .  .     . . .    . . . ..   .      . ..      .  .
..  . . .      ..  ..  . .  .  .  .. .  .. .   ..  . .  . ..        ..   ...  .   .   . . .    .   . ... ..    .. ...   .   .. .
.. .        . .   ..    ...     ..    .     .    ...   .. . . . ..        ..     .   .    .   ..    .       .   . . . .   . .  .
.  .   .. .    .  .      ..  .  .   .    . .. ...          .  .  .    ...  ...      ..      . .   .     .   .     ..  ..     ...
.   ... .. ...         .       ..    ..  . ..   .  ...   .... ..      .     ...        ..        .  .   .                     ..
... .   . .   . .  .        . .  . .  .... .    ...  ..   .   .   ..     .  .    .   .      .        .    . .   .  ..   ..    ..
... .     ..     ..       .   .       .          ..    .  .     .   .      .  . . . .  . ...   .  ..  .. .   .     .     . .   .
..     .  .    ...   . ...  .   .    ..        .        . .  .     ..           .        .. ..     . .      ... ..            ..
.    .. ....      ... . ...     . .      .     .  . . .. .. . ..  .     .     .       ..      .    . .   .  . . ..    ...  .   .
. . .  .   .. .   ..    . .  .        . ..  ... ..        .  .        .     ..    .       .  .   ..         .     . . .  .     .
....    ..   .   .          .  .  .  .  .    .             .     . . .....   . . . .   ..  .  ... . .   ..  .        .   .   . .
. .     .   .        .    .           . .        . .       .. . .       ...         . . .  .. . .  ..  .   ..  .  .    . .  . ..
..          .  . . . .   . .   .   . ..   . .    . ..          ... .     .   . ... . ..     .       ..  . .   ..      .     .  .
.. .    . .    .    .. .      .      .   .  . .      .      .  . . . . .   .  .   ...    . ...       . ..   .   .         .  . .
.              .                ... . ..  .       . ..         .   .  .    ..   .  .. . .  .  .  .        .  .  .       ..   . .
. .  .. ...     ...  . .          ..   . . .         .  .   ..   ..                  .   .  . ..   ..   ..      .  . .... .    .
. .  .   .     .   . . ..   .  ... .  .    ..   . ..  .    . .    . .   ...  .  .   ..   .     ...   ..  ..   .  .      . .   ..
.. ...    . .. ... ..   .   .... .  .       .      . .   .   ..         .   .        .   ..      .. ...  . .    .     . . .    .
.    .. .  .  . .  .. . .     .  ..    .      .  ..      .. .. .  .     . . .       .    ...  .... . .  .  ..   .. . ..  .  .  .
.     ..   ..     . .   ... . . .     . .   ...       . ...   ..     . ... .  .        .  .                      ..    .    .. .
.           .       ...    ..  .   ..      . . .    .      . .   .        . .... .   .  .    .        . .  .       .    . ..  ..
.     .    ... ....      ..        .    . ..     .        .  ..  . .. .   .        .   .    . . . .     .  .   . ..    ..      .
. .   . .    . ..... .  ..    ...  .     .. ...  .   ..     .     .    .    . .   . ...    .        . . .       . ...        ...
. ...  .     ..         ....  . .   .  ... .  .  ...     .. .. .   ....   .     .        . .    . . . .   ..  ...... .    ..  ..
.  .  . .    . . .  .  .. .        .    .           .. .. .   .      ..   .           .  ..         .     . .. ..  ....   .    .
. ...     .. .   ..  .   .   . ..       . . .   . .  ...   . . .  .  . .     ..  .   .  .             .        .    ..     .   .
. .       .        .  ..     .  . . . ..        .. .       . .   . .      .. .      ..  ..      .  . ...   ..        . .  ... ..
.... . ...      ..    .         .   .   . . . . .  .  .....         ..      ..  .  .  .  .. ..    .   ...   .    .        .   ..
.   .  .       .       . .    .           . .   .  ..    ..       .    .  .       .  ..      .    ..  .   ..  .       .     ....
..  .          ..   .    .  . .. .  .      .......    .... . . .   .  .       . .   .. .  ..  .  ... .      ..    .  . .   . . .
..  .. .  . ..   ..    ..    ....   .. .  . .     ..      .      .          ...  . ..    . .    .        ...  . .       .....  .
. .   ... .     ..   ... .     .  ...     .        . .. ... .   .        ... .    ..       .. . ..  .        . .   . . ..     ..
.     .   .  .            .        .   .    .   . .   .    .        .     .     ..     ..          .   .       .   .  .      ...
. ..           .    .  . . .  .      .  .  ..       .  .  . .    . .  ...   .. . .. . .    . ..   .  .   .       .          . ..
.     .  ...  . ..      .     .     ..    .  .  . ..  .. .      .    .     .    ......   .  .. ..  .   .    . .    .   ..    . .
. .   . .. .    .. . . . .       .   .  .  ..  ..   .   ...   ...    .    . .  .. .    ..  . ... .. .    .         .        .  .
. . . .    .  .   . ..  .  .   .  .    . .    ......     ...     .   .  .      ... .        . .      .     .    . . .  ..      .
................................................................................................................................
