.................................................................................................................................
.       ..       .  .  .   . .     ..    ..             . .. ..   ....  . .   . ..    .. ...  .. ....         .       .. ..     .
..   . ..   ... .    . . .  . .            .  ..    ..   .    .     .      ...      .   ..   .  .      .  ..       .   .   . . ..
.   ..        . ..        .           ..   .  ..  .    . .    .. ..  .   . .     .  ...  .       ..                  .. ..  . . .
.                . ..      ..     .  . .   .    . .      . ..      ...  .         .   .   . . . .. ..    . .     . .  . .       .
. ..            .         .   ...   . . .    . . .  .       .     ..         .     ... .   .      .      ..  .. .     .  ..  .. .
.     .  .. . .    .  . .   .   .  .   ...   ..    ..   ..    .     . .     . . .   ..     .      .     ..          .      .    .
.   . ... .     ..    . ..    ..       ...   .     .             .   .  .   .      . ..         .. ..      .  .. ..    .   ... ..
. .  .  .  .  ...  . ...  . .  .  .  .    .     .   .  .  .  .    . .      .    ..    .    .  . .   . ..  .    .... .    . . .  .
.  .  .. .   ..    .  .  .. .   .   .       .  . .     .. . . .     ..       ..   . . .    .       .   .       . ..           . .
.     .       .      . . .  . .   .     . .   .    ..      .   ..       .     . .  ..    .  .     .    . .. .   .      .   . .. .
.         ..   . .  .      .    . .   . ... ..    . .        .   ..       .   .  .   ..  .  .  .  .   .  .     . .       .. .....
.  .    .  . .        .  ... ..  ..   .     . . ..  .     .   .  .   . . .. .  . .  .    .   .      ....     .   .   .    ..    .
.     ..          ...    . . ..     ..  . .  .     .    . .  .   .  .     ... . ..   .              .  . ..    ...  .  .        .
.    ..    .    ..        .  . .    . .    .  . .          .       .  .   ... .         .  .   .. .   ..      ..    .  ..       .
.  .     .    .  .       . . .        .       . .    .  . .  .       .      .    .     .  . .    .    . .  .      .  .  .  ...  .
.  ..   ..   .     .   .  ...  .    ..   .. .  .       .     .   .   .  .      .     ..     ... .    ... .     ..   .    . .    .
..  .       .   .   ..  .    .  ....... ..   .       . . .. .  . .    .    . .   . .. .  .  .          .    ..     ..     . .  ..
.  . .. . . .    .   . .       ... . . .    .. .    ..   . ...      .  . ..         ....  ...   .                . .. . . ...   .
.  .. .         .     . .  . ..       .    .. ...         .    . . ..... ..   .                .        .       .  ..     . ..  .
.      .     .    . .  ..  ..  .   .   .  ...   ..  .    ..  ..  .   .        ..     ..  .     .           .     ..... .     .  .
.      ...           .  .        ..  .     .. ..    . .  .  .    ..   ...    .      ..     .. . ..  .  .. . .   .  ..  .. ..   ..
.  ...          ..              .  .   .  .  .      .     .....     ..... ...          .  .   ..  . . . .  . . .  . . . . .    ..
.   .. .  .  .     .   .   .   .       . .  .  .  . .     .   .  ...  .  .     ..        .  .. .   .     .  . .  .     ...    . .
.    .     . .   .   . . .  . .    . . .   .     . . ...    ... ...  ..   .        . .   .    .  .          ..  ...  .  . .. .  .
.  . .       .    .. ...  .  .  .     ......     . .   .      .. .   .   .      .  .  . ...  ...       ..  .   .    ...   ..    .
...   ..     . .   ..  . .   . . .  . .   .  .  ... .      ..   .        ..    . . .     ...     .     . .. ..    .       . . ...
.. . .. . .. ..  .   .        .   .  .      ..    ..  .  .   . .   ..     .         .      .    .. ... .     . .... ....      . .
..     .   . .....  ..   ..  .  .... .           .   .         .    .     .  .        ..         .   . .  .  ...  .    .  ..  . .
..      . .   . .  .   ..  .. .   . ....   ..       .   .    .        . .  .       .          ..   ...  . .     .       . .     .
. . .... ... .  .  .    ..  . . . . .   .       .       ..         ..          . .     .      .     .    .         .    .   .  ..
.  ... .   ..... .  .  .  . .. ....       . ..       . . .. .    . ..  .  . .  ...  ..        ..      .    .     .  .. .    . ...
. .        .   ..        . ..      .   .      .   ...   .. .  .   ..    .  ..              .            .    .. ..           .  .
.  .  .. . .    . .     ..     .  .     . ..  ..   .  .   . ....  . .  .     .  .   .  .  .       .    .       . ..    .  .  . ..
...      . ...  .         .  ...   .  .. ...    .        ..    . ..   ... ..         . .       ... ..   . ...   ....   ...   .  .
.  .. . ... .  .   . ...      . ..  .   .    ..  ..  . .     . . . . . . .     .. .              ..     ... .    ..           ...
. .  . .  ..   .  ....  . .    ..  .. ..   .      ..   ..    . . ... . .       .  . .. .  . ...    .         . .  . .  .    ..  .
. .. . . .    .  ..      .   . ..   .     . . .  .  .. .   . .        .  . .      ..  .   .. . .     ..      ..  ..  .      .  ..
.   ..     .. ...   .    .  .         . .. . .           .  ....  .     .    .     .    ..      . ..  .  . . . .   . .   .. .  ..
.   .   . . .  .   .. ..     .. . . .        ..   . ..      ...        .  .  .    . .        .               .  .           .....
.  .        .  . .  .   .. .         . . . .    . ..     .   ..    ..    .  ....     . ..     . ..   .  .  .. ...    .    .     .
.       .. .    .  ..  . .  . .     . .   . ..     . .     .  ...  . .            .        . ..  ..    .   ....          .  .. ..
.  .    .     .      .  ..  .  .  ..    .....         ..          ....  .         ..     ...     .     .... . ..   .  .  . ..   .
.  . .          .     .  ..   .    .     . .      .  .  .. .  .     .   .      ...   .   .   ..                .  .     ..  . ...
.      ..     .   .....   .    . ..   .    . .      . .        .  . ... . .  . ....    .   .  .. .      .    .   ..       ..    .
.  .    .  ...   .  ..  .. .  . .    .    .  .      ..   ..         .   . .   .   .      .  .          .. .   .        .   .    .
.. . ... .    .  .      .. ..      .  .                 .   . . ... .  .    . . .     .. .    .   ...         . . .. .     ..   .
. ..   ..   .  . .  ...       ..  .        .  ..           . .       .. .. ...  . .  .... .     ..         . .   .    .     ..  .
... . . .      .     .....            .   ...    .        . .   . ..  .  ...   .   . .  ..   . . .  .   . .  . .   ..   .    .  .
..   .   . .  .      .  .             ..     .  .         .   .   . . . .     .   . .    ..   .    . .               .   ..  . ..
..  ..   . .         .        ..  .  ... .  .  ..   .    .  .         ..            ..  .. .  .        . . ..         ..    ..  .
.   .   . .    ....  .    .  . . .   .... ...       ..  .    .     .    .      .       .     .  . . . ..   .  .    ..      .    .
.   . .  ...   . . . . . ..  . .         .  .  .     .  .     . ..  .    .  .   ..      .   ..      . .. .  . .  . .. .    ..   .
. . . . ...      .. .  .. .....  ..  . . .      .         .     . .    .    ..     .     .   . .   ..    ...   ..       .  .    .
.           . . ....           .          .  . .  ..     . .  . ....   . .              .       .  .  ..   .   .       .... .   .
.  .     ..   ..  . ..          . .   ...    .       .   .    .         . .   .  . ..          .    .  .        .       .       .
. .        .  .. .   . .   .  . .     ...      .   .   . .   ..    ...      ... .  .  .   .   .    .    ..   .     ....      .  .
.. ..   . .  .   ...     .   .. . .    .. ..    . .   .  . .   .       ..     ...   .     .  .    .    . .     .. .            ..
..  . .. .. .   .        ..             .. .     .  .   .     .  .  .  .   ..  .  . . .     .     .. ..  .    ..      ..        .
.        . ..     .  .. .     .      . ...   .      ..       .  ...  . .         ...      .. . ...    . .     . . .         . . .
.   .         .   .      .  . .   .      . ..    .      .  . ...  .    .  ..     ..      .. .   .          .        .   .... .  .
. .... ......  . .  . . .     . .  .  .   ..       .  .    ...    ..   .  .  . ..    .  .. . .      . .     .  .              . .
.    .   .. .  .  .   . . .    .  .   .. ..  .       .  .   .    .... .  . .   .   .  .    .   .  .    ...   . .     .    . .  ..
.       . .       .    .   .   .   .       . .   .. .     .    .   ....     . .     .       .. . .     .       . .   .   .      .
..    ...     .          .     .   .        ..  .   ..  .. .  .   . . .         . . ..  .. ..  ..   .  .     .. .    .   . .  ...
. .... ..     ..   ...  .         .   . . . .   .  ..    .. .      ....      .  .             . .       . .          .   .  .   .
.  .        ..   . .  .              . .     .   .   .       .    ..    .       .... ... ..   .  .  .    . . .   ..           ...
.  .   ..       . .  .  ..          .         ..    .    ..    .      . .    .       . .          .   .    .   .   .     .  . . .
..      ...  ... .      ..   .  .     .... .   .             .   .. .   .     .   ..         ...  .          . . .  ..     . . ..
.            ..   .   .   .  ..    .      ..  . .. . .   . . ..  ..  . ...  .     ..    ...   .       .     . .   .   .. .  . . .
.  . . .  .  .    ..   .     . .  .  ..     ...     .      . ..     .   .     . ..     ..   .         ..     .  .  . .     .  ...
.    .     .    ...      .       ....  .       ....   .          . .        r. ..    ..    . . .. .    .    .    .  ...   . . . .
.    .  ..  . .. ..                  . .  . ......  .   .  .   X    .        . ..     . ..   .       . . ..    . ...  ..  .  .. .
.          .        .   . .   .. ...    .  .                     . ..   ..    ...  .. .  ..   .  .   ..  .. ..   .   .   .  .  ..
.      . .   ... .  .. .    ...    . .       ...  ..           ..   . . .  .   ... .    .   .    .  .    .     . ..        .    .
..  .    .  .     . . .    . ..   .   .. .  . .  .  ..   . . .      .  ..  .      .   .    . ..     ...  . .. ..     .    .   . .
. .     .   . .   . .      .  .    .   .   ..         .  .. .  ... .  .....    .            .. .            .      . . ...   .. .
. . . .  ..    .  .. .       .       ..      . .       . ...   .  . .   .... . .  .   ..         ...  ..        . ..        .   .
...  .. . ....   .     . .         .     ..  .    .        .   .     .         .  .  .      ..  .  .   .    .. .        .  ..   .
..     . .  .     ..         .      . . . . ..    .  .  . . ..     .. ...        . .. .    ..   .  ..   . .  . ...      ..   .  .
.  ..  . ..    ..              .. .      ... .   . ..  .    .. .. ..     .    .   .  ..  .    .     .   .  ..  ..     .   . .   .
.. ..    .. .  .  .   .  .    ..     .    . . .   . . .  . ...  .       . .....    .  ... ..         ..  .. .     .    . .. .  ..
. ..  . .. . ....   .   .    .         .   .    .  ..     ..    .  .  .        ..   . ...       .   .  ..          .  .  .   . ..
. ..  ... ...       . . .    . .  ....    . . .    .    ..  ..   .  . .   .  ..    .   . . .   ..      .     .   .. ..     ..   .
.     .     .  .  ..     .  ..    . . . .   . .. .        .         .  .     ..  .  . . .   .  .... .   .   .   ..      .  .   ..
. .       .   ....        .         ....        . . . .   . ..     .         . . .. .   .       ...      .. . .          .   .  .
. .   .  .  .      .   ... .          .     ...  . ... .. .      ..       . .   .     .          .     .   .    ..   . ..    .  .
.    . .       .   ..            .  .  .     ...  ... .   .      ..        . .            .. .  .  ..  .     ..       . ..    . .
.   .         .  . .. .. .              . ..       .       .   .. . . .  . .   ..  ...                 . .   .   .     ..  .  . .
. . . .. ...    .    .        ..  .   .  .. .. .     .  . ...  .. .     ..   ..        .      .   .  .        .   ..     .      .
.  . .    .       . . .      .. ..  ..  .. .  . .       .          .     .  . ...   .. .  .. ..    ... .      ..       .   .    .
.  .  .      ...    ....   .. ...    . . .... .    .        ... . .    .  .         .    .   .....    ... . .  ..    .   .  ... .
.  ..     ..      ..     .     ..   ... . .  ..   . . .  .  ...  .       ..  .   ...    .. .         .   .   ..   .    .     . ..
....    ... .    . .   .  . . .      . .  . .. . .   . .  .           .     .  .        . ....   ....   .     . .    .  ..  . . .
..   .  .   .. . .    .  . .  .    .   .     .   .    . ..   . ..   ..     .  . . .. ..  .     . .  ..    . . ..     .   .   . ..
..    ... . ..  .       ..  .. . ..  .. ..  .   . .     .   . .    .     .     ..            .  .    . . .  ...     .        .  .
.. .       . .  . . ...   . ...      . . .      .        .   .         .  .  . ..        .          ...    .      ...  .  ..  . .
.. .      .   . . ..   .     ...    .         .  . .       .      .   .     . .. ..  . .  .  ..          . . .      . ...    .  .
. .   ..  ... ..        .  ...    . .    .            ..   ..    .   .     ..      .  .. .     . . . .           .   . ..   .   .
.   .  .     .        .       ..  .         .               . .  .  . .   . .  .  .   .    . .  .                 ..  .. .      .
. .  .   ..   .     . ..      .     . . .. . ..   ..  .     ... . . ..   .      . .. .. ..      ...      .  . .     .   ..      .
.. .     ...  .   .    .       .  . .      . . .  .  ..  .  . .       .....   ..   .   ...  .  .   . .  .          .   .  .  . ..
.       .. . . .   .   . ..  .  ..   . ...            .      .      .... .  .    .... ....     . . .   . .  . ...            .  .
. .  . ..   .. ..  . .    . . .. ... . .. ..      . ...    .    .       .   ... .       .    .      .. .   . .       .         ..
.  .... .    .     .  .  ..   ...... ..   .     ...  ..     .   .      .     .  . . .  .   .. ..       ..  .   . ..    .    . ...
.  . .   .          .  .  .  .    ... . .       .  ... . .    . .  ..   . .  .   .        ..          .    .      .     .       .
. .  .      .         .      . .. . ..       .  .   .    .   ... .  . ...  . . .  .  . . . ..   .       . .  .   .    .      .. .
..   . .... .  .    .  .   . ...      .  ..   .  .   . .. . .   . .            . .     ...  . .     . ..  ..   .        .  . . ..
.   ... .. . .  .       ........ ...        .   ..     .      ..  ...  .  .       ..    .   .   ..  .  .. .    . .   ..      . ..
.     . .   ..   . .   . . .        . ...    .   .. .      .       .   ... .      ..        ..          .   .    ..    ..  .    .
..      ..  ..  ..  . .. .  ..       . . .    . .  .   .  .   .      ..  .     .. .   ...   . .    .  ..   ...       ..  .   . ..
. .  .  ..     .  ..              ..     .. .           .    .   ..    ..... .  ...      .     .  ..    .   ..  .       .       .
.   . . .               .  .  . . .     .. .   . .    . .  ..  .   .  . .          . .        . ...        .. .. .     .   ..  ..
.  .         .     ..            . .    .   .     .  .          ..        ... ..         .               .  .. .  .   .  .     ..
. ... . ..   .   ..  . . .         .... . ...     .   ......  .    .   . . ..  . . .     .      ..   .     .  .    .      .    ..
.    . .      .    ..    .   .   ... .  .     .  ..      .    .  .. ..  .     .    .      .  . ..   .     . .. ..  . ... ...... .
. .  .  .. ..   ...       .     ..     .. .      . . .       ..   . .    .       ....   . .        .   . .  . .. . . .. . ...   .
. .      ... . . .. .    .  . .. .   ..       .  ..  .  . .      . .  .   ..  ..   .   .              . .. .  . ..   .  .       .
. .      . .      ..   . . .   .  ..   . ...             .. ....     . .        . .  . ..     . .      . .    . ..  . . . . ..  .
.     . ... .....   ..      . ...      ..     ...     ..     ..      .  .  .  .. .          .    .    . ..  .   .           .. ..
. .     ..    .               . ..  .    .   . . . ..  .      . .  .   .  .    ..  .            .  .         . .    .   . . .   .
. .    . .     .   .   ..  . . .  .     .. . .  .. ...      ..       .    . .         .   .   .  .  .. .      .     ..         ..
.      ..   . .   .    . .  ..               . . ..  . .    . .    .                  .  ....   .     .      . .  .    .. . .   .
.   . .  . .             ..         . ...... .            . .     . .   ..    .        ..  ...        .. .. .   .  .     . ..  ..
.     ..     .  .. .. ...              .  .    .   .  .  .      .   .   .   .  . .      ..  ..                . .  .  ..       ..
.              . .  .   . . .. .              .   .      . . .       .   .    .. ..    .  . .. . ..   .   ..    .     ..    ..  .
. .      .. ..       .   .        .       ..  .       . .       .   .  .     ....     .    ..    .      ... .   . ....  . .  . ..
.       .  .   . .  . ..   . .       . ... ...    .         .        .  ..  .        ..       . ..  .... .    .      ..  ..   . .
.................................................................................................................................
