............
. .       ..
. . ..   ...
..         .
. .   .   ..
...   ...r .
..  .X     .
. .  .     .
. ..    .  .
..        ..
. ... .    .
............
