..................................................................................................................................
...   .        .     . .      .  ..   ..  . .  . .. .    .      .  ..... .  ..    .    .  .. .      .  . ....   . .       .    ...
.  .        ..  . .     .  .  .      ..         .   .  . r. .... . ....    . .      ..   .     .    .  . . .  .     . .    .   . .
.             . ..    ..   . .  ... .   . ..  ..   .   ..   .. .  ...   . .        ..   .        .      .   ........   . . .  .  .
. . . .    .    .       .   .  .. ....   .   . ..       ...   .       . . ..   ..    .       .  .    .     ..  . .. .  ...  .   ..
.  .    .     ...  .     . . .   ..  .   ..  . .   .   ..   .          ..  ..  .  .   .    .       .  .       .  .  .  . .  .  . .
. . .  ... .  .       .   .  .   .   ..     .  ..          . .  .  . .    .    . ..   . ... .    .          . . ..     .....   . .
.   ..  ..  .  .     ..        .     ..    ..  .      .  .. .... . .      .     . .  .      ..   .  ..    . .   .  ....      .. ..
...     .  .. ... .   .    .. ..     ...... ..       .  .         . ..     . .  ..    .   .     . .. . .     ..     .  .     . . .
.    .  . .  . .. .    . .....  ..  . . . .  .. .   .     .    . ..    .    .   .. ... . . ..     .        . ...    ..       .....
.    .    .  ..    . ..       .. .  ...     ..          .     .. ..              . .           .   . . . ..    ..  . . . .     . .
.   .   .  .  .     .      ...    .     .  ..  .          . ..  .  .. . .               .   ..       .      .       ..   .       .
. . .  .  .              .  .        .   .. ... ... .   . .        .. .   .    .   .  . .      ..  .      .   .   .           . ..
.   ..     .   .  .. .       . . .     .  ..    ..   .     . . .    . .    .  . .   ..  .  ..  .       ..  . .        . .  .  .  .
.....           .. ..   .   .  ... .     .  ..        ..   . .      . ..   . ....  . .   .. .   .  .... . ... . .  .     .  ..  ..
.         . ..   ..  . .  .  ..  . .  ...    . .     ..  . .. .      .    . .. . .  .    ..    .   ..    .. ..  .  .       .   ...
.  . .  .  ..      .   .  .    ..      .  .          ..     .. .  .. ..   .       . ..   . .   .. .      .            .   .. ..  .
.  .. .            .      .     .  . ..     .    . .  .      .        . .  .    .   . ... .   .    .  ..      .      . .  .      .
.     . ..    ..   .     .....  .        .    . .   . . .   .  . .       .   . .  . .        .        .   .   ...      .. .     ..
.. .    . ... ...  .       ...   ..   . .        ..   .      .    .    ..  ..   .  .   . . .  . . . .. .  ..    .      .         .
.            .  . .. . . ..  .. .. . ..     . .      ..        . .        .  .  .... .       .  . . ...  .  ..  .          . .   .
. ..            ..   .. .   . . .  ..  ..   ..  .. .. .  .  ..   . . ..   . .. .         ...  .     . ..       .              ....
. . . . . ..      .   ..  ..  . .       . .    ...  .  . . . .      .     .. .  .. ..    ..     .    . . .. . .     .  . .      ..
.. .. .     .  .     ..   ... .   .    .    . ...     . ..    .  . . . .   . . .    ....    .        .   . ..  .  .     .... ..  .
.  . ... .   . .   .     .     . .    . . .    ..   ... . ..    . . .. .    .  . ..    .   .     .   .   .   .            ..     .
.      .       .  .    ..    .    .  .     .  .                    .        . .. .        ..        ...     ..   . . .  .  .. .  .
.   .   .  .     .          .  ..       . ... ..  ..     .  .  ...    .  ..  .      . . ...  . . . ...  .  . .   .       .     ...
.  ..  .     .   .    .  ..        ..    .       . ..   .. .     . ..  . . .    . .               ..  ...       .     ..     .  ..
. .. .  .   .     .  ..   .     ..  .  . .     . .      .    .       .   ..    . .  .     .                     ..    .. .  .    .
..  ..     .. . .           .   .   . .    .    . ..  ...  . ..  . . .      . ..   . .    ..   . . .   .  .       ..  ..         .
...      .    .    .            . .. .   ..               .   ...          ..     . . .   ..    ..      . .     .       .  .   . .
.      ...   .     .      X .          . ....  . .. ...  .      ..  ...   .  ...      ..    .        .   .. .  .  .       . .   ..
.   .  ..  . .   .                 . . ......       . ..     .       ..  .    ..    ..      .  ...         ...  .    .   . ..    .
..    .  ..  . .   .       ...   . .  . .   .       .      .       . . . ... . .   ..  ..   ..   ..  .             . ..  .  .  . .
. ...  .          ...       .  ..      .         ..            . .                ...          ..    . .        . .   .. . .  .. .
. .   ..   .     .    .                 ...... . .    . .  . ..    .  .. ....       .  . ..  . .    . .    . .         .     .  ..
.   .       . ..  .  ...        .   . .. .. .     .. .   ..  ..         ..              .    .    .   ....           ..    .   . .
.           .    .   ..  . . ..  .   .   . .   ..    .           . ..  .. .     .. .   . .         ..    .      .       .        .
.  ...   .   .       ..  .   . ...    .     .     ..  .    .       .   . ..    ..     .  ..   ..        ..  .. ...      .   .   ..
.  . .                  .  ...      ..         . .  . ..  .   .. .            .         .   ..  .  . . .      .  .         .     .
..          ..  .    .   .. ..    .      . .  .    .  . . .  . .          .  . .   ... .  .    .      .  . . ...     ..  .  . .. .
.. .  .  .        ...  ..              ..      ...  .      ..   .  .    ... .. .  .  ..   . .....   .     ...    .    .      ..  .
.     ..  .. .   .    ..  .   .        .   .    ..  .      . .      .  . .     .         ...     ....    . . . ...... . .        .
. . .  . .  . ..     ... .    . ..            ..   . ..   ...  . .      .  .       .  . .     .   ...  .      ..   .  .    ..   ..
.  .  .       . .  ...     .        .         . .  .   .       . .   .              .. ..   .    .       .  .     .... .        ..
..   .   .    .  .  .  ..  . .  .        .  ..      .   . . ..       . .     . .     .   . . .    . . .       ..     .  ..     ...
.     .   . .    .....  . . ... . ....     .  ...       . ..  .. . .   . ..  .       .. .        ..   .. ...   .. .     .  .   . .
. . .     .      . . .  .  .   .  ....    . ..  . .    .      . . .    .. .     . ..   .. . .  ..   .    . .      .   ..   .  .. .
.  .. .   ..   .    ... .       . . ....    ..    .   .    . ..  ..         .   . .      .          . .        ...         . .....
.   ..  ..       .  .   .     ..          . .   .    ...     ...          .     .     . . . ...  ....    . .      ..      ..  .  .
.. .        . .  .. ..    .  ..  .. ..  .    . .  .             .   .  .  . .    .     .        .   . . .....     ..     .   . . .
. .      ..     .             .. . . . .  ..  .    . ...        ..   .     .  .   .  . .  .  ....    . ..   . . .. . .    .  .. ..
....          .   ..       . ..  .   ..  .            .  .     . . .  . . .. .           ..       .     .        .     .   .. .  .
.. . ...    ...   .       .  . . ..   .   .   . ...      . .    .  . .         . . .. .  .  .. .         .   .      .   . . . . ..
.      .          . .     .. ..  ..   . ..  . .  ..   .  .  .    ..  ...        ..      ...    . ....       . ..     . .       ...
... .  .  .     .   .          ..    .      .        .    . .    .   .  ...     ..   .    .   ..  .            . .   ..     .    .
.   ....     .          . . .  .      .     ...       .. .    .      .     .      .          . .   ...   .      .. .  . .        .
. ..   ....  .    ..   .  . .  .  . .    .  .. .       .       ..  . .     ...  .. .. . . .     .    .  ....    .       . .. ..  .
.. .     .  . ..     . .    ...    ..  .. ..      . ..        .   .  ...     .  .  .  .  ..   .     .  ...   .    . . ..  . .   ..
.  .    .    .  .    ...   .  .  .   .  .      ..  .. .      .    .. .    ..  . ....      . ...         .     .   ..  ..        ..
. . . .     .. .     ...  .  ..   .        .       ..        .  ..    .  ..   .   .....    .   .. .   .. .      .  . .     .  ....
.  . .  . ...  .   .  ..    . .   .         .                .  .   . . . ...  . . . .      .  ..          .  .  . . .     . ..  .
.         ..   .  . .      .     .  .  .   .   . .    . .  .     .. . . . . .    .   .   .            .          ..              .
.      .       ..    .        . .   .   .. . .. . ...                 .    . .  .       .     . .    .. ..   ....          .    ..
. ...      . .   .  . ..     ... .   .  .        .  ...     . .  .             .   .   ..      .   ...  .    .        ..   .    ..
. .    .       . ..       .          ..    . .  . .   .  .  .  ..    .  .        ..      .    . .   ..  ..        .     ...   .  .
.  . . ... ..  ..          . .. . .  . .  .... .    .  ...  .    .    .  ... .         .                . .      .     . .    .  .
.    .     ...    ..  . .  .        ...          .   .   .  .         . .. .. .  . . .    .  .. .      ..  .   ..  .     ..  ..  .
.  ...   ... ....       . .   .. ..  .     .    ...      .  . .      ...... .        ..  . .     .   . .         .  .  .    ..   .
. .. .   . .     . .       ......   ..   .    .. . .  .. .  .        .  . .  ..  .   ....    .         .  .      .      .   .    .
. . ..  . . . ..     .. . ..   ..  ..    .. . ......            ..        .   ..       ..   .  .    .        ...      . ...    . .
..    ..  .       .   ..    . .   .   .   .. . .      . .    .   .   .  .    ..   . .    .   ..         ...     .   .. .  .  .  ..
.      .  .. .   . .       .  .. .       .    .. .   . .  .  .          ..  .      .  .. .  ..  .   ..   .  ..      .  .   .  .. .
.  . .         . .   .  .   .   . .    . . .  . .    .    .. .   . .         . .     .         ...  .    .     . .   . . .      ..
.   .    .     ..  .     . .. .  . .       ..    ..   ..     .    ... ..    .......           . .  .  .. . .  ..   ...  .     .. .
.  . .   .. .      .   ..                 .         .            .   .  .      . .         .     . .             .   ..     .  . .
. ....  ...   ...    ..   .         .   .    .. .          ..     . . .        .      .      ..       ... .   .    .  .   .      .
.         ..  .     . .. .      . .      .   .   .          .. .   . . . .   . . .   .  ...        .     ..    .   .  .  .      ..
. .    ...   ..       ..    .      .   .  .      .    .              .              .....  . ... .    ...    .   ..   .....      .
.      .....   . . . .    ....  .  . .       ...   . ..     .. ...     ...   .  .  .. .           .         .    .     .     .  ..
..  .  .    .  ..             .   .   . .   .. ..   ... .         .. . .   .     .   ..  .    .  ..  .. .     .       . . .   .. .
..  .   .  ..       ..  ... . ... ...  ...         ..     ..     ...         .     .       .            .  . .  ..  .     ...  ...
. . ..     .     .  .     .   .      . .    .        .....      .     .  .    .    . .   . ....   .   ....      .    .       .  ..
.. . . . .. .      .. . .. .    .   ..    .   .     .     .  .. .        ..     ... .       ..    .  .     .  .     . .     ..   .
.   .   . .  .   . ..  .       .    .    .      ..   .    .       .  .. .....  . .   .. ..  .        .  .   . ...  .. .   .  .   .
. .  ..       . .     ...  . . . . .   ..   ...     .             . . ..     .        .    .     .        .           ..       ...
..  .    . ..  ..       ..    ....   ... .     .      ..  .       .    ..    . .         .        ..   ..       . .   ..       . .
. . . ...       ..  ..           .  ...      .    .       . .       .. ..  .  . .  . ..   .. .. .     .   .    .    ..  .   . .. .
.     .   .  . .     ..       .  .......  . . ... . .    .. .  ....... ...   .         .       ...    .   ..                    ..
.    . .       .  .    .  . ..   .     ... .    ..        .  . .      .    . .   ....        ...       . .. ..       .. ...      .
..        . .    . .           . .      . . ..     . ..     .  .             .  . . .    .   ....  . .. . . ..  .      .  . . . ..
..  . . ..  .   .  ...   ..   .  ..        .   .   .  ..  .      .  .     .. .   . .          .   .   ....  ..   ..     ..  . .. .
...    .        . . . . . .    ..    .. .    .     .     ..  .  .  ...         . . . . .  . .    . .   .     .         . .    .  .
..      .   .  .  ..  ..        .  .  .   ...     .    .           ..     .  ..   .        .. . ...   ..     .    .     .    . ...
. . .   . ...    . ...     .. . .  .    ...   .   .        .        . .  .  .  .        . ..  .        .     . ..        .. .    .
. .  ..      .    .   .  .          .  .. ..     ... .     ..   ..   ...     .             . .. .               .  . . .  ..  . ..
.    . . .  ... .         .. ... . . ...  . ...          .   ..   ..   .  ...    .  ..   .       ....        .        .     ..   .
. . .      ..     . .  .         . . ..  .  ...     .  . ...       ....    .. .     .  .  .   ..     ..  ..   .   . . .. .       .
. . ..  .     .  . .  . ..  ...    . .  . . .  ... .  ..     .  . ....  .  .. .         ..   .. ..       . .   .  .       . ...  .
.    . .         .  . .  .  .          . .    ..     . .      .  .     ....  .             .  .        ..   . . .     .          .
.  . .  . ..      . .   ..  .. ..   .   .        .    .. .    .       ..        .   . . .   ... ...    ...       .  . .       .  .
.. .    .   . . ..    .    . .  ..  ... . .  .  . . .   .. ..  ..  .... .   .  .   .   . .      .         .. ..  .    .  . .     .
.  .  .. ... .  ..  .  . .. .   . .  ....   .  ..  . .     .  ... ..  .   . .  ...   .    . .    . .    .      ...   .    ..   . .
..  .  ..    .     .  ..   ..   .     . . ..  ....  . .     .   .  .      ...           . .      ..   .     .  .      .  ...  .. .
.. . .  .   .        .  . .   .  .           ...   ..     ..    ..     ..    .  .. . .     .   .    .           .    ..  ..      .
.   ... . .   .  .       ..   . .    .     .    .   .     .... .  .  ..                  .     .  . .  .    . .   . .   .      . .
. .      .  . .    .   .   . . ....  .      ..   .  .  ... ...        . . . .   .      .     .   ..     ..      ..   .   .       .
....  .   ..        ... ..    ..        . .       . . .    ... ..   .. .        ...  .      .  .      . .            ..        ...
. ... ..   . .  . .  ... .   . ..  . .     ... .  .       .  .  .    .. . .. ..    .    .       . .  ..   .       ..   .   .    ..
.      .    . .. . .    . .  .  .   ...       ..    ..   .   ...   .  .      .       .   . ...   . . .   .           ...         .
.      .     . ..      .    . .        ...   . .  ... .    .      . .      ..  .  .     .   .. .   .. .      ..      .  ..... .. .
.   .   . ..       ..       .      .           . .   .   .      .  . ..              .    . .   .   .    .             .       . .
. .         ..  .     .    .       . .   ...  ..       .           ..  .         .  . .   .    . . . .  ..   ..   ..   .         .
...   . .        ..  . .. .       .   .           . . .     ... .        .     .   ...  ..   . .    .  . .   ... .. . ..  .   .. .
.       .      ..       ..   .    .    .       .    ..  ..   ..  ...    .  .  ..   .  .  .  ..    .       .   .     .     ..    ..
.        ... ..  .  . .    .    .  ..  . . .   ....  .  .    .     ..   .. .  .          .  ...  ..  .    .. .          .        .
. .    . .    .  .  ...  ..     .  ... .   .  .  ..     ..  . .  . .  .        ..   .        ..      . ..          . ..    . ..  .
..   . ....    .    .    .   .  . .  .  .    .  . .    ..    ..      .    .   ..        ...   .   .   ...   . .  . . . .  .  . . .
.      .    . .    ... ..  . .. .    .   ..  .. . .    .    .. .   ..    . .. . ....     .      ..     ...  .. . ..  ..   . .... .
.   .  .  . . .   .. .  .   .  .  .       .  . .  . . .  ..  . .. .    . .     . . .   .       .   ..  .        . .        .     .
.  .    .          ..... .       . . . .   . .    .   .         .     .. . .  .   .   .  .      . . ..    . . .   ..  .        . .
...  . .  .  .      .  ..  .  .          .    .   .  .  .  . .  .   .      .    .               ..    .  .  . . .    ...      ....
.     .  .        .    ..  . ..  .  ...  .    . .   ..      ..  ..    .      ... . .   ...  . . .    . .. .          . . .       .
.    . ..     ..      ..    .     .          .   .  . .    .  .   ... .    ... .  .   . .          ....  .   .   .    ..    . .  .
.. . ....  ..     . .    .  ...       . .   ..    .   .    .          .  .   .     .  ..     ..     ..   .     . ...       .  ....
. .   .  . .       .    .  ..  . .  ..           ..    ..           ...... . .. ..           .... ..     .. ..     . .     .   ...
.        . .   . .   ..  . .. .   .. . .   .   .    . .   ..  .  .. . . .    .. .. .    . . .. .   .  .     .     .    ...  .    .
.     .  . .     .      .. .  . . . .      ..   ..    .  .    .    ..   .. . .   ..    . .  .    ..          .   ..  ..   .  . . .
.           .   . . .  . .     ..  .     .    .  .  . . .   .   .       .  ... ..     .  .     ..      .    ..      .   .   .  . .
..................................................................................................................................
