...................................................................................................................................
...    .. .  .    .. . . ..   .    . ..       . ..    .      .  .    ...  ..   .. .        . .   . . .   ..   .   .. . .  .  .    .
. ...    .  .   . . .     ..   .. . .    . .... ..   .             .   .. ...   .        .  .   .  .   .. . ...     ..    ... .  ..
.  .   .     . ..            .   .  . .   ..  ..   .     .. . .            . ..      .  .. .     .    .  .  . . .  .    ..   .   ..
.    .       .       . .. .      .     ..  . .       .  .          . .  ...   . .       .     ..    . . . .     .  ... ..  ... . ..
.   ..    .      . .    .   .  . . .  ...                 .  ...      .       ...        . . .    . ..       ..           . . .   .
. .     .    . .    . ...  .        .  ..    . ... .    . .  . .   .         .       . .. .   . .     .   ..       .    .  .    . .
.  .          .       .     ..  .      ..      .   ..   . .    . .    .   ..      .. . ..     .  .  ..  .  ..   .    ..          ..
.          .     .       ..   .        .   ..   .   . .. . ... . .   .  .     .. . .   ..    . .   . .     . .   .  ..     .     ..
..  .. .             ...   .. .    . .      .  .  .  .  ..     ..  ..    .  .  . ..  .    .    .   .      .. .  ..      .      ....
.   .    .     .                  .    .  . .   .. . ... . .   . ..    . .        .    ..  ..   . ..  . . .. .... ..        . .. ..
...   .  ...  .         .       .  . .      ..       ... ..    .  . . .    .  . ..   ..  . ..  .        .  . .    .   .     .    ..
.. .        .   .. .   .   .      .     .  ..         . ..    . . .        .  . ... .  .  ..  ... ... .   .     .... .    .  .  . .
.  .      . ...  .  . .     . . ..   .....  ..    . .   .        .  .            .  ... . . .  .   .  .    .  .          .    .   .
..   ..  .     ..  .  ...    .       .  .  .    .  .   .    .. .. .        ..    .  .   .     ..           .  . .    . .    . .  ..
..    . ..  .  .   . .          .          . ..     .  .  .    .     .     .    .   .   ... .   ..    ....          .     ..    . .
.  . . .   ..      . .        .  .        ....    .      .  .   . .     .   .   .  .     .  . .  .. . ...     ...   .     ...     .
.   .  . .  .....    .     .     . ..  .  .    ...                                .  .    .   .         .       . ...       .   . .
. .  . .  .. .   . ...   .. .  .. .  . ..   .        . ...  .       .             . .       . ..  .     ..     ..  . .  .. .   .  .
.. .   . ..   . .  .  ..  ..  .  .        .. ...     .  . .          ...      . ..     ...  .   ...  .  ..   .  .. .  .   .   .   .
...      .   .. .....       . . .  .. . .    .   ..  ..  .. . . . . . .     .        .   . .     . .     ..  .  .      . .        .
. ...   .   .    .  .       .     .  ..       .  ...      ..  .. .       . .. .. .  . ..  .   .    .  . .... .   . . .   .    .....
.  .  .  ..    . . ... .    . .   .   ..       .. ..  ..    ...       . .          ..     .      .  .      . .      ..   . ..  .  .
.     . . .       .     .   .     .  . ..    .. .       .   .  ...     .  .. ..     .    .     .    ...    . . .   .    .     . ...
. .   . ..     . ..    . .   . . ..   .         .. . .   .... .    .  .    .  ... ....       . .   .   .   .   . . . ..  ..  .   ..
..    . ..  .  . ..    . .          .     . ..           . .. ..          .       .    .   .      .   .   .       .          .   ..
.  ...   . . .       .       .   ..   .. ... .. ...    .    .      .    .  .      .      .          .  .      .  . .  .        . ..
.   . .     .     .   .  . .      .        .   ..   . ..  ..   ...  ...  ....  . ..           .. .   . . ..      .    . ...  .  . .
. ..  . .  . .        . .      . .  . . ..  ..          .    .  . . ..  .  ..  .   .   ..  .  .         ..     .   ...  .. .   .  .
.... ..  ..  ...  .   .   . .       .      ... ..     .        .   .       .   .. .    .. . . .   ...      .     .    .         . .
..    ... .    . .....  .      .   ...    .. .   .    ...    . . ..       .   .   . .   .       .  . . . . .             ..  ... ..
.   . ...    .   .   .   .    .     ..  . ... . ... .  .    ..  .   .    .    .   .      .  .   . .     . .             .     .   .
.         .     . .  .     ..        . ..  . .    . .   .      .. ..       . ..  .     ..       .. ..  ..     . .            .    .
. ..       . .. .      .    .        . .  .   ..     .. .   .       .  .   . . .     ... .              ...  .... .      .  ..  . .
. .         .   ...   .     .    .. ... . . .  . .    .  ....          .        .  ....    .....  ..   . ..   .  . .    .   .. .  .
...  .   .. .              .  ..  .  .   ....   . ...     ...   .. .   ....    .    .  .     ... ..  .  .        .    .    ...    .
.  .      . . .   .   . .      . .  ...     . .  .     .    ..    . .  . . ..   . ... ..    .  ...     .   .      .          ..   .
.      . .   .... ...      .. ... . ..  . .  .   . . ...     .        .   .. ..   .  . .  .    . .   .    . .. ..     .    .      .
..       .  .   .   ..... . ... .  .     .     .... . . .  .        ..    .      ..   . . ..    .      ..         .. ..    . ..  ..
..         .    .      .   .     .   .  .   .  . . .  .. .     .      ...     .            ...       ..  . .   ..    .. .  ..     .
. ..     .                              .  . . .     ..   .            ...... . ..   .  .    .   .  . .  .    . . . .. .      . . .
.    ....      .  .  .. ..          .    ..  .     . ... ...      . . .    . . .. .  . . .     .  .   .  .  .  .        .    .   ..
. .   .      . . ... . .      .   .  ..  .X        .    .        ..    .     ..    ....        .           .   . .        ..  .   .
.   ...  .  .. ... .        . .   ... .            .      . .  .    ...  ..         . .  .  ..   ...   .   .         ...        ...
.   .  ..  .  .  ... ..         ..  .   .         .   .  ... .      . .   .   .         .  ...    .    .   ..   . ..   .  . . . . .
. . . .      . ..   .   . ..             .        .        ..    . .   ..            .   .. ...    .     .....            ..  .  ..
.              .   .   . ..   .        .    .    . .   .   .   . .  . ..  .   ..  . .  ..    .   ..   .. .     .   .    .. . .    .
.    ..      .....    .. . .     .      . .      . . .   .     .. ... . ...     .  ...  ..   . .     . .   .   .. . .    . . . ....
...   .      .  .  .. .  .  ..  . .       ..   .. .      ..   .   .. . .    .   .       .  .. ... .. .  ..  .  .   .   .. ..... . .
.   ...  ..... . .  .   .     .   .  ...      .     .  ..   .   . .     .   .     .  ...              ..     ....    . . .    .   .
.  ..       .    ..    ...  ..       .... .       . .  . .  ...  . . . .    .      .   .   .  . .   . . .   . ... .  . . ..    ....
. .   .     . .    . .    .              .    . . .. .   .   . . .   .  .    . .  . .   . . .      ..      .  ..... .  . .  .  ....
..       .     .   . .      .  .   ..     ..  .  .   ..  .         . .   .   ....      .    .            .     . .         .      .
.     .     ..      .            . .      ..  .   .        . .     .      ..    ..      ..          . .   . .   .     .       ..  .
.  .    . ..    .    .  . ...             .      .  .  ..  .. .   .         .            .   ..  .               .       .   . . ..
.. .     ...  . .       .        .    .    .. .     . .    ..  .    .    .   .   .. .  ..             .  .  . . .  . . .          .
.  .. .     .           .   .          . .          . .   .  .     .   .    .    .   ...       .     .          .  .     .     .  .
..     .       . .      ..    ..     . .     .         .            .           .   .   .  . .   .. .  .   .           ..   .  . ..
.. .    .         ...   . ....      ...   ..                ..    .          .       ..   .     .   .   .  ..     .  .      ... ...
....   .  .  .. .   .. ... .. .      .   . . .     .. .  .  .  . .      ..     .          .  .  ..        .  .. .  . .. .   .     .
.  .   .    .   ..      .. .  . . . . . .  . .    .   .     .      . ..       .      .    . ...     .   . .   .     .       ..    .
.       .  .. .  .   .     .     .           . .         .   .         ....     ..   .  .      . .. . ......   . ..    ..  . .  . .
.   .   . .      .    .     .      . ..  . . . . .      .    .    .  ....   . . .  ..    .  .. .  ..  .     .  .     .    .   .   .
.. ... .   .   . . .    . .   ..  ..    .    .          . . ..   ...  .   ...  .. . ..     ..  .   ... ...  ..      .   .      ....
.  .     .  ..    .  .      .  .     .      ..   .  . .    .  . . . .. ...  ....   . ....     . .  ..            ..  .            .
.    .       . .       .    ......  ..      ..        . .    .  .     .  .    . .   .   .  ..  . .  .   . ..  .     ..    .     . .
.  .  ..    .  .    ...    .  .  .  .   . .  ..              ...    .   . . .  .  .      . ....   .    ...     .  .         . .   .
..    .  . .       .           . . .    .. .  .  ..    .  ..  .     ...  .    ..    . .       ..   . . .     .  .    .    .     . .
.          .    .  . .  ... .     ..     .      ..  .  .   .   . .. .  . .  .       .   .      .   .            .  . .      .  .  .
. .    . ..    .     .   .  ...  .     .      ...  . .   .       .  .         .     ...     .. .  .   ... ..    .  . .   .     ....
.   .      .           .    .. .  . ..   ..        . ....          .   .      .....  .      ..  ..   ..  .  . .  ...  .    .  . ...
..      .     . ....        . .  ..  .. .  .    .  ..       .....  ..   ..    .      .     .     .      .. ....   .. .    .  ..  ..
. ..      .. .    .    ..    ..    ...   .   .     .  ..     . .   . .  .   .    . .         . .   . ..   . . .    ...   ...   ....
..  .  .      ..   .. .  ..    .  ..       .    . .     ...  . ..     ..       . .  .    .      .  . .     ....  ..  .     .     ..
. . ...      .      ..   ..    . .  . ..   .   .  ..      .       ..  . . .      ..       .    . . .    .  .   . .  . .   . .     .
.   ...   .   .   .      . .      .   .     .        ...       .    .      .        .  ..   .  .  ...   . ..  .    .   . ..   ..  .
..  .   .       .. .. .         .       .       .  .. .    .  .   ..     ...         .     . . . ..      .   .  .  .   ...        .
..      ......  .     . .    . .  ..   . .     . .    ..       .  .  ..  ..    .  ..          . ...  ..   .  . .  ..   .  ..     ..
..    .     . .   . . . .  .   .   ..   .... . . ..  .  .  ..         ....              .    . .     .. ..     . . ..         .   .
. .    .   . .  .  ..     .  .  .   .             .  .        .      ..        . .       .    ..       .  . .... .        ... .  ..
. . .   ..  ..   . ..   ..              .             . ...   .      .. .      .. . .       .     . ...        . ..  ..     ..   ..
..      .     ...  . . .   ...         ...   . ..  ..      .   .    . .    ... .       . ......  ..      ..  ..        .   . .    .
. .... .         .     ..  .     ..      ..  .  . . .   .               ..     . . ....        .      . ...  ..... ..    . .   ....
.         ..     .  r   . .  .        . .    ...   ..   ..  .  ...     .    . .  ...         .       . .    .  .             . .. .
.  ..   ..  .  .    .        .   . ..  .....  ..    ..        .  . .   ..    .  .    .. .    .  ..     .  . .  .    ..   .   .. . .
.      .     ..       .       .  . .    .    .  .   ...        .. . . . .    ..        .     .  .   .  ...  ... . . ..     . . .  .
. .    .         . ..... ..  . . . .      . ... . .      .    .     .    .   .   ..  .      .      .  .  ..    .. .  .        .  ..
.. ..   ....    . . .     .  ..   . .  .   . ..  .            .       ..   .. .   ..             .  .      .    .   .     . ..  ...
. .         .   .  . .  .   . .  . .   .. . .       ....    .  . . .  . ...       .  .. .   .           .    ...  .      .        .
..    .  .   ... .            . ..  ..  .  . .  .    . .   . ..          ..     . .. .                .  .          ..  . ..     ..
.   .           .        .....  .    .        . .. .    .       .. .  .     .   .   . .    . . .   .    ..   .... .    .   .    . .
..  .  ....     . .... . .  . .  .   .   .    .        .   .  .   . ..  .. . .. ....    ..    . ...    .. ..    ...  . .  ..  ..  .
.  .                 ..    ...       . .       .   .   .       . ..   .   .. . .. ..  . ...   .    .     . . ..     .....    .   ..
.   .   . .  ...  . ..   .. . .. . . .  .   .    .     .    .    .  .         . .. . .. .      ....           . .    .      .     .
. .  .   .   .... .     .    . .    .  . .      . .          .  . ..        .      ..  . .  .       ..       .    ..    ..    . . .
.   .      ..       ..    . .   .           . .  . ..   .. . ..        .           ..  ...         .  .    ..      . .  . . ..   ..
.. .   ..   . . .    .  ..             .    ... . .. .       .  ..  .  .    ..    .. ....   . .  .       .  . .. .  .       .  .  .
.. ... .  .          ...    ...  .. ..            ..     ..    .  .    .  . ..  .   .   . . .    . .. . .  . .. ...    ..  ...    .
.     .  . .. .  ..... ..  . .       . . .     .    .. .     ..   .         .          .. .  .   .   ..      . . .   . .      .. ..
..  ...    .      . .          .   . .   . . .  .  .    . .  ... .      .  ..       .   . .    .    . ... .    .  .      ...  .  ..
...      . .  ..     .   .   .   .    .    .         .  .        .         .  .    .    .    ..  ..  . . .    . .    .   .      . .
.   .  .. ..  .  .  .   . . .             .      ..    .. . . .   .. .      ..   .   . . .  ..   .  .. .        .    .     .  .   .
.      ..     .             .  .   . .  .     .   .     . .  .   ....... .    .. ...  .  ....      . . ..  .    .   .  .    .  . ..
.          .    .   .   . . .     ...  .  .. .   . . . ...    .        .. .     .  .       .   .. .   .     ... .         .    . ..
.      . .   ...   .   ..   . .   .  .         .  . .  .     . ..    . ..    .  .....    .     .        ..     .   .   .... . .  ..
.      .    .        .        .  .      .  ..       .   .     .. . ..  .  .      .  ..  .        .        ... .  ....   ..  . ..  .
. ......  .   .   .  .   .. .     .  . .      .   .   ...         . ..          . .   .   .     .        .  ..       .   .   . .  .
...    .     .. .     .  .. . . .   .....                  ..  ..   .          . .      . .. ..       . .   .   . .  .  ...       .
.  ..     .  . ... .  ..  . . . . .         .  ... .       ..     .....   .. .     .       ..    .. ..   .    .  .     . . .      .
.  .  ..   ..     . .      .     ....       . .    . .   .   ....  . ..  . .  .. .   ... .  .  ..       ...    .   .  .    . ..  ..
.. ..   . .. .  .. . . ..     ..    . .     .    .  . .    .. .     ...  .. .   .. .    . . .  .    .     .         . .  .   .  . .
. .....      .  .  .     .             ... . .  ..    ..   . . .. .    .  ..     .   .   . ..      . ..     .. . .               ..
. .     . .  .  . ....  .  .      ....       .  . .      .              .        . . ...  ..   .. .       .    .. .   . ..    . . .
. .  .  . ..           .  . . .          ...  ..    . .   . ...        . .   .  .       .    .  .... .. .                      .  .
.           .  .  ...          . .   . .. .   ..   . .   . .      .... .  . .. ...     ... .  ... .   . .      . .. .. . . .    ...
. . .  ...  .   ..   .       .    .           .  .. .. . ....    .  . .  ..     .  ....   ...  .    ..   .  .      ..  ..      .  .
. .. .    ..  ..     . ...   .  . .    .   .. ..    .. ...     ..   .   ..  ..              .      .  . . .  ..   ..     .  . .  ..
.     .   .    .  .     .. . ... . .   .     .. ..        ..                        .     . .    ......     .. .   .  . . . .     .
. .  .    .  . ..     ..  . .   ..     ..   .          .     .              ..  .     ..    .  .     .. .      .. ...    .      ...
...  . .   .    .  .. ..      .  .  . .  .        . ..       ..  . .    .    ... .   ....    ..         .. .       .  . ..  ..  . .
.. ..   .     ..    ...  ...           .                .       .         .         ... . ..     .    . .    ..  .       .  . .   .
. . ..   .                 ..   .  . .. ..          ..               ..  .   ..          .   ... . .. .. .   .  . ...   ..  .  .  .
. .          .                 .   . ..         .          .      .. . . . . .   .. ...   .   . . . .  ..   ...  . ..  .  . .     .
..... .    . ... .  . .       .  .   .    . .        .. .    .   .    . .       .    .  ..    .  .  ...      .    ... ...   . ..  .
.  ...        . .  ...     ..    .     .  ..      .     .    ..      .         ..   .   ..    ..  . . .        .     ..    .. .  ..
.  .    .   .. .   .   .    .   .  .     . . ..      .  . ...             .. .    ..    ....  . .   . . .      . ..   .     . . . .
.     .   ..   .             .    . .. .         . . .        .    .   ....  . ... .   ...   . .......  .  ..     .    .    .   . .
.  . .  .  .    ... .      . .     .  .    . .             .     ..      .   . .      ..  ..     ..   ..   .  ..   .     .   ...  .
.   . .   .  ....    .    .    .    .    ..                              .    .    ..  .   ..    ....     ...  .       ..         .
.      ..    ..   .      ... .  . .       .   .    .         ..     ..  . .        . . . . .  .    . ..     .  .. ..  .    . .  . .
...................................................................................................................................
