....................................................................................................................................
. ..  . .   .     .... .        .        .             .   .  .             .    .. .   .   ..  .       .      ... .. . .   .  ..  .
.           ..    .      .    . .     .   .       ..     .  .     .   .  ...  .  .  .  .    .     ..... .  ..    . .. .    .     . .
. .  .     .         ..  .      . .   .. .. . ..  . .   .   ..   ..  ..  .. . .   .     .. .        .       .   . . .     . . .   ..
...... .. . .  .. .  .   ..  .    ....     . . . .   . . .    ...  .   ..   . .   .  .   .... .     ..         .   . .  .       .  .
..  .   .  .  .. .  .        . .  ..   .  . . ..  .     ...  .     . .  .     ... . .       .   .. . .  .          . .       ..  . .
. .     . ..         .    ..     .       .  .. .. . . ..   ....  .       .  . .  .. .     .    ..   .       .  .    . ....  ... .. .
..        .. .   ....  .  .       . .  .        .   .. .            .        .   .  .           ..         .          .  .      .. .
.   ..    ..     ..      . .. ..   ... .   . .  ... . . . ..  ..   .  ...      .       .. . ...          . . .  X    ..   .     . ..
. .  .  .  .    .  .       ..      .   .   .        .      .  .   .   .    .  . .     .  .    .     .  . .. .  .  ..  .  .     ... .
. .  .. .  .   .....        ..     . ..   .  .   .. .    ... .    ..      ..    .  .   ..   . .  .  .      . .. . . .    .  ..   . .
..     . .    ..  . ...   .  ..  ..     .     . . .  . .      .     .        .      ..  .  .  .  .  ..   ..    .   ... .  ...     ..
..  . .  .  .  .      . .      .   ...           . ..     ..    .  . .  .   .                   .    .   . .    .. .. .     . .   ..
.    .              . .  . .           .  .     .    ..   ..     ..  . .      ...     ..    ..   .       .    . ..  .        . . ...
...    .       .   .  . ..     .... .      .     .   .     .     .   ..  ..   .. .        .  .      .      .  .      . .   ..  ..  .
. .  .. ... ..       . . . .              .       .       . . . .             . . .  .          .    . .         ..   .   .   ..   .
. ...    .  ..   ...    .    . .      .    .      . ....    .      .      ..  . ..    . .  .   .      .    .  . .     . . ....  .. .
..   ..       .  .      . . ..     ..    ..    . . ..   . ..  ..  . .        ...  ..   ...      . ..     . .      . ...  .  .  .   .
.  .   .  .   .        .       . ..  .. . ..  ..   ..    ..     .  ..     .. ..  . .. .     ..    .. .           .     . .  .      .
..  . . .    .      . .     .     ..   .              ... . .          .       .     ...        .. .              . ..    .  . . . .
..  .  ..   .   .  .   .   .  .  .   .      ..   .                 . . .  .   . . . .    . . ...    ...         .        .       ...
.   .  .  . .   . .   .  .  .   . ..  .    .     ..    ..       . .. ..    .  .          . ..  .  .     .    ..   .  .. .   ... .. .
..            . .  .      .  ..  ..  . .    .. .  .     ... .. ..    .   .  ..    . ..   ..   .     .. .   ..   .. .      ...   .  .
.. ...  .   ..     ...  .. ..         ..  ... ...        .     .  . .   . . . .  . .    . . . .     .      .  ..          .       ..
.. ...  .    . .    .   .      . .  .....      .  ...    .     ..   .            ..  ..          . .    .    .    . . . . ..    .  .
..         . ... .    .    . .   ..  .. .  . ..   ..   .    . .  ..      ..  .  .. .     ..   ...         . . .   ..    .     .    .
.  .  ..      ..    .  ..  . .    .  .. .  ...   . .. ..    ..   .   .  .    .   . . . . .     ... .                . .          . .
.   . .      .      ..     .    . . .           . .. .    .  ...     .      .  . ..    ..    ..    ....  .  .        ..       .    .
. ...    .  .   .   ..    .  .  ..    . .  . ..  . .     ...    . . . .  .     . .. .. . . ..  .   .         ..         .. .      ..
.     . ...    ... . .. .   ..  .   ..      . .   . .    .   .          .   .    .. ..   ...  . .    .  . .   . .           .  .   .
.   .  .    . ...  .     .  .   . .  ...       . .  .    ..        .       .         .     ..     ... ..   .  . .   ..   . ..  .  ..
. ..  .   . ..  .      .    .. ..       . .    .        .. ..  ..  ...    ..  .       .   . .      . .       ...   .  . .   ... ....
. .      ... ..   .   .   .. . .  .. .  .    . .  . .      ..   ..  .    .. .  . .     .   .  ..    .    .  .   .         .        .
.  . .  ....      . . . .   .  .    .. ... . .             .. ... . .... .... .    . . . .. .          .      .  .            .    .
.      .     .     .      .  .       .    .   .                 . . ...    ..   .... .  . .. ..   .  .... .   ... . .     .        .
.   .  .  .  .. .. .    .. . .    .             . .        .    .    .  .  . ..  .    .     . . ... .  .  . .. .  . .....  .. .   ..
... . .   .   .    ..   .  .   . .   .  . . . .     .      . .  .. ..  ..  .  . . . .. . .       . ...  .. .   .       .. .        .
.    .    .....    . .    ....    .    .  .  .  ...  .     .   ...  .  .    ..  . .  ..  .   .   .   . ...     .  ..       .   .   .
.   .. .     ..    ..  .. .         .  .. . .       . .   .. .  .    ...    ..    . .  .    .      . . . ..        .           . ...
..     .            . .      .    .    .        .      .   .     . ..     .. .  ..  ..   .       . .  ..      .         .    .   . .
. . . .    . .  .  . . ..  .   .     .  ..  ..     .  .  .    ...  ..   .   ..  .  . ..   .     .     .  ... .     .   .     .  .  .
.. .....      . .            ... ...    .     ...    .  .    . . .. .      .  .         . .       .    . .   .  ..    .. .         .
. . . . .     ..   . .   .   ..     ..    ...  . .. .  ... . .    .. .             . .    .  .. ... . ...     ... . .             ..
. . .  ..    .    ...   .     . .   ..       .   . .   .  .        ..      . .     .             .. .  . .. ..  .    .  . .   .  . .
..  .... .           .        .    .     ..         .             .        .. ...    .   .  ..  .. . . . .    ..    ..  ...  . . . .
. .   .   .     ... .       . ..  .    ..    . .. .      .  ..  .   . ..    ..  .    ... .   .. .     .   .   ... ..  .  .    .. . .
.   .  ..      ..    .  ...   .    .  . .        ....    .   .  . .   ...   . .       .            ..    .     .. .     .    . .   .
...  ..         . . . . .. . ...   .     ...   .             ....   .      .. . .  .      . ..  .. . . . ...  .  .....  . .        .
.  . .  .     .   .    .  . .  .  .. .. . .. ..          .    .       ..   .  .        .  ...   .  .  .         .  .....  . .    . .
. .    .  .   .   .   .   . .    .       .  . . . . .  ..  ..          ... .  .      . ..   .  .                . .      ..   ..   .
..           ..          . .      ..    .. .  .  .   .             ..   ..   .      . ... .   .       .   ...   .     .  .  ...  ...
.   .    .. ..   . . .             . ...    . .  .   . . . ..     .  ..   ...     ..  .     . .   . .     ..    . .    ..  .   .   .
.  . ..     .   .. .       .  .   .   ..   . ... ..        ..   .   . ..     ...  .  .   ... ..    ..       .       .     .   ..   .
.    ..... .     .        . ..       .  .  ..      . .  . . ..  .        ...  .       .    .   .   .         .   . .    .   .    . .
.             .  . . .       ..     ..   .      .  .     . .  .     . . . .      .       ..   .          .. . .  . ..        .    ..
. . ...  .   .  .    . .   . .         .  .          ..  .      .   ..  . .         . .  .    ..    . ....   .    .   ..      ..   .
. .        ..  .  .   .  . .  .     .  ..  . . . . ..  .  . .  .   .       ..  .  .. ..  .  .          . ..  .    .   ..  . ....   .
.   .   .      .        . .   . .. . .   .  .  . .   .  .    ...    .   .         .     .   .  .   ... ...  .  ..      .  .    .   .
.    .  .   . ..  .                  ...   ..             . ..     .  .  .   . .   .. .    ... . .     .  .     .         . .   .. .
. .    .. . .   .. .  ... .           .        . ...  . .. ..       .   .  . ..  .  .  ...      ..       .... ... .  .   .         .
.           .                .     .. ... . ...     ...   ..   .   . .  .. . .     .     ..          . . .    . .  . . .    ...  . .
..    .   ..  .  .   .. ..   ....      ...      . ..   .   .  .        .   .      ...   .   .  . .   .  .    .   . .  .  .       . .
.               .  ..  .     .  .  .  .    .              ....   .   . . .        . ..   . ... .   ..  .. . .      ...  . . .  ..  .
.   .       ..   .   ..        .          . .      .    .   .  ..   ..            .  .    .    ..         .     ..     ..   ..     .
......    . .... ... . .   .   .    ...  . .    .     . .               ..         .  .  .. .   . .  .  .  .  ... .     .   . .    .
.   . .    .  .   .   . .  .  ..      .. . ..  .   ....   . . .. .               ..  .  ..    . .  ..   .  .  .  .  .   .       .  .
.  ..  .         . .. . .. .    .  . . ..   . ..    .   .           .     .  .   . ...                ...     ..   ..   . .     .  .
.                     .     ...   ..   .   . .         . .        ... .        .      ..  .  ...     .     ...  ...         .  .   .
.   ...     . . .   ..  ...  .       .   ..  ...  .   .  .  .  .... ..   .... .     .    ...        .   .  ... . .    .   . .      .
.   . .....    . .  . .  .          .  .   .              .     . . ..     ...    ...   ..       .   .. .  .... . .. ...    ..     .
..      . . .          .. .. .. .  . .             .. .   .      .    .   ..       .  . ....      .  .  .     ..   .   .    .    ...
.      .       .   .... .    ..   . .  .    .    .     .  .   .      . .. .....  .. .. .      .  .    .  .  .. ..                . .
.  .   .   .  .. .   .   .         .  .       .. ..      .  .  .   .     .  .  .. .   ..               .       . . ..    . .... .. .
.  .  .. . ...... .  ....  .  ..   . .  .  . . ..  .  .  .       .      .          .       .. . . .  .  .. .     .  ..     ..    . .
..  ..     .       .  ..      . .. ..    .. .      ..   .   .   . .   . .      . .             .              . .. .      .  .    ..
... .    . ..              . ... .      .      .    .   ..    ..  .  .    .  .  .  .  . .  .  . ..   . ...    .          .. ...    .
.         . . .    .         .  .  ..          .  . . .  . .. ..      . . .     .    .    ..    .  .  .   .    . .  .   .   ...  . .
. ...                 .   .                        .  ..  ...   ..    ..  .   . ..   . ..  ..      . .    .   .. .. .       ..   . .
. ..   ..  .       .      . .  .  ...... ...  ..   .  ..  ...  .  .  .  .      .  . ..  ..    .. .. .          .    .    ..  .. .  .
. .  .       ....  . ...  ...             . . .      .   . .      .   .    .   .  .    . .   ..   . . ..    ..   .   . . .. . .    .
.  .       . ...    ..   .  .  .   . ..      . . ..    .       .. .           .    ... ..  .  ..  ...  . .      .   ..     . .     .
... .   ... .      .   . ..  . .  ..  . ..   ..     .        .. . .          .. ..  ..        .   .  ..     .           .      .   .
.. .. .  ..    .. .     .    ..  .        .  .    ..  .. .               ....  .  ...   .        .       ..   . .  .... ..      .  .
.   .   .  .        . .    .          .    ..     .    .   .  .         .  . . .      .     . .    .   .   . .    .    .           .
.  .  ... .. .     .  .   .    .   ..   . .  .       .    .   .      .     ..    ..    . .       .      ... .    .   . .     ..    .
. .        ..          ..  .           ..      .    .        ..  ...   . ..       ..    . .   .   . .     . . . .    ..  .  .      .
.      . .  . . . .  .          . .  ..         .   .. ...   .    ..   . .  . ..   . .      .     .  .    ..    . .     ..         .
.   . ..          ..     .       .         .  ... .  .        .   . .           ...  .    .. .... ... .   . . . .           .   .  .
.       . .   .  ...  .. . .. .   .  ...           ..    .    .  . .. . . .      .   .  .    .  ...... ..  .       .    .. ..  . ...
.  . . ..    . .  .      . .      . .  .  .. .  .   ..  .        . . . .  .  . .....  . . .   .    .   .   .    .        ..  ..   ..
.     .   .  ...  ..        . . .  .    ....           .     .   . .. ..   . ..    ..      . . ...   .. .   .      .    .  ... .   .
.  . ....  ...           .. ..  .  .   .  .  .        .   .  .... . ... .. .   .     ..    .  .  .     .     .  . . .  .  ..       .
.  .               .    . .    ..    .  . . . . . . ... .. .. . ..      .   .   .   ... . .   .  . ..      . .    .    .     . .  ..
..       .    . ..  .    .   .. . .      .   ...... .    .    .     ..    .  . ..       . .. .  .         . .. . . ..   . . .. .   .
..   .  .    ... .    .   ...  .. .  . .   .         .   .  .    . . . .   ..  . ..  . .... .      .     . .  .   .       .       ..
.  ..    ...    ..   ..                  .    .  .    .. .            ..               .       .             .         ...  ..     .
..       .   .   . . ..        .  ....      . .   .   ....   ... .   .  .. ..  ..        . . .     .. ..      . ..   .        ..   .
.      ..      .  . .      .      ..  ..          ...    .    .... .        ..    . ..  .  .   .  . .     .   .        ..      . . .
. .  .    .  . ..   . .  ..   ..  .  .  .. ... .. .    ...       .     ..  .  .. .       ..  .. .  .  .   . .                    ...
.   . .    .    . .    . .. ..  ..     ..     .. ..   ..     . ...       ..      ...    .    .          ...  .    r    ..  .   .. ..
.  ..       .   ...  .    . .  .     .      .. .   .    ..        .   . ......  ..   . .    . .     . .        ..            . .   .
..         .     .   . .... .      . .     .  ..... ..    .  .    ..  .  . ..       .. .. .   .     .   .       .          .       .
. . .         .   .    .  . .   .. . .     ..   .    . .   .    .       .      . ..  .     .      . ..   ...    .   .   .  .       .
.       .      .   .    .  . .     .   .  ...  . ....  .    .   .  ..   .  .  ... . ....      .   .       .     .  .  .  ...  ..   .
. . . . . .       ...   .  ..  . ..     ... . .       .. .      ..... . .. ....        .             .   .     . . ...  . . .   . ..
..    .. .  .     .    .  ..  ..  . .       .  .    .   .   ... .    .   .              . .         .      . .. ..  .  .    .      .
..  .      .    .  .       ..  ...     . .  .     ...   .   ..  .      . .   ..  .   ...      . .   .   .    .   .. ..   ..  ..    .
... .  . .     .. . .  ..      .  ..      .  .     .   ..   ..  ....  .. .     ...    .. ..  ..   .  .       .  . .    .. . ..    ..
..    .. .. ..    .  . ...  .  . ..     ... .      .  .      . . .. ...    ..       . .  .    .   .  .     ..                . . ...
. .   . .     . .      ..  . .. .       .   .   .    . . .   .  .. .      .   ..    .     .  .   .  .                .   ..  .     .
... .    . .     .     .             ....     .  .   .   .  ...       ..      ..   .  .    ..    .       . ..    .  .         .   ..
.       .   .     .    .     ..   ..       . . ... . ..   .  ...       .       .. . .    .. .      .    .                .        ..
. .   ..     . ..   .      . .  .  ...  ..  ...     ..    .        .. . .  .    . ..  .  .    ..   .   .         ...   ....     . ..
.   . .  ..   ..    . ..   .  .  .  .    .   .  . ..            .         .       . .. . .   .        .   . .. .           .  .   ..
..      ..    . ..  .. ..      .    .   ..  .  . .    .     ..          . . ..       .       ..  .     . ...   .    .  .  ... . .  .
..  ..  .  ..     .. ..  .     ..    .         ..   .      .   .        . .. .    .  .       .   ..    ..   .  .    .   .    .. .  .
..    . .....  . .    .  . ..   . .    .  .   . .  ... .   .   .   ...... .        .   .  .  ..    ..    ..      .                 .
. ..    .. .   . . .   .    .  ...   .. .   ..          .     ...    .         . .     ... .    . .  .      . .     ..  .  .       .
....       .   .   .   .            .   .           .  . . .    .     . .      .  . .                .   .      .   .  . . .       .
..       .    . ..   .  .    .. .              .    .   ..    ...         . .     .  .     .. ..  .  ..   .  .         ... .     . .
. .      .        .  .     .  .    . ..  .    . .    ..   ..    .   . .      .       ..  ...      .   ...  . ..... ..    . ....    .
.. .. ..  .  .        .   ..  .     .   . ..   . ..    .    .            .     .     . . ..  . .   .  ...  .     .   ..     . . .  .
..       .    .      .  .  .   .    ..   . .  .   .   . ..         .  .. ..    .    .   . . .       ..      ....  .    .   ..     ..
..   .    ...  . . ... ...    . .   . ..     .   .         ..    ..   .            . .    .  .      . . .       .  .    .  ...     .
.  .. ...      ..  ...     .  ..  . . ...  .      .    . .  .. .  ...   .       . . ...   .     .             . ..  .              .
.    .    .. .      . ..  .    .. .   .  . .    .     ..         .    .      . .    . . .    ..   .       .  .  ...     .  .  .   ..
.       .   .    . .      .  .  . .      . . .        .     .    ...  . .  .    .        .. .        ..   .  .   ..        ..  .   .
....    ..   .   . .     .   . ...  ..  .      .     ..  .      ..  . .  .   .   .  .    .   .    .       ..  .               ...  .
.. .. . .  .   .. ..     .       .   . ..      .        ...  .   . . .  .  .  .  . ..  ...        .      .  .         . . ..   .   .
.  .   .   .. .  . . .. .. .    .. . ..  .  .... .   ... . .         .   .   .        .    . .  . ..  .          .   .     .  .. . .
.     .   ...     .      .  .   . ...   ..  .         .   . .. . .   .      .  .  ...  .      .   ....    .  .   .. .   . ..   .  ..
....................................................................................................................................
