.....................................................................................................................................
.  .      ..   ..         . .  .  ..  . ..       .   . ...   .   . .     .   . .  .              ..        . .   .   .       .  . ...
.    ....   .       . ...  .    ..   ..  ... ...       .  .  .     .    ..    .    .   ... .        ..   . .. . . ..    .  ..   ... .
.    .  . . ..  ... . . .  .           .        .      ..   . .  .                   .    ...    . . .. ..... .   ..  . . .     . . .
.  .         .    .  .   ..... . . ...  .       .  .. ... .    .    ...     .         ..  ..   .    . .     .   ..      .   . .    ..
.. .       ...      . ...    ..  .     .   .. ..   .        .  .   .  .            .  .   . .    . . .. .           .   . ..   ......
. .  .       ....   . .     ..     .       .  .. .  .     .      .   .   . .       .      . .              .  . ..     . .   .     ..
. .. .  . .  . .     .       .     . . .     .     .   .         ..  ...    ..     .. .         . . . ..    .   .     .  ....     ...
.   ..  .    .   . .            .     .  . ..  ...... ..    ...   .     .       .  .       . .   .  .      .  .     ..         . . ..
.  ..  ...           .      ..     .   .  . ..   .   .        .. ..    .  .          .     ..   .  . ......  .    ..    .. .        .
..   . .         ..  ..     . .   .    ..  .   .   .  . .   . .  .  ..        .   .    .    ..  . ..       ..   .  .   .   .       ..
.      .   .    .        . . . .      . ..  .    . .               ..        ..   ..   .          ...     . ..  . .  ..          .  .
.  ..   ... .    ..     .  .  .   ..       .        ..  ...  . .  . .  .      .      .  . .    .   ..   .  .      . . .  .    ..  ...
.  .      ..  .  . . .  ..    . .    .   . ...        ..      .. .    ... .  .     .           .   ... . .  ..  .  . . ... .  .. .  .
..        . ..  .  . .       .       . .  .  .  .   .  .         . ...   . ....... ....  . .     .  ..  .     ... ..      .. .    . .
.     .    ..       .             . . . .    .     ..     . ..     .        .  . ..  .    .  .       .. . .  ..       .   . .      ..
.    . . ..         ...   . .    .  .  ..  .  .   .      .              .  .  ..      . .     .   . ...  ...  ....       .. ..     ..
.   .      .          .          .  .  .  .   ..   .  . .  .  .  .       .. .    ..     ... .   . ..    .   ..   .. . . .   ..    . .
.   . .   ..  . ..   .  . .       .            ..  .    . . .    .. . . .   .  .     .    . . .  ..          .          ...  ... .. .
..      ..     .    ....   ..    ..    . ..      .    .   ...      .  ..    .    . .    . ..  .   . . .      .  ...  .              .
. .. .       ...       . .. .   .  . .  ....   .     ..  . . .    ..       .      . .  .      .    ..  .    ...  ..      .   .    . .
.    .    .     . . .    .. .         .    .. ..     .   .     .  .  .    .  .  .        ..     .     .   . ...    .. .       .     .
. . .   .   ...          .   .     ..  .  .    .  . .    .. ..       .  .     .    .   .    .               ....  .   .        .  . .
.    . .  . .  .  ... . .    .  . .     .      .     ..         ..        . .  .   . . . .....   .   ...   . .. .    .     .    .   .
.. .    ..          ..   . .      .  . ... .    .     . . .  .  .  .   .. ..       .   . ..     ..      . .   ...  .  .  .  . .  .  .
. .  ... .  .    .    . ....  ...    ..          ..  .     .   .    .. .   .   .  .   .  ... .. .      .     .  ..        . ..   . ..
.        ....  .  .  ..     ..    .  .    .. .      .  .  .  .     .    ..  ..     .              . . .   . . .   ...       .      ..
.       .         ..  .       .  ..            .          ... .   ..        .. .         ...      .  ..    .  .  . ..   .       .  ..
..      . .   .  .      .         .  .. . .  .    .    .       .    .   .    .    . ..   .             . .   ..        .    ....... .
. .  .       ..    .   ..      ...     .     ..         .. ..  .      .  .         ..      . ... .   . .    ..      .   .. .   . . ..
.  .. ..     ..  .. .        ..     ... .    .  .   .             .  .   ..   .  .  . .. .  . .   ..           .  . .  ..    .   .  .
. .  .   .      .  .       .     .        . .     .. . ..   ... ..    .  .    ..  .   .        .    .       ..   .. ....  .   ...   .
.   .     . .  .  .    . .  . .. .      .....  .  .      ...   .    .. . ..     ..  ..  . .    ....      .....    .    .     .    . .
.    . . ..   .   ..       . . ...        ..  .         .   .   . .        .       . . .     .. ..     .   .   .     .    .    . . ..
.  ..        ...   .  ....           .      .     .  .  . .   ..  .  .   .   .  .     ..   .    ..  .   ..     .     .   ..      .  .
.       ...  .  ...     .    ..   ..   ..  ....    .  .     .      .  .       ..  . .    ..       . . ..    ... .   . .      .     ..
.    .  .. .. .  .  .        .     .       .  .    . . . .    .    .   . . .  .  .         .  . . . . . .. ..   . ...    . .  . ..  .
.. .     .   . ..  ..    .  .        . .. . .       . .  ..  ..  . .     .. .. ... .    . . .. .        ..  .   .  . . .            .
.     .   .      ..       . .   .  .... . . .     .   ...  .    .     .     . . ... .  ..  .        .   .....   .    ..  ....     . .
.         . . ..  .   .. . . .  .. .. .. .    ... .     .. ..    .  .        .. ..      .       ..   . .  .. .    .  ..         .   .
.. . . .  .  .. .     ..  .  .    .  . ...     ..   ..  . ... .     ..  ..    .. .         . .     .     ..     .   .  . .     .    .
.. ..  .  .. .    ..    . .    .    . .. ...       . .      .    . .  ...   ... .  . .                 .   .           .     ..  .. .
.         .. ....    .  .       .            . . .  .   ...               .. ...   . ..      .       .    .  .     .  ... ..  ..  . .
.        .    .  . .   ..    .        .    ..  . .  . .        . .   ..    .  .. .  .         .       . ..  .  .   .   .   .   . .  .
..   ....    . .....  .. .    .  .  .. .    .  ..    .    ..    ...  .  .    .     . .   .       .  .   .    ..  .     ...   ...   ..
. .   . ...  . .  .  . . .. . . ..   .      .   . .      .         .       . .   ..   .    . . . .  .   ...  . . .        .  .      .
....     . ..  . .    .. ... ...  .  .  . .  .. ..  . . .. ..  .  .          .  . .  .             .   ..   ....   . . ..   .   . . .
..  .  .  .  . . ..   .  .. ..      .  ..  ....   ...      .    ..   .     ..   .    .   ...  .   . .     . .    .   .     ..    .  .
.   .     .    ..  .    ...  .     . .  ..    .  ..     ..    .   .  .          . .  .   ...       . .                         .  . .
.. .   .... .         .    . ..         .  .  . .   .  .      ..     . . .   .  . ...  .   .   ..   . .  .   . .  ..  ...     .  .  .
.   .     .  .. .  .   .   ..       .      . .     ..    .          ..   .     . .      . .. .  .. . .... .       . ....      .  .  .
.     .   .. .   .   .  .     .  .  .  .       ... ..  .  .  ... ..   . .       .    .   .    .   . .  .       . ..   .  . .    . . .
.  ..   .   .... .  ..   .  .  . .        . .     . ..    .       .  .  .   ..   .     .      .  . .    .    .. ...  . .. .    . . ..
.... .       . ... .    ..  . .    ..     .         . .     .    .     ..               ..   .      . .. ..  ...  ..  .     .       .
.  ..  . ..   .  . .    . .     ...          . .    ..      ...   .       .      ... . . ..   .. .    . .   .. . .  . . .    .      .
.    .  .      .  . ..        ...   .    .    .  . ..            .   .  .. .  . .  ..  .       . .  .   ..  ..  .  .   .  .... ..   .
.  .. ...  .           ....      .      .          .  .  .          .   . .. . ... .  .    .. . .. .   ...    . ..     . .    . .   .
...       .       .  .    . .   .    .   .  ..   . ..     .       .    ..     .  .  .    ....        . .        ..           .      .
.       .   ...  .  .               .   .    .....       ..          .  .  ...     .             ..  .. .  ..     .    . ..       ...
. ... . .  .. .    .  . .      ..   . .  .   ..     .       . .   .....       ..  .      .  ..     .    . .. .. .    . .     .   . ..
...     ..       .  .... . ..   .  .  .  .    .  ..  ..       .     .    ..  .  . ..     .         ..   .  .  ..     ..   .  .      .
.. . .   ..       .  . ... .  .  . . .  ..      .  .    . ..    .    .  .. ..  . .. .  . .   ..  .  ...  .        . .   .      .  . .
..  ... .. .  . .        .  .   .  .. ...  . . .  .    . .  ...                 ...   .....    .  .   .      .  ... ..       ..   . .
.  .   .    .    .     .              .   .           .  ...    . .    .   .. .. .     .    .. .. ..    . .    . .   . .  ..    ..  .
.       ..      .  .. ... .               .     .  .  ... .. .  ..     . ..     .  ..     ..  .  .  .  .     .    .. .    .     ..  .
...   ...  ..           .      ..     . . ..        .. .  .      ..          .  . .    ..     ...    .    .  ..      ... . .   .    .
.        . . .       .  .   .   ...   ...     ... ..   .  . .   .   . .  .. .   . . .        .  .     .  .     . .  ...  . .. .. .  .
...     .     .       .  . . . . .    .. .   .       .  .. . . .    .  . ... .        ... .   .   .  . .   .       . ..           . .
....    .      .  . .   . .   .     .   ... ..     . .   . .         .        .. ...  . .....      .   ...        .. .        .  .  .
..     .    .. . .  ..  .   .    .    .     .      .... .  .     .    . .      .. ..          ..   .   . .. ..  .   ... .   .  .  . .
.  .    .   ..   . .         .. ..  ..   .  . .          . .     .      . . ..   .   .  .. .. .  .  . .  . .  .    ..   .    .  . ...
.. . ..  .      .  ...                   .... .             . . .. .     .        . .   . .       ..  .  ....    .  ... .           .
.  . .    .  .. .     .. .       ...  .. .     ..   .. ..     .   .   . ..  ...      ..    ..   .   .  .    .    .. ... .  .    .   .
.        .  ... .. . .    .     .. ..  .   .   ......   ..  ...     .       . .                    ..  . ..         .            .  .
.    .       ...  . .      .       ..... .. . ...... .     .   .   .  .. .  .         .        .      . .. .  .  .  ..  .   ...     .
.    .. . .   .       . . . .      . .   .  .    ..  . . . .. .      .          .         .  . . ..    .    .     .. . .. . .       .
.. .     .   .. ...       .                  .   .   ..   .    . .    .      . .. .  .        .  ..       .  .  .  .          .   . .
..  ... .     .. .            .   ..  ..  .   .         .   ....       .          . .      ..    . . .    .  .. ..        ..        .
.    .      ..    .. .        .    ...  . .  .    .. . ..  ..    .  . .. . ..    .    . . . .    .         . .   . . .  ..  .. .. . .
.     ... .   .      . .   . .   ....  .                ... .    .  .  .     .  ... .    .. .  .  .    .   ..     ....   .   . . .  .
... ..  . ...  .   .           . .. .  .   .          .    .         .     .     .    . .  ...   .   . .   .   ..     ...   ..   .  .
..    .  .     .  ..    . .. . . .   .   .  ........   . ..             .    ..   .  . .  . .     .     .     .   ... .  .  ..    ...
. .     .    . .  ..  .   .  .     .   .  ...        ..  .       .. .  . .    .. .            .           ..  .    .    ..  .. .  . .
.  . ..         . ..    . .          .  .       .   .. .   .   .    .      .       .  .  .  .      .  .  .  .    .       . .  .   ...
..    . ..  . ..   .    .. .  ..  .. . ..     . ..  .       .   ..      .. ..    .  ..    .         ..     . .  .      .        . . .
.  ..       .         . .    ..          .. .         ..  ..   .  . ..   . . .. .  ..   ..  .    ..    ..  .. ... ..      ..      . .
.   ..  . . .   .       .  . .    ..      .  .        ...  . . .  .       ..        .  ..  .       ... .. . .   .   .   .    ..     .
.  .         ..  . .  .      .  .  .    .   .            .   .    . . ...    .    ..  .  ..   . ....       . ..       ...     .     .
.....  .       ..   .  .       ..     ...       .    . .    .  .. .  . ...   .     . .  .  .             .. .        .    .     .. ..
.. ..   .  .  . ..             ..    .        .          .      ...    .   . .... ..  .. .. .       . .  ...   .  .      ..         .
. .    . .    .  ..    .  .  ..      ....    . . . .... ..   .  .     .         .   .   ...  .   .  ... .  ..     ..       .     .  .
.. . .   .   .... .   .  . . . . ...   .. .   . ..  ......  .     .      ..  ... .     .       . .      . .     .  ... ....         .
.     ...       .   .   . . .      .   ..  ..       .        . .  .  ...  .       .              .    . .           ....      .     .
.    .    .    ... .      ..   . .  ..          .  ....   .    ..... . . . .           .   .   ...     .      . ... .   .  ...   .. .
...      . . .     ..  .  ... .   ..   .     . . .  ..   .    .  .       . . ..  ...  ..     . .  .    .  .       ...    . . .   .. .
.       .       .   .    . . .      .        .  . ..   ... .  .  .  . . .    .   .         .. . .  .   .. ...   . . .   .    .  .   .
.        .     .. .    ..      .           . ..  .    .  .      .    . .           .        .   .  . .  .  .  ..   .....      . .  ..
.     ..   . . ..    .         ...   .  . .       .      . .      .        ..  .    .  .   .         .  ..      .. ..   .  .   .  . .
.   . .     . ...   .      .           . ..  X ....   . .     .               .. .        . ...      . ..      .   .. .       .   . .
.  .   .  .  . .    .   .  ..           . . .      ... .. .       .                 ... ..   .       . .  .... ... . .  . .    .    .
.     . .        ..  .    .. .  . .  . .   .    ..   .   .  .. .  .  .  .. . . .    ......  .   . ....   ..  . .    .. .      .  .. .
. .   .  .. ....           ..     . ..  .     .    ..      . . . .  ..    . .   .        . .   .  . ..  . . ..    . ..  ...     ..  .
.              . .  .. .  .     .  .  . .    . . . ..               .      .    ...        ..         .  . . .  ..  . .. ..  ...  . .
.   . ...  .  . .    . .. . .    ..           .  . .     .          .  . ... .   .   . .. .. .  .    . ..   ...            . . ...  .
..  ...  .  .         .     . .  ..  .  .  .        .  .  ..  .  .  .  ..  .          .      ..  .    ......  .  .      . .      .. .
.   .. .  .... .   ..   .     . .       .   .      . .  .   .       .    .     . .   .    ..  .     ...       .  .    ..            .
.. .. ...    ..    .   .   .   .    .  .   . . .. .      .   . .. ..     ...    .     .      .      .          .   .    .   . .     .
. . .       .     .       ...         ..  . .   .  .  ...     . ...   .. .    ......    .            .      .   . . .       ..  .  ..
.  .   . ..    .  ....   ..  .  . ..   .      .   ..  .  .  . .  .....        ..         .      ..  . ..  .... .   .      .   . .   .
.. .   .    . .   . ..             . .     .           .. . .   .    ... .  .  . .      . .       .  . .        .        .  .    .. .
.          .. .      .    ...   .     ..  ..  ..    . ...              .      ..    .        .              .            ..  .  ... .
.. .  .    .  .. .   .  .  .   .  .   .             ..  ...   .   .   .  .. ...   ...  . .   .  .           . .   .        .  ..  . .
.  . .   ...     .      .. . .     .  . .    ..       .. .. ...        . .  ....   .       .      .  ... .  . .     .......  .     ..
. ...   . .  .       .   .  .   .  .  .   .  ..    .  . .        . .   .. .    . ..  . .  .    .   ..        .     .               ..
.     .     . .    ..     .  . . .       .   ....   ... .    .     . .    .     . .  .. ..          .   .  .   . . . .  ..     . .. .
....  .  . ..  .           . ..    .    . . .  .     .  r ...  ..  .    ..   ....   .    . .. ..   ..    ..  ..     . .        . .. .
.      .   .   .  .     . . .  . .   .  .  .       .     .  ..       ...  ..      .   ...      . ..   .   .     ..  .   .  .    ... .
. . .   .    .         ..         . ..       .   . . . .   ..       .          .  .. . ..    ...    ..      .         ..  . ..  .  ..
.  .   . .   . .  .  .     .      ..       .       . .    .        .  . ...  .   .                     .    . .  .      .    .... . .
.. ..          .  ...   .. ..   .  .   .       ..            .    .    .   .         .  ...     .  .    ...     .   ....   .    .  ..
.. .  .               ..     . .   .. ...    .       .      . ..    . . .   .  .     . ..  .   .   . ..        .    .   .       .  ..
.      .   . .  .. .   .  .. ..    .. . . .    .      ....     .... . ..            ..    .      .    .   .  .  .   .      .  .  .  .
.      ..   .  .    ....  ..   .   ... ..  . .   .  . .   .  .     .. ..     .    . ..            . ......  ...     .  . . . .   .  .
.    .       ..  .  .    .  .   ..  ..  .  . ...        .       .    . ..       ..     .          .    .   .     .  .  ..   . ..   ..
.      .  .    . .   .          .  .  .   .. .  .   .  .   . .  .   .  ..           .  .    .      .      .   .   .  .   .  . . . ...
.    ..       ..       ..  .   .. .      .  .  .  .  . .       .      .     .. .  . .  ..     .  .  .  ...   . ...          . ..  ...
.   . .  ...   . .   . . .    ..  . . ... .  .  .      .   .. .          .     ..   .. .  .. .      .. .    . .  .   .   . .. . ..  .
.  . .     . . .       .  .  ..    .      .  .  ... .    .   .        .. . .   .  .  .. .   . ..    ..     .        ..      . .  .  .
. .        .       .            ..      .        . . .    .          .... ..      .  . ... .. ..  .  .   . ..   .  .   .     . . . ..
..  ... .   .  .  ..            .       . ...              . . .. ..  .    .    ...  .   ..     .  .     .  .   .   .   .. .  .     .
.   .... .. .   ...    ....  ..  .           . .     .  . .. .       . .    .  . . ......        . .       . .. .           .       .
.. .     . .    .     . .  . ..  ...  . .   . . .       ..   . . .  ..      .   ....   .  . .  ..  .      .   .           ..   .    .
.....................................................................................................................................
