......................................................................................................................................
.   ...        .     ..  .    . .   ... .       . . ..          .      . ..  . ..  . . . .......  . .    ..       . . . .      . .   .
.      . ..  .     ...     ..  .          . .     .          . .  .  . . ..    ....       .. .          .        .      .  .    . .. .
... ..   . ... .  . .     . . .  ..  . .        ....        .  . .    .  .   . .   .    .      .. . .  .       .. .    .  . ..       .
.  .           ..    ..  .     .  .   .. .   .     .  ..     . . .        . .    ....   ...   .     .      .    .. ...    . . .. .   .
...    . .  ..       . .   ..  .    .      .   . .. .  .   . .   ..        .  . .  .   .       .... .  .  .. ..   . .       .   .    .
.  .  .       . .. .     ..   .   .   .    .              . .        ...  .    ......   .. ..   .   .      ...         .   .    .    .
.       .    .     .   .. .  .. ...     .    . .        .  .    .            . . .  .        .  ..      ..  .   .   .  . ....    .   .
.  .    ..   .. .   .   ..      .  .    ..  .         .....     . .  .  ..  ..          .  ....  . ..  ...  ....   .   ..     . .. . .
.    ... . . .         .     . .  .  . .   .. . . . ....    .      .. .   . .. ..  .      . .. ..    ..      . . .    . .   ..   . . .
..... .         .  .       .  ..        . .    ..   . .. .  . . ... .  . .  ..  . .   . . ....   ..  .  .  .   .    ..   . ...       .
.    .   . ......       . .     .     . .. .    .     .  ...    ... .    .. ..            .    ...       .      .  ..   .   ..   ..  .
. .       ...    .  .      . .   .. ..       ..      .  ..  .  . . .        ..  .   .         . .      . ..   .  .              .  ...
. .  .  ...  ...  .    .. .  . .  ...   . .    .   ......       .   .. .  .  .      ...       .     .. ..    .         .    ..    . ..
.  . .   ... . ...  .       .  . .  ..        . . .      .        .  ...     .  .   .    . .   .    .    .  . .. .  .  . .         ...
..   .  . .  . ..     .        . .   ...      .   .          .. . .       ..   . .  ..        . ..    .  ..    .    .      .  ..     .
..       .. .. ..          ...  .    .  ..  . .   ..   . .            ..      .   .   .    .       ..  .      . . ..  .  ..  .  .  . .
. .               .    . . .         .   . ..  .  .. .      . .  ..   ...   .....     .. .       . . .    .     . .              .   .
.  .. .. ..  .....    . . . .     .  . . ..  .. .    .. .         . .      .  . ..  .. .     ..  ....           .     .. . .   .  .. .
..    .   . . .  . . .  .    ..            .     .  . .    .        .  .     .   ...  ..  . .  ..   .   .     ...  .  .      . .     .
.  .    .               .. .  .  . . ..    .     .         . .  . ... .         .       .     .    .        .        ... . .  ..  .  .
. .     .   .. .  .. . ..        ..       .  ..           .   .    . ..    ..              . . . .. .  .     .     ..  ..      . .  ..
.   .               .. ..    .    .. .. . .  . .   .. . . .  .   .          .    . ..  .. .      .  . . .    . .     ...  . .. .. . ..
..   .. .    .           ..   .   .    .      .     . ..    .  .   . . .  ..  ...       ...  ...   . . . . .     .  . .   .    .     .
.  .    .    .  .   .    ...   . . .  .. . .    .   .    .   .  .  .  ... ..   ..     .     ..   .       . ..  . . .  .      ..      .
.. .  .  ..   ...        .. .  ..   . .  .         .  .  ...    .     ..    .   . ...  ..                   .   .  .  .       .     ..
..      ... .  . .   .  ..  ..   .           . .     .  ..  .      .   .. .   .  .     .              ..       ..   .. .    .      . .
..    . .   .             .   ....  .    .        ..      .    .         .   ..  ...    .   .   .            .  .  .  .. .        .. .
.   ..     . .    .    .   .. . .  ...   .   . .       .     .       . .     ..  . ..   ..       . .   .   . .  .  . ...             .
...   ..              . .  . ... .  .    ...  .    .. . .   .  . .        ..   . .  ...       ..  . .    .   .      .. .... .. ..    .
.    .       ..    .    ...  .   ...      .  . ... ..   ..  . .... .      .      . ...     .   .               . ..     ... .   .   ..
..      .  . .  . .  .          .   ....   . . . . .    ..    .  .    . .  . .            .   . .... .    . . ..   .       . ....    .
.. . .      ..    .       .   . .   . .   .  . . .. . .. .      ..              .. .    ..   .     ...    ... . .... .. .    .      ..
...  .    .  .     .          . .   .    .        . . .      .. .          .  .   .      . ..  ..      . ..   .     .. .        . .. .
. . .      ..   . .    .    ... .. .  .                  .   .     .    .     .   .    .  .   .. ... ...     .  . .  .      .        .
. . . .   .        .           .   . . .          ...    .   . .   . .     . ... .      ..    .  ..    . . ..     .   .   .      .. ..
. ..      .      . .  .    . .   ..    .      ..    . .  .. .....   .     .  . ..   .... . ..    ..      .  .     ....  ..    .   ....
. ..  . . .   ..   . ..  . . .    . .    ... . . ..    ...  ... .. .    .     . . . . .  ..        .. .       .  .. . .         . .  .
.     .. . .    ..    ..     .  ...    ..  ...     ...  .      . . .    .    .  . ..   .  .     . .     .   ..    . .  ... .     .   .
.  . . .  ... .   ...          .  ...  .   ...   ..   .  . . . .     ... ..    .     .              . .  ..  . . .  .   . ..  .  ... .
.         . . .     .. ..    ...  . .  ....     .              .       .   .        .. ..   .  . .  ..    ...    ...   ..  ..    .....
.  .....  . ..    .  .      .  .  ... .        .     .   .... .    .     . ..  . .  .  .. . .      .        ...       .    .  ... ....
. . .    ..    .    .     . . . .     . .   .. ..  .   ...              .   . ..  .        .....  ..  . . .    . ...   . .. .  . ..  .
.     .   .. . . .        ..     .    .        .  .. .    ...   .  . .   .   ....    ...     .    ..       . .  .  ....  .. .. . ... .
.. . .   ...   .     .  .  .   ..  . .  .  .    .                  . .. . .              ..   . .     ..        .   ... .  .  ...  ...
.  .. . . .      . .    .   . ..   .  .      ... .        .    ..         .  . .              ...  .  ..     .    . ... . . ...  . . .
...   ....    .      .       .. .  .      .              ..   . .  ..   .      . .    ..   . .  . ....  .    .. .. .        .  ...   .
.  .. ....      .   ..     . .....         . .        .   .  .     ..   ..    ...  ... ...  . .   ..    .   .  . .   ..      .  .  . .
.  .        . . .. .  .     .   .   .  ..  . .. .   ...  .  . . ..    . ..          .  .     .        ..     .      .  . .    ..   . .
. .  ..    . ...  . ..    . .  ..  . . . . . .     .    .   .   .    .. . ..  .    .  .     .  .   ... . .         .. .  .           .
.  .   .       . .   . .        .    ..     .  ..  .. .  ..          .   . . . . .  . ..  ...  ... . .  .      ... .       ..   . .  .
. ... . ..   . . . . .   .  . ..     . . .   ...    .     ..    . .   .  . ..... .    .  ..                      .    .      .   .  ..
....  .     .  .    .. .  . .      ... .       ..  ...  ..   .       .      . .... ...          ..    . .            ..  .  ..     . .
.. .    ..     ..       .  .   .   . .   .  .         .. .  . . . .           .     . .  .   ..     . . ...     . .. .  .  .      ....
.   .   . .    ...   ..           .. ...      .     ..         .    .   .   ..     ...        ..    ..     . . .   . .    . . .      .
.    .   ..  . ...   .       .     .  . .  .     .... .      .    .      .....          ..   .  .  .   ..   ...  .          . .. .   .
.  .     . ..  .  .. .     .   .  .     . ..   . . . ...     ..   .   .  . . ..   ...        ..    .  . . ..      . . .  .     ....  .
..   ..    .     .  ..   . .  ..  ...    .  .   . .                .  .. ..  .. .       ..  .  ...       .  .  ..  ..   ..      .  . .
..  .  ..   .     .   .    .   ..        .  .    .   .  .  .    .   .       ..   ....  . . ...     . . ..     .     .  . .   . .. .. .
..     .          . .    .   .     ...    . . .   . .            . .     ..  .   .  .      .      . ..   .      .     . .  .  .. ..  .
.    .. .. . ..     .    . .   .       .    ..  ..       ....    ...    .  . .         .  .     . .. .    .              .    .  ..  .
.  . ..    . .  .......    ..    .. .  .  .   .   .  .      .  .      ..  .    .  . .  .      .....    .    ..... .     ..  .     .  .
. .      . ..   ..  . . ..   .  . .    . .    ..       ..   .     ..      .   .  ..     .     ..      ..   .    .    .       . .     .
.    . .  .   ..  .         .  .  .  .   ..      ...   .    ..      ...  . .    .   ...   .  .. .     .   .  .  ...         .     .  .
..  .     . .     ..  .        . .... ..   .   . .  .. .. .   . .      .    .  . .  .   . ..        .    . . .       ..   ..   .    ..
.        .    .       ... ..     .. .   . ..      .     .   . ..            .           ...   ... . .  .. ...  .     .    .   .  .   .
.  . . ... .      .   .. . .     ...     .. .  . .   . .     .        .   ..    .      .     .   .   . . .. .    . ..    ..      . ...
.   . .         .   .        .     ..           .   ...    .       .    . ..   . .      .. .  .   ..  .   .    ..      . .  .        .
.   ........ .  . .    ..   .     .             .   .  . .   . ...  . .              ..   ..     .   .  ..  .. . .   .     .. .      .
.  .. . . ...             . .   ..  .      . ..       ..  .       ..  .     . .  .   .  .    . .  ..   .   ..    ...          .  . . .
..  .     .      .        .  .   . .   .  . ..       . . ..    .     ....  . .. .            .            .       ......  . .  ..  . .
. . .  .   .     . ..  .       .    . .. . . . ....  .     . ..  . .. .     ... .    ... .     ....        . .... .   ...      .  .  .
. . .     .......   .  .  .  .       ..  .        .. .    .     .. .   ... ...    .  ...   .     .  ..   .      .   .   ..   .  ..  ..
....      .       . .    .     ..   .   .   .     .  .. ...    .        .   .      .  .. .   .      . . .  .  .   .             ..   .
. .  .        .. .      ..  .   ..    . .      .    .        .      ..    .   .    ...                 ..    ..   .. .. ...  ..  . . .
..     . ...  . ......     . ..   . .. . ..      .      .   .. . .  .  .     .  .  .     .   .    .. ..    .   ...   . .   ...  .   ..
.  .     .  .. .   .. .  ..  .. ..   .    ..   .   .   .   . .   .     . .  .. ... .        .    ..  .         . .... ...      .  .. .
...       .     ..   ....  .       .  .              .   ...      .    ..  .  ..    .   ..  .      .      .    . .   ..      . .    ..
. . .. ..  . . .  ..       . .     .  .   .  ..         .     . .  .    ..     .      .  . .      .      .. .      .. .              .
.. .. ..  ..     .  .  ..  .   . ..  ..    .    .  . .       .      .   .  . ..   .    .             .   .    ...     . ... .     .  .
.       . ... ..   . .      . .  .      .    ..   ....     .           ..   .  .  . . ....  . .    .  ...        .       .  .   . .  .
. .  .   ..  .  .. . .     . .   .  . .       ...   .. . . ..  .  .   . .  .      .        ..   .   .        ... .    .    .         .
.     ..  ..    . .   .      ...  . . ..      ..   .      ..   .  .  .    .. .  .  ..   . .  . .. ..  ..    . .  .    . ... ...      .
. .    ...  ..     .   ....   ....  .     .   . .. .. .  . .      .   . .              .. . ..  .      . . .     .     ..   ... ..  ..
.   .      .    .      ..    .  . .     .   .    .  . ..  .. ...   .                  ......    .     .   .    .       .  ..   ..    .
.     .. .  .       ..   ..   .   .                 ....      .    ...  . .      ...       . .         .  ..   .   .        .    .   .
... .  .  .   .    ....       .  .     .   . . . .. ..   .        .        . .   ....   .     .   .       ..           .. .      .  ..
..   .        . .      ..  .        .  .  .    .     .            . .        .  .   .  .  ..  .. .  ...  .  .  .         ...    ...  .
.   ..   ...        ..  . .    ..    .         ..             .  . .   . . . ....  .          .          .  .   .   . .. . . ..      .
..       .     .  .  .           .   . .   .   . ...         .    ....     . .    .   . . . ..      ..   .        .   .. . .     .  ..
..       .  .     .     .   .     . . ..    .  .   .  .  . .    ...     ..        .  .   .   .  ...  ... . . .    .  .      .     . ..
. ..  ... .  .  ..    .     .        .      .  .           .      .      ..    .  .  ...       ....     .     .   ..      .  . .     .
.     .        .       ... .  .  . .      .         .    .  . .  ..       .   . .    .         . .. .        .. .     . .   .     .  .
.          .  ....   .   ...     .  .. . ..     . .. .    .              .  ..     .        .           ..  .      .  ... ...   .  ...
. .   .         .      .  .  .  .  .   . .  .      ...      . .     . ..  . .      . ..     .    .  .   .      .    .  .    .   . .  .
..   ..       .  ..    . . .  ..      .   . . .   .    .. .. .. .   ..     ... .  .  . .  . .  .  . .      . .  ... .       .  .     .
. ... .         .     .      .    . .  .    ..   .   .   ...         . . ..        ...     .   .  .  .     . . .. r     .    . . .   .
..   . .     . .     .   .   .     ..   ..   .  .      ..   .   .     ...       .   . . .  . .  . ..  .     . .      .         .     .
. .  .   ..      .    ...      .  . .  ....   .   .    .  ....    ..   ..   . ..   ....  .   .. .     .  .  .  ..    .          ..  ..
.   ..    ....      .    .   .. .. ..     ...  . . .   .   .. .      ..     .     .   . ...         ..         .    .     .  . . .   .
.      ....        .. . .     .  .. .     .  ..      . . .  .      .             ..  .           .  ... . . ... .. ..         .      .
..     .      .       ..   ..      .       .        . . .      ..  .     .  .  .  .     .          .   .   . .  .            . .. .  .
.     ...      .    .           ... ..         .. .. ..      .         .   .      .  .  .  .         ..      .....   . ...      .  . .
. . .  .            .      .  .   . .     .. .  ..     ..   .       . ..       .  . . . ..  .  . .. . ..   . .  .   ..  ..  .  . .....
.                     .     .    .   .  ... .        .        .       .  .  . ...  .  .     .. .            .  . ..      .   .     . .
.     .   . .  .    . .. .     .   . . ... .        .      .   .   .        . .      . ....   ..    ...        . .             .     .
. . . .  .   . .     . .   ..  . . . . . .        .        .   .             .  .. .   .    .    .    .. . .      ..     . . . .  .  .
..   ...       .   ..  .. .       ..   .    . . .        . .    .. .  . ..   . .  ..        .     .            .       . . . .  ..   .
.    ..        .. .   .  .  . . .. .   .   .  . .  .     .           ..  .       .        .   .... ...    ......   ..  .  .  ...  .  .
.  ...       ..  ..      .    . . .  . .  ...           .     . .  . . ..    .    .   .    . ..    ....   ..    . . .. .     . .     .
..  .   ..    . ...            .   .  .  .  . .   .         .. .   .  .       ..       ..  .   .    .     .           .         .  ...
.    .  . .     .. .   . . ...   . ..          .      ..   .   ...  . .. .. ...    .      .  ..   .  .  .    . .. . .   .     .      .
.. ..  .    .   .  .   .  . .            .  ... .     .   .           .  .. .     .   .. ..     .  . . .      . . ....  .        .  ..
. . .   ..    . .  . .            ..  ..  . .    ..  .  ..           ...  .  .      .. .     .     . ..    ..       . ..   ..      . .
.  . .   . .      .     .   . .  .                  ..    .. .   ...   .   .   ... .  ..      .   . .       ..    .  .      .  .  .. .
.              ...   .   . .          ....  .     ..    . .. .    .     .. . .       .    .     .. . .   .   .   .   . . ..        . .
.     . ..     ..   . . ... ..  ....      .    .  .  .  . .... . . . .  .              . . .. ..      . .   ..  .. .. ..   .  .. .   .
.. ..  ..   ..     ...        ...      . .    ... .        .. ..   .         ..         ..  .. .. .  .      . .  .   . . . .. .  .   .
.  .        .        ...  . .     .   ..     .  ..     .      . .      .  ..     .   .     .. .  . . .X    .   ..    .   . ..      ...
.    ....  . .  .           . .  . . .   .   .. .        .       . . .. ...   ....    .  . .      . .   .. .     .  .    .   .  . .  .
.   ....  .   . ..  .   .  ...  .. ...    .   .. .         . .   .  .    ..  .   .  ..                 ..     .    ..             .  .
.         .           .  .    . .   .  .    .    . .   .  ...       .    . ..   . .. . .  . .   . .   .  .     .  ..  .. .    .   . ..
. .  ..     .    .  .             .     ..  .    . .. . . ..  .   . . .        .          ... .    . ...     .  ...   .   ..   . . ...
.     .   .     .   . .   .      ..   .       .    .  .   . .    .     . .   .  .  .   .  .    .. .    .    ..  ..  ....     . .     .
.  . .      . .  ..     ... . .. ..     ..  . .         .   . ..     .  .   .   .      .. .   .         .         .   .    .   .   . .
.       .    .    .. .  .       .  .   ...  . .   .    .  . .   .    .. .  .  .         .   .  . . .. . .. .   .           . . ..   ..
..     .   .  .  .. .   .    . .   .   .   . ..         . .    .  .  ..                .. .      . .   .  .   .             .. .  . ..
. .               .      .  .. . .  ..     .    .     .      . .. . .   . ..  .. . ...    ..       .    ... .     .        .  ....   .
. .  ...    .. . . .  .      .  .   .    . . .   . .   .      .                ...       .   .  .. ..   ..   .    .   .  .  ..       .
...   ...             .     .. .  .               .    .   . . .    . .       .    . .  .    .      . .        ....    .  . .   . .  .
.        .  .  ... .        ..  ..         .... .      . .       .   .    ..  . ..  .    . .             .         .     ..  .   . . .
. .       .     .  .       .    .  .   . .... ..  .      . .         .  ... .  . .   ....   . .. .. .  . .                .        ...
.    ..    ..   . . ...         . ..           ..   . .    .  .  .  .   .     . .  .  .  . . .   .... ..  .. . .      .     .   .    .
......................................................................................................................................
