.......................................................................................................................................
.    . ..      ..  .     .          .  .   .   .. . .  .. .     .. .    ...   ...    . .    .. . .      .  . .  ..      ..       ...  .
...   .. . . ...  .         .   . ....      ....  ..    . .  ..    . .      .  .. .. .   ..   .  . .   . ....    ..   .. .  .        ..
.  .  . .  . .  .. .   .      ...    ..        .    ...    .   .  ....   ..  ..     .  .. ...    .     . .      .  .  ... . ..     ....
.. ..        . ....  .. .. .    .         .  .. .   .  ...   ..   . .  .  ..  .  ..  ... .          .   ..       ..   .   .... .      .
... . ... .    .. .   ...  . .. .. .       .. .  .   .   .   .. .    .    .  . .    .   ..   .     .. .        .           .    . .. ..
..     .   .      .    .       .      . .   ....    .   .   . .        .. .     .  .     .  ..  .     .. .    .. .     .       .      .
... . .         ..   ... . .       ..  .  .. .   .       .    .    . .     .  .. .  ...  ..  .   .. .. ..     .       .. ..    . .  . .
.    ..   .    . ... .     ..   ..    . .. .             . .     .  .         ..    .  . . . .    .   .       ....  ..      ..       ..
.     . .......    .. .  . .  .  .  ..   ..    . .  ..     .      .    .   .    .   ..  ...   .   . ..      .  .  ..   .      ... ..  .
.      .           .  ...    . ...   .        ..      .  ... .  .    .   ..   . ..           .. .   . . .  .. . ....    .. .. .      ..
..    ...  ... ..    ....      . .    .       ..      .  . .  . .. ..   .    .  ..        .       .     ..   .    . . . ...       . . .
..  .       . . .   .    ..       ....    .  . . . . ..  ... .              .  .  . .   .    .. .         ... .    ..         .       .
.      .           ..      .         .  . .    .  ...      .     .            . . .     .    . .. ....    . .           ....  .   . . .
..     .  . .   .     . . .  .    ....  .   . .         .  . ...  .               . . .    ..   .     .      .    ..   . .     .      .
.  ..       .    ...    .   .... .  ..   ..  .  .  ...       .  ..       .       .  .      . . . ...     .      .       . .     . . . .
.  ..  .. .        .   . .    .....   .       .   ..  .  .  .    .  ..   . .       ..         .       . .  .  .       ... .   .  .  ...
.. .  ....       .       ....    .. . ..           . ..    . . ..  .     .   ..   .  .    . .    .  .  .   .   ..  .  .     .       . .
.    ..  . .   . ..       . . ..       . ..  . .  ..      . . .  .  ..  .... ....     .         .                     .    ..   . .. ..
.     .   .  .  .  .  ... ...     ..     .   . . .              .     ..   . .  .       .. ..    .       .    ..     .     .  .    ....
. .     . ..  .     .       .     .  ..   ..  . ... ..        .   ..   ..  .             .       . . .  . .         .  . .      . . ...
.  . . .   .. ..        .    .      .  . .    . ..   . . ..  . .     .       ..    .    .        .      .  . .    .  .. .  .   .  ... .
.  .    .   .. . .      ..  .         ....    ..  .  .      .    .....       . ..       .    .       .    .. .    .              .    .
.         .    .  ...  .    .         .   . ..  .   .       ..         .    .  .     . .      . .  .. .  ..     .   .  . . .. .  . . ..
..    ..     .   .    .. .   ..   .. . .         .     . . ..  ... .   .     .       .  .....  .           ...      ..     .   .     ..
..   .        .  ..              ..       . .. .   ...     .  .   .      ..  . .     .  .     ..     .  . .. .  .     .            .. .
..     .. .    .....    .    .  . . .  .      .     .        .   .    ..    . .      ..  .   .. .      .     .   . .. .   .     .     .
.      . .    .     .    ..   . .. .   .        ..    ..   ...     .        . .     . . .. . . .     .    .    .    ..      ..    .....
. .  . ..   . .   . .     .  .   ... .  .       .        ..    ...    . ...      ...      .  ..   .  . . . . ..        ...  . ...   ...
.      ... .    .     .      . ..  .  . ... .     ..  . . .   .   .  .  .   .      . ..    .  .                     .         . ..   ..
.       .  .....      ..   .    ..   .   ..   ..    .    ... ..  .     .      .        . .  . .  . . ..    ..   . ..   . .    . .  .  .
.  .  .    .         . .    . .    . .. . . .         .   ..     . .. .      .  .      .                 .      .       ...   ...     .
.   ..    . . ..    .      . . ..   .    ...    .    .    . .  .        . ...    .      .   . .. . . .     .      .         .         .
.    .   .  .      .  ..    .... ..  .   .  ..    .  .     . . .  .  ...  . ...   .   .    .  .              .  .  ..     .   .  . . ..
... ..  .   . .        ...    .  ..   ..          .   . ..    .. ..  ..  ...   ..  .       ..        .  .    .  ..      .  ...   .  . .
.     .. ..     .             . ..   .          . .      .      . ..  .    .. ..    . . .   ..  ....         . .      .  ..  .    ..  .
.    .  .   .       .       .    ..  .      . .  .  ... ...   ..      .  ...     .   . .    .        .  ..    ..    .         . .     .
. . .  .   . .   .. .   .. ..  .   .    .. . .           .   .. . .      .   .. .    .  .  .  .       .     .  . ..   . .          .  .
..      .     .   .    ..  . . .  .     .   ..    ..    .   .     .  ..   .            .  . . .. .  .  . .   .   .    .   .   . .     .
.   ..   .       . ..   .            .. .. ..     ..  .    . .   .     . .. .   ... .  .   .      .        . .     .. ..   . .        .
.   ..  .            ..   .  .   . .   .   . .        ..  .   .. ..  .  ..         ..    ..  .  .      . . .   . .     .     ..    .. .
.  .. .    .  ..   .. . . .     .  .    .  .    .  .  ... .  .  .   .         .       . .  .     .  .        ....  . .. .... .   .  . .
.    ..   . .     . ....  .  .   . .  .       ... ..  ..         .   ..  . . ..  . .  .  ....           .       .... ..  ..           .
. .. .   ..  . ....   . .  . ..    .. .. .   . ..    . . . .     .         .    .     .     .. . . .     . . .  ..        .       . ...
.   .        .  ..   .    ..    ..     . . ...  . .... . .       .      .    . ..    .. .        . . .      .     . . ...           . .
. .  ..     .    ....   ...         . ..  . .  . .  ..   .. .  ..  .  .     . . . .... .    .... ...   ...      . . .     .       ... .
. ....  . .       .   .    .     . .     ... .. ...     .     ..      .    .                .      .. . .. ..   .   .  . ..   .       .
. ..    ..     ..   ..  ..   . ..   .  ..      .   .    .    .   .  . .       . .     .    . .  .      . ..      .  ..     .       .  .
. ....  . ...     . .     .   .  ..   .     . .  .          .   . .  .  . .   .    .    .   .   . ..  .    .  . ..    ... ..  .  . .  .
.     . .. .   .   ...      . . .     .          .     .    ...      .    .     .   .      ...  . .     .           .  .   .          .
.       .  ... ..     .         . .      .   .      ......  .  ..     .        . . .   . .   .. ... ..        .   . ..   .     ... .  .
..         . . .  . ..                     ... .    .    .     ..           .      ...  ..  .    .      .       .      .  . .  .  . . .
.  .  .  .. .        ..         .  ..     .  ..   .    .  .   .   .  .       .  ..    ...   .     ..   .   .   ....  .. .  .  ..... . .
.. .  .     ..       .    . ..   .  .       .       .. .   .  .     .. .    ..     .    .  .     . ..   .           .. . .  ..    . ...
.... .   . .    .  . ..       .  .   . ..    .. .    ...  .  ..  ..   .  . ..        ..   .  ... .                .  .    .  .      ...
.           .    ..          ..   .   .   . . ... .      ..    .   .  .        .  ..     . .     .      ..  .   . .     .   .   .     .
.         ..   .  .    .   .. .      . .  .    .  .      ..   . .   .    .     .     . ..     ..         .. ..  . ..    .         .   .
..   .   ....    .         .     .  .    ..  .     .    .....  .  . . . .     .   .       ... .   .  ..            .       .. .  ..  ..
.   ..       ..          .   .   . .. . . .. .. .... . .  .    .  .  ...      ..       .   .  . .  .         .    .     .   . . . .   .
. .. .            .      .     . .              ..  .     .    .  .          ..  ..    .       .  .       .     .....       .   . .   .
.      ....   ... ...    .  ...       .    .     .  ...     . .  ...   .  .      .      . .     .. .        .  .   .     ..   .    .. .
..  . .            .   ..   .  .  .   .. .    ..   .... . . . . ..  .   .  . .     .    .    . .        . .  .     .       .         ..
...    .                   .   . ..  .    .. ... .     .  ...    .    ..      . .  .    ..       .    . ..     . .  ...     . .  .. . .
. .   .  .        .      .  .       ..  . .      .. .        .  .        .... . . .       .   .               ... . . .  . .  .. ...  .
.   .      ..    ... .   .  . ..  .   .     .   .         . .  ...  ..  .     ..   . ....  . .   .    .       . ..  . .  ..   ..     ..
.           .    .     .    . .  .      .            . .    .  .      .  .  .     .   .   .  ...    ..  .     ..  .       .   .   .  ..
.   . ...         .... .. . . .     .   ..  .    .  .    .. . .     .  .. . . .    ..           .   ..  .    . . ..  .      ..   . ....
. . .     .  .  .           .      .   .   .    .. .   .  . .  .  .   . .       .. .    ....  ..   . .     ..   . ..  . .     .     . .
.  . ...   . .       . .            .  .    .      .  ..      .   ..   .      .   .  .  ..      . . ...  . .   ..  .   .. .    . ..   .
...  . .  .. . ..  ..       .         ..        .  ...  . . .   .   . .       . ...    .         .    .. .  .... ....  .     ...     ..
..      . .   ...      .        ..     . .       . .  .  ..  .  . .  . .   . . .           ..          ..   .        . .   ...   .  ...
.   . ..        ..  . .  .    .  .      . .  .    .  .  .  .   .   .  .. .                  . .  .  . ..      .    .  ..    .   .     .
.. . .. . . ... .. ..     . .    .  .  .   . ...  .       .  .   .   .  .  . . . . ..   .   . .   .      .. .  .          ..  ..   .  .
.      ..  ..   . ....      .    .   .    . ...          . ...   .. .    .  .     ...  .     ..     .          .  . .   .  . ..    .  .
.  .       .. .. .  .   ..    . ..     . .  .   .     ...    . .  . .  . .  .       . ..   ..    ..   .    .        .... . .  ...  . ..
.     ..   .  .    .     ..  .   . .         ....   .              .  .  .. .  . .      . .     ..    .  .....      .  .. ...   . ... .
... .    . ...    ..    .. . . .  ..          . .....   . .   .          ..   .   .    .. .  ....... .       .   .      ..    .  .    .
.  .. .. .  .    .            . ..  .    . ..   . .          ..    . .    .            ..            . .....          ..   .        . .
..                     .            ...             .  ..  . .. .       .   ..     ...   .  ..   .     ...  .. . .   .  .  ...      . .
. . . . ... .. . .  ...     .    .   .     . .  .        .         .    . ....      ... . .     . .     . .  . .       ..  ..  ..  .. .
..      .. .       ...      . .   . . .     ..     ..   .    .. .. .     .. .      . .. . .   r  .       . ...    .   .  ... . .   .  .
..  ...  ..  ...  ...    .    ..    . ..     .          . .   .  .    .   ...         .. ..      ..  .... .  .  ..    .    ..  ..     .
. .  .    .     .. . . ..  .    ..   ..   .  .         .   ....       . .       .     ..         .   ..     .   ...  .  . ... .. ..   .
.       .     ..  .        . .  .    .    . . . ..   .    .         . . .    .     . .... . .  .    ..   . ..   .     ...   .    ..  ..
.     .  .     ..         .. . . .  .. ..   .    ....  .... . .    .   ... ..         ..        ... ..     .   .  . .     .    .   . ..
. .. .  .   . .         ...       .    ...  .     . .       .  .   .   .      . .    ..       ..  .. .      .      .      . .    .   ..
.     .    ..   ...    .      .... ..  ..         ..  ..      ..      .   ..             . ...  . .  ..   .         ..   .        ..  .
.  .. . ..  ..  .            ..      ..       .   .         .. .    .          .. . ..   ..     . ...   ..  .     .        .    .. .  .
.     .     . .  .           .   ...   .    .   ...  . .      ...         .. . ..     .     .   .    .   .    .     .    .  ..        .
.      .       .  .     ... .   ..  .    .  .   . .               .   ...  ..  .          ... .  . .  .        .  .. .   .  . ...  . ..
....    .  .. .. . .... . . .     ..   ..    ...   . .          . .   .        ..   . . ...   .    ..      .. .  .. .   .   ...       .
.  .      .      .       ... ...   ..  ...  ..  .  .    ...  .          .             . .    ..    .  ..   .        .      .. .       .
..    .  .  .    ... .     . .     .. .     .       ..    . .  .  .    .  .  .    .  ..   .     ... ..       . .     .  .  ..  .      .
..           . .   .      . .. .. . . ..       .             .     .   ..     . .. .  .   .    . . .     . .. . .  ..    .   .     .  .
. . .    .. .     ..    . . .      ..    . .    . .  .     ....   . . ..     ..    . . ...      .       .     .   . .    . .          .
.   ..   .     .   . .  . . .  ...  .  ..   .   .  .  .  .... . .     .           . .     ..  ..  ...   ..   . . .  .... .       . ....
. . .....       .. .  .   ....   .   .  .   ..    .       .  .      ..     .  ..                 ..   .  .     .    . . ... ...  . . ..
.  ... ..   .     ..  .  .      ..  .   . ..         .          .            . ..     .  .    .              ..    . .. .  ..  .   .. .
.     ....   . .     .   .... ..     . .    .  ..  ..     .     . . .... ..          .. . .  . ..           . .. .      . . .   ....  .
..        .  .    .             .    .    .      ..  .   ..      ...   .   .. . .   .  .  .. . ..  .       .....  .   .   . .   .   . .
. .  ..      . .  . . ..........      .      ..    . ..   ...    ..   .  .   . .       .   . .       ..    .. . . .    .   .  .  .  ...
...     .  . .          ...   . ..       .        . .         .. .      .     .. . .               ...  ..   .    ...              ....
. .     .      . . .. . .   .  .       . .  . ....    .           ..  .               ...     .  ...       .   ..     .. ...        . .
.. ..   .  .  . ..   .   . .  .     .      .    .   .      ..   .       . .  .       .              . ...            . . .  .    .    .
.  ..   ....   . . . ..      .. .    .         ..    .  ..           ..  .  . .  .. . .. ..    .    .. . ...  .  ..  .  . ..  .   ..  .
.  .   . .  .  ..  ..   ..   .   . .    .. ..    . ... . .   .     .     . .     . ..         ..      . .         .  . ..     .   .   .
.... .   .       .    . .  ..   .     ..     ..  .   . ..     .              ...         .. .     .   ..        .  ...                .
.. .     ..   .. .       .   .  ..   .       .  .      ..    .    .. .    .   .    .   . .   .    .  .. .         .   ...            ..
.   ..   .   . .             . ..           ..    .   . ..      . .     .       .     . . . . ..    .   . . . .   .          .  . . . .
.  .  . .  . .   ..   ..  .              .   .  .          .. ..   .    .    .   . ..        .    ..    . .    . . . ..  .  ..    .  ..
.. .  .           .      . .   .. . ..    . . .  . .       ...       .  ..    .   ... . .          .   .  .. .... .            .   .  .
.   ..... .            .    . .    .     .   .  .   .                      .   . .      ...    . .            .      . ..    ...  ... .
.. .. .... .   . . .   ..  .       ...    ..      . .  . .  .   .  .  .  ...     .. .  .    .. .   .   .   . . .....         .    ..  .
.   ....  ..  .. .  .... .  ...      .     .      . .    .   . . .      ..  .       ..  . ..      . ..   . ..      ... ..   . ..   .  .
. ..    .   .   ..X  .  . .  ..  .  . .   . ..   .  .     .  .  ..   . ..    .   . .. .          .  .. .. .  ..     ..     ..  .      .
.     .        . . ..        ..         .  ..    . .  . .   . ..  . . .   . .  ... .    . . ..    ..     .    ..        .   .   ..   ..
. . .     ..  ..  .  . ... .     . . .  ..   ..          .     .  . .     .       . ..   ...  . . . ..  ..   .   .  .. .  ..   .     ..
..            ...   .   .       .   . .    .   ...... .. .  . .   .. . .       .   ..      ... ...   .. . .     .    .     .      ..  .
.. ... .   .. .. .        . .. . .     ...  .    .   .  .  . .    . . .. .. .    ..  .  .            .   ..   .          .   .  .     .
. . .  . . ...   . .  .    .    .     .. ...   .  .  .   .   .  . . .  .  .. .       . . .   . ....      .   .    .   .  .  ...    .  .
.. .    ..  .    .. . . ..    . .   .  .         ..    ...  ..           ..   ...  .  .            .   . .  ..       .              . .
..     .           .   ....         .     .   . .. .  ..   .  .  ...           .. .           .   . ..     .. .     .       ...     . .
.. ..      .    .      .  .              . ..    ..   .     .. .    ...  .  . .  .   .         .  .   . .   .  .. ....    .     .. . ..
..   ...    ..    .  .                 ..   .     .. .. .. .  .      ..    .    .  .           .        .           .               ...
. .. . .   .     .   .     .  .   .        ...         ..     ....  .  . .      .. .      . .     .. . .   .     .. .     . .   .  ....
. ..  .  .   . ..            .    .. .     .. .      ..      .. .   . . .  .   .. ...       .. ..     . .. .    . ..    .       .  .  .
. .      .   . .  .     .  . . .     ..    . ...  .      .  .  .  .       .   . .  .  .  .. .  .. ..   .   ...  ....     ..... .      .
.         . . . .   .   .  . . ..   . .       ..   ...  .   .  ... .. .  . ... ...     . ..      ....   .        .  .... .   . .      .
..     .    .. .   .....    . . . . . .   ....      .     .  .    .... ..      .. .       . .   . ... .                .   . .  .   ...
.          .     .   ... .  ..   .  . ..  .. .  .    ..   .  .       .   .  ..     .      .  .  .   . .   ..   . .   .           .    .
.  .  . ... . .   ..        ...       ...            .  .  ...              .   .       .    .    .   . ..         . .     ..  ..   ...
. .     .       .   .  ...  .  .. .   .      .  ..  ..    ..     .  .     .. .                 .. .  .    .     .          .  .       .
.       . . . .. .        .   . .  ..        .    ..   .. .   .   . ..    .  . ...  .  . . ..      .... . .         .. .   .  .     . .
. ..    .  .         ..   .  . . ...         .   . . .    ..  .          .     .. ....   .  .   ..    .  ....   . .   .          . . ..
.......................................................................................................................................
