........................................................................................................................................
.  . .           . .       .  .       .   .  . .        .   . ..  . . ....       .  . ..     .... ..    . .     . .  ..     .          .
.          .  . .    . ...  ..  .. .   .    .     . ... . ....  .         . .. ..    .       . .       . .  .  .       ..       .    ...
. ..       .         .  ..       .   ..    .      .      .   .. .  .   .     ..   . ..     . .. .   .   .      ..... .    .. .   ..    .
..  .  . ..  .   ..  ...   ..     .        . .  ....     . .   ..    .     .  .    ...  ..    .   . .     .   . .   . ..          .. . .
..   .           . ..      ..   . .   .     .  .     ..      .     .   .  .      .. . .... .    ..   .    .  ..      .    . ..    ..   .
.      .  .            .. ...    .         . .   . .         . .    ...          .   .. .  .           .    .          .   . . .   ..  .
..     . ..      . . ..        ...  ..  .    . .    .  .     . . ..        .  .. .. .. ..  .   .            .     . ..      ...       ..
.   .   . .   .   .    .              .                . . .. .. .   .  .  .. .    . . . .  .  .    . .  . . ....   . .   .  .. .    . .
.. .    .    .     .   .     . ...  .. .... .   . . .     .        . ..         .... .     . ..   . ..    .  .   .. ..  ..  .  ..  .  ..
. .. .     . ..       .     . ..   . . . . ..  .  ..  ..  ..  ...        ... . ..    .       .    .  .       .  .  .     .   ..        .
. .  .  ..   .      .. .  . .          .    ..  . .   ..    . .   .  . .  ..   ..       ..  .  .      .  . . .    .    ..   . .   ..   .
.       .   . ..     ..  .   .  .  ... .     .  ....        .   . .    ..        ...              .  . ... .      .     ...  .    .   ..
..    . .      .            .   .    ..        ..  .  .   .     . .    .       .    . . .     .    . .     .         . .  .  .   .  .  .
.   ..    .  .    ..  .  .    .     . .   .    .   ..   .   ..   .     . .   ..        . .  . .. .  .  ..  . .  .       .  .  ..       .
. .      . .   .  .       .   .     . .      .     . ..  ....     . . .....  . ..    ..  .   .  .           . .      .. ..   . ..  .   .
.   .  .  . ..  .  . .  .. .         ...  . .  .. . . ..  .  . .        . . .  .     .  ... .    .  .   ..       ..  . .  . .   .      .
.   ....  .  .  .  . .  ... . .    .   .  . .  .  . .    .   .  .      .     .   ...   .   .  .    . ..          .      ..      . .    .
.    ..           ..     ..   .   .    ..         .      .       .      .   . ...  . ..   .     .  ..   .      .              . .   .  .
. ..... ....      . .    .             . .       .        . .   .     .    . .   .      .  ...      ... .  ..   .  ..      .   .  .    .
.   . .   .  . . .       . .. .....  ..     .    .   .     .      . .  .    ..    . . . . . ....   . . . .    .    .    ...       .  ...
..     .   .       ..     . .   . ...  . .      . . ..      .  .      .  . .       . .    .. ..... .    ..            ..  .   .  . .. ..
..   . .       .   .    .  .                .   ..  .  ....      . .  .     .   ..   .      .  . .   .                   ......      . .
.   ..   . ..  .   .   .  .    . .     . .   .      .  .         .    ..  .  .  .  .  . ..        .   ..   ..   ... .... .. .    .  . ..
.            .  .    ..  ... .           . .    . ...  .       ..           ..     .         .   .         ..   . .  .    . ..   .   . .
.   . .   .. .   .  .         .         . .     .   .  .      .  ..    .   .      .. .. . . . .. . . ..    .... .      .      ..  .   ..
. ..  .        . ... .     .     .. . .  . .          .             .   ...      .   . . .      .  .   . .   .           ..   . . .   ..
. ..  ..  . . .  .. . . . .       .     ..   .       .          ...   .    ..    .. .  ...  .   ..    . . . .     .     . . ..    .  . .
.    . . ..  ..  .     .   . .  ..      ...  .   ..    . .    . .. . . .    . . ...  .  .   .  .   .   ..       ..  .  .  .  . .  .  ...
. . . .     . . .   . ..    ..     .. ..           .     .   . .. . .      .  . .      ..   .     .      ..    .   ..    .  .    .   . .
.         . .   . ..... ...  ..  . .       . .  ..  . .          . . ...   .. .     . ...    .       .   .    .  ..         .. ....    .
.  . .      .  ...    .    .   .   .         ..     . ..  . . .   .. .   .  . .  .    .       .    ... ...  ...  .  . .   .     .  ..  .
. .          .      .  .. .     .. .      .   .     ..  ..           .  .  .    .        .     .  . .         ..  ..   .     ..  .    ..
.                .    . .          . ..   .  . . .   . ..      ..                ..     .  . .. .   ..   ..  ..  .    . ..  .    . . . .
. .       .    .  .. .   ..        .. .            .    ...   .      . .      .     .          .. . .    ..  ..     .   .....  ..     ..
.     .  .        ..    . ...   ..    ..     . .                 .  ...  .  ..  ..  .      .   ...   .  .  . ..   ..  .      .     .   .
. ..     ...  . .  ... . ..  .   ..      .     .. ..    .     ..     ..     .           .  .            .   ...     ... .  .   .  .    .
.     .   .    .  .        .   .. .   .  . .... .  .          ..   . ..  ..... . .... .  . .   ..  . .    .          ..         .  .  ..
.       .. ..  ..... ... . ..  . . . .  .  ... .  . .   . .     ..  .. .. .             .            ..    .   .   .  .  . .  .. .     .
.  . .  .     .    ..    ..   ..               .. . .  ..      . .. .        .  . .               ....  . ..     .. ..           . . . .
.    . . . ..   .  .. .....       .    .  .    .  .  .  ..  ..     . ..  .. . .        .  .  . . . .     .    ..   .       .  .  .   ...
..     .    .   . ...    .   .        .       ..  .     .                .. .  .. .. .  ..  ..  .   .          .   .      .    ..   .  .
.  .     .  .    .. ..   .  .  .   .  .      . ...   . .   ...     . . .     .  .   . ..    .      .             .     .  ..       . . .
..    .       .     .         ..         .           . .  .       ..         .    .  .  .  .          .. .   .   .  .. .              ..
. .     .          .    .. .     .  .   ..     ..         .. . . .  . ..   ..     ..  .    .   ... .     .          ...   . ..         .
.  . .       . . .   ..  .    ..    ...     .          .. . .   .. . .    .       .  .     ..   . .. ..  .     .  .. .. ...           ..
..   .  .  ..  .  ..  . ..     . ...   . .   .   .   .    .   ...   . .. .    .    . ...    .       .    ..        .. .. .   .     ... .
.  .       .      .    .   . . .  .  ..    .              .  . ..           .  . .  .   .     ..   . ..  .       ..    .  ..  . . ..   .
..        .. .   .. .   . .  .   .    .         .      ....  . ..... .    .       .       .   .  . .     .. ..... .... .     .     . . .
. .      .         ....        ..    .  .  .    .  . . ..  . ..    .   .   ..  ...    .. . .  .    . ..    .   .   ..    ..            .
..      ..  ..   .  ..      . .   .         .  .        .   ..   ..                . .    .   . ..    .  .     .    ..   .   . .....   .
...   .  .. ..          .  .   ..      .  .      .  .     .        ..  . . .   ... .   . . .    .     . .         .  .   . .       ..  .
.     .  . .    ..  .      ...         .   .   ..    ..   .    .    ....    ..      . .           .... .      .    .    ..... .     . ..
.    .             ... .   . .    . . .   . .    ..       ..  ..  ..  .    .  .....       .   ... . .  .  .      ..     .... . .    .  .
.   ...      . .                  .  . . .   .  .  .   . .         .         .    ..  .  .      . .       . ..       .. .              .
.     ..  . . .. .  . ..    ... .     .  . .  .     .  .  .    . .      .  .      . ..         ..   .   .  .  .... ...   ... .     .....
. .  . ......  .  .. ... .           . . . ..  .      .    . .       .. ..   .      .  ..  .    . .     ..         .          .  . . ...
. ..   ..   .  . .   .  .... ....   . . .          . .   .  .. . ..  ... . .       .       ..   .   . .     .   .       ... .   .  .   .
.... .    ..    .      .   .....     . .   . .  .               .  ..    .        .    .       .  .             .        .     .. .    .
.  ..  .     .    .     ..  .      ..          .        .. .    .. ... ...    ..  .     ..  . . ..     .    .  .   . .  ..  .. .    ....
.   . .. ..  ..       .   .    .  .    ..    .          .     .  .  .   .     ..... .   ..  . ....  .   ..  .   .  .. .  .  .  .    ....
...      . .  .. .  .. ..    .       . ..   . .   ..   ..  .  .    ...         . .  .         . ..  .     ... .    .              . .  .
. ..     . ..   ..  .    ..    ..   ..   .    . .       .   . . .       . ..     ..       .     ..     . ..     .  .          . .   .  .
..     . ..    . .  ...   .    .. .        .        . .        ..  .    .    .  .  . .  .  .      .            .        .  . ...  ..   .
. .      .      . . .. . . ..  .    . ..  .        .   .  . . .  . ..          . ..     .  .       .. . .        . .     . . . . .     .
.         ..  . .....      .   ...     .   .  . ... ..   .    .. .  .  . .      . . .   .      . .  .... .  ...  ..   .     .  ..  .. ..
.   .   .   . .       .  ..    ..      .  . .. .   . .    ..      .     .    . . .   .. . .  .       .  . .         .     . ...        .
..  .     .    . . ..  .         .  .        .. ... .   ... .....  .... . ... . .         .    .  .    .   .  ..    .....         . .  .
.     .   . .  .        . .    .     .  .  .   .  .  .      .  . ..    .  .   .   .    . . . .   .. .         .   .. ... . . . .       .
. .  .          .   ....      . . .  ..     . .  ..     ..   . .       .   . . .  ..     . .   ..    .  . .   .. ..     .   ..   .  .  .
...  .  ..      ..  .      ...    .  .   ...  .  .. .  ...     .  .   ...   . .      ..  .  . . .  .       .  .   ....          .   ....
.   .  .        .    . .   ... .......  .       . .  ...    ...     .  .    ..  .  .     .. ..  ..   .  . . . ..      . ..     . .     .
..  .. .     ..          .. ..  . ..     .      . . . .   . .   .       ..    ..   . . . .   . . .      .    . .         .             .
.    . ..   . .       .  .. ..  ..  .    .  .     .     .. .   . ...   .     . .      .     .  . . .         . .  . ..      .. .      ..
...   ..       ..     .  .  .          . .       . .  .....  .   ...      .    ...   .   .     .  .  ..    .     .      ...            .
.  .   .  .     .     ..    ..  ..   .          . ... ..  .    ..  .             .  . .  ...   . .. .. .  . .    .    .. ...   . .     .
..  .     . . .      . .. . ... .   ...  .      .. .        . .....   ...          .     . . .  .  .  .  ..  .           ..    .   .  ..
. .    ..  .  ..     .  . .      .   ..       . .    .          .   .     ..      . .. . .. . ..   . .  .     ..  .    . ..    .      ..
.   ..... ..    ..  . ..     ..  . . .   . ..       ... .   .   .    . .       .. .      ...      ..         . ..    . .. .  .. .    . .
..  .   .     .  .         .                .  . ..     .  ... . .  .. .            .   .     ... .  .. ..    . ...  .       .         .
..     . .      . ..  .   .. X . .  .   ..    .   ..    .     . .   . . ..      .   .     ....         . ..                   ..     . .
.     .      .  .     .    .       .   .    .    ..  .  . .. . .     . .  .  . ..  ..    ..  ... . .        ..   .   ..   ..  . .  .. ..
.. .      .  .  .  .  . .   .. ..   .  ...   ...  ..     . .     ..    . .  .  ..  .    ... .     .      .   .   .  ..        .  .   ...
. ..  .. .      . .    .  .   ..  ..r . .    .   .    .      .  .  ..    ..       . ..     ..   ... . ..    . . .. .   ...          .. .
.. .   .....  .    .  ..   .    .       .      . . .   .  ..    .    .  ..     .  .    .. .  . .   . .             .. .  . .           .
..      . .. . ..  .  .....    ..... . .   .    .      . .            .  .        .         .    .     .    . .       ..... .  .    . ..
.            ...        .  .   .  .    ..    .     . .          .  .  .        . .  ....       ..       .       . .   ..         .     .
. . ..  ...   .   .  .         .     . .   ... .     .... . ..  .  .. .   ..   .      .. .           .   .  . ..     .. ..    .  .    ..
.    .   .  . .... .   .      .   .  .  ..   .. . ..   .  .. .     .   .  .   . . ..  .. .         .. .. . ..  .         ...  ... .    .
.    .    .  . .. .         ...         . . .  . . .    . .  . ... .    .  . ....   .         .  .         ...     .     .   .. .      .
.   .        .   . ..  .  ... ...   .    .      ..    ..   . .   . .   .          ..     .        .  . ..         ..        . ..   .....
.  .  .     .      . ..         .     .   .. . .  .     .     .   ..  .    .   . .... . .. . .   ..      .      .      . .  . .     .  .
. .  .  ..     .   .....    .    .  .. ..  .   .. .    . .     .  .  .     ..... .  ..     .  ..  .       .         ..    .            .
. .      .   .     .        .  ....  .  .     .... . .  . . .. .   .. .   .  .  .  .   .  .    . . .      . .       .....      .  ..  ..
..   .    . .   .    ... . ..     ..   ..   .       .       .    .     .   ....... . .           .    ..  .. .  .    .            .  . .
. .  .     . .. ..   . ..   .    .  .  .       . .   .....  ...  ...  . . .   .  .     . .        .  .    .      .  ....           .  ..
.                .    ..       .    . . .    .  . ..               .    .  .  .    . ...       ... .   ...      .       .      ....    .
.  .             .   .  .  .    ..   . ... .    ...   .           .    . .       .      . .. .           .    ..     ..  ....        . .
.  . .    .. ..    .   . .  .. .    ....    .    .   . ..   ...    .            ..  .           .   .  ..    .    .   ..   .     . . . .
. .       .     .      .       .     .....    .   .       ....      ..    .       ...   ..           . .           .    ..    ... .  . .
.       ..  ..   .  ....  .. .   .          .     .   ..   .. . .   .    .  ..    . ..   .  .     .. .       .    .      ....     . .  .
. . . .    ..     .   ..  .  .     . ..  .... .   . . ....  .   . ...     ..   .    ..  . ..    .  .. .   .  .   ..  .           .   . .
.     ...    ..       . . . .    ..           .         .. .  .     . . ..    . .         .       .. ..  .  . ...   . ..  . .       .  .
.   . .  ...  .  . ....  .      .   ..  .. ..  .      ... .      .. ..   ..   .        ...    . .       . . . .   .    . .     ...   . .
. .   .   .  .    ..      .              . .   .. ..         . .  .  ..    .  ..     .   ..    . . . ...    .. . .     .     ....    ...
.      .   . .    .     ... ..   .       .       . . ...  .        . .      ..  ... .     . .  .  .     ... .    ..       .  . .   . . .
. ...  .   .       ..       .  ..         .  .       .       .          . .     .  .  .  .             .    .    . ..      .     ..    .
.  . .  . . .    ...  . .     .      .  . . .     . .. . .  ...  ..  .    ..  .    ... ..  .  .   ...   . .  ..   .  ..   .  ...   .   .
..  ...  .   . ..      . ..   ..        . .    . . .    .    . . .             ....   .  ..     ..   .  ..   .     .   ...     . .......
..   .  . ..    .        .       . .   .      . .... . .  ..  .. . ..   .  .           .. .       .  .    .    .  . .   .       . .    .
.. .   .  ..   .  .  . .     .    .   . .    .       . .     .  . .. .  .       .    .  ... .   .  ..  ...    .   .    .   .  .  .. .. .
. .    .   . . ..          .. .  . ..   .  ....       .. .         . . ..   .        .  .   ...       .    . . . . .     ..  .  .    . .
..    .        ..   ..   . .   ..          .     .       ..    .   .      ..  ..       ..    .. ..    . .  . .  ..   .. .. ..        . .
..     .     .  .  .  .  .....   .        .    .... .. .  .   .    . . .     .. ..  .     ...   .   .    .  .   .  .         .      .  .
..       .     .   .  .     ..  . ..     ..     .       . .. .   ..    .  ..  ... .    .  .    .. ..        .         . . ..    .      .
.     .  .   .  . ..    .   ..  .                      . .    .    .. .  .  .    .....  . .  .. . . . .. .     .... ..  ..      . ..  ..
..     .              .  . ..         . . . .. .       . .   .   .  .               .  .      .   . ...... .  . .    . .  .          . .
.     .   . .  ... . .  .  .   .     .  ..   .. . .  . . .  ..  ...    . .  .  . ... .     .   .. .  .    .     .   . ..    . . .      .
..   .     .     .      .  . ..             ..    .    .   .  . . .  .    ..         .  .   ...  ..     . . ...   .  .. . .      ... . .
. .. . ..   .  .  .     ..  .   .  .         .   .   .   .    ....       .     .  .   ...  .  . .  .. ...  ..           .  .  .   .    .
.   .     .  .   ......       .        .   ..    . ..     .        ....      .  .   .  .    .        .   . .         .    .. ..        .
..   . ..  .. ..          .      .    .   ... . . . ..   .. ....   .          ..   . ..   .  .  .   . .  ...  ..    .   . .    .  .  . .
.   .       .. . . . ..   . .   . . . .  .  .   .       .     .  . .    .  .    . .  .. .   ....    .       .   .   .. ..     .  . .   .
.  .  ..           .  .       ..       . . .   ..   .   ..    . . .       ..             ..  ..  .      . ...    ..   . .       ..    ..
.    .  .   . . ..  . .                   ..   .       .  .. . ..   .   .   . .      .               .  . .. . .        . ..  .    .. ..
..     . .   . .   ...  . .   .  .   .   .                    .     . .. . .    ..        .       .   ........     .  . .    .   .  .  .
.  .. ..   . . . .  ... ..           ..   ...  . . .. . .               .  ..  ...  . ..     . .  .. ... . .....  . . .              . .
.    .   .   ..    .   ...   .   .        ..   .    .. .  ...  ...     . . .      .    ...    ...    ... .    .           .  .  .    . .
....  .. .    .. . .         . .     ..        .  ..     .  ... .. ..  .. .      . . .     .      ..         . .       .    ... .      .
. ...    . .      ...      .               . ..   . .      . . .    ...    . .  ..        .   ..    .. .    ....   ...   . .  . . .    .
.         .     .. ..    ..     .     . .       .   .   ..  ..   ...  .    .      . ...   .  . .   .    .     .    .      .. .  . ..  ..
..  .. ..  ..    ...     ... .    . . ..   ..       .  . .     ..   ... . .    ... ....  .    .  . . .  . .......    ...       ..      .
..   .  .   ..   . .        .  . .   ..   .    .      .  .   ..    .     .   .. ..    .       .   . .  .. .     . .   .    .           .
.      ..   .     .         ..  .        .. ..   .  .   .   . .      . . .  .      ..         .     ...  .   .  .. . .   . .   . .  .  .
.  .  .  . .     .   .  . . . . ...      . .  .                 . .. ..      .    . .      .         .  .         .     .    ..... .  ..
........................................................................................................................................
