.........................................................................................................................................
.        .. .    .  .   ..   .  .  ..    .  .                 ...      .     .    .  . .  . .     ..  . .  . . .  .   .    .. .    .    .
. . ..  ...     .      .   . ...  . .    .    ... ..      ..    ...    ..  ..       . .. .. .  .... .  .    . ..     .  .. .   .      . .
.  . .        .   . .    . .   ..      .   .  .    .     .       .      . ... .  ..     . .      . . .   ..  . .      ...    .....  .  ..
... .        .   .  . .   .    .. .... .     ....   . . .    .   ...  .      . . .                . .     . .   ..   ...  .. .  . .     .
.  .. .. .  . .       . .     . .   .. .   .  .   ..    .  . ...      . .     ..     ..   .. ..              .  .     .   .    .     . ..
. . .. . .. .        ..  . .         .   . .  ..     . .  . ....  .    ..      .... .  .    .  ..    . ..     .    ... .. . .. .. . .  ..
.    ...   . .           .      . . . .    .  ... .   . ..  . . ..   .. .     .       . .       .  .   .  .     .  . .. ..        .  . ..
.      .    . ..  .   . .    .     ..    . .   .    .              .   .  .  .    .    . ..  . .. .   .  .   .. ..     .. ..   ..     . .
.. .    .    .. . .    .    .. .    . .    ..        .     .       ...           .   .. . ..   .. .    .   .  ...        ... .  .  ..   .
. ...         . . .   .     . . .    .  .  .   .       .  ... .    ..                 .   ..    .   .  . .   .  . . .   .    .     .    .
.  .. .. .  .     .   ..      ..  .   . .  ...  .     .             ..   ..        . .         .  ..  .  . .  .   . . ..      .      .. .
.  ...  .    ...   .  . ..   .  . .           .      .. .   . . . .   .   .    .         ....  .... ..      .  .  .  ..   .  .     .. . .
.   . ..  .  .     . .. .   .  . .    ... .  ..           ...    ...     .      . . .       . .  .           . ...  .          .        .
.  .. . ..  .  .  .   .     .   ..      .  ...          . . ..    ..   .        . ...      . .    .    ...    .      ..   . ...       . .
. ...   .      ..      .         .  .    ...  . ...  ..    .     .  .. .    . . . ..  .      .   . . . .     .   . .    ..    .    ..   .
.  .. .         .. .....  .   .. .. .. . . .   . .  . .   . .         ..  ..      ..  .         ...   .   ... .   .   .. ..        . .  .
.    . ..   .     .   .    ..    .. ...     .  ..  .                    . .  .    .  .  .  .                      .  ..   . .       ..  .
.      . ..     .         ..  .  .  . .   .      .    ..    .      .  . .  . .    . .   ..  .       .        .   .  .       ..       ....
. .  ..  .   .       . . .       . .      .  .   ..  . .        .  . .       .  . ..            . . .   ..     ..     . .   .     . .   .
.    .   .     .  ..     .   .. .      .    . .               .     .. . .       . ..  .           . .   .       .      .    .      .   .
.            .                         ..   .       .    .   .. ....        . .    . .    . .         ..  .    ..  ....         .  .   ..
.    ..   .  .     .  ..   ..   .     .  .. .   . . .     ..  .        .  ...   . ..     .   ..       .. .    . ..   .. ..         .. . .
..     .   . ...  .   ..   . .  .. .       .... . .. ..   . . . ..    . . .. .  .       .  .  .  .       .          .   .    .    ....  .
.  .. . . . .          .    . .     ... . .       ..  .   .. .    .    .  .      .  ..     .   .       .             .      .    .  ... .
.  . ..  ..     ..                 ..     .   ..   ..  .       ... .. .      .  . . .  . .  .    ..      .        .... ...        ...   .
.    . . .  . .    .    . .    .      . .. ..   . .      .   .       .     . .  ..      . .      .     .   . .      . . ..   .  . . .. ..
. ..    . .         . .   .  ..           . .   ...  .   .   ..  .       .    .        . .      .     . .      ..    .    .       .     .
. .  .      ..   .           ..   . ...   . ..  .  .... .. .     .. .    .     .   ..  . .              .  ..  .. . . ...       .  . .. .
.       . .. .. .       ...  . .      .. .  .    . .       .   .  .      .       .  ..   . .   .        ..    ....   .  .   .    .   .. .
.. ..  .      . . .      .   ..   .   ..  .      . . .      .. .  .       .   . .  .     .. . .           ... ..               .     .  .
.  . ...    .          .   .   .  .  .     . . . .      ... .        .  ..    .     . ..  ...            ..    . ..      ...   ..     . .
.....         ..    .    .               .....    .   .   . ..      .    .  ..  ...     . . .      ..  .      .        . . ..       .   .
. .   . ....  .  . .    .  ..         .  .. .     .      .  .   .. .         .    . .       . . . . .   ..        ... .    .      .   ...
. .  . . . . .    ..  .    .. .  ..    .   .    . .    ..       .  .            .. .  .  .   .. .           .    .. .     .  ..        ..
. ..  ...   .   ...   ... . . ..  . .         . .     . ...  .   .   ..   . . ...   .         ..  ...    .  .  .   ..   . .    . .    ...
..   . .  . .    .. .  . .   .        ..      ..   .       ..        .   ..     .  ..    .  . .   . ..       . ..          .   .    .. ..
...     ..    .   .    ..   .. ....      .. . .   ..        .  .      . .  .  .   .  .  . . .       .    .  . . ..    ..   .  ..     .  .
. .   .      ..        . .    .    .  . .  .  .   ..  ...         .   .....   ..  .    ..  ..    . .           ..  .  ..   .       ..   .
.. .     .    .. . .         ..     .. ..       . . . .      .      .       .    ...   .. .      .. .  . ..... .  . . . . . ..  .. .. . .
..             . . . .      ..    .    ..     . . .        .  ... .     .  . .. .     .     .   . ..         .. ...      . .    .    .  .
..    ....  ..               . .     .   .       .   .     .. .   .   .    .  .. . ..            . ...      .   . .  .     .     ....   .
.    .     . ..     .         ..   . .    .   ...  .         ..    .   .       .. .   .    ...   .      ..          ...               . .
.     . . ..   .         .     ..  .. ..   .   .  .     ...   . ..  .   .   .  . .  . . . ..               . .     .   .  .    . .  .   .
........ . . .    .                 ..         ...   .  ..  .   .      ... ....       . .  .   . ...    . . .  . ... . . ..    . .  ..  .
.    ..  .     .... ... . .       . . . ..    . .   ..  .   .   .  . ... ..    .   .. .. ... ..       .  .       . .   . .            ...
..        .  ..      . . . ..     .   ..   .    . ..         .  .    ..   .    ..    .   ..  ...  .  . .    .       .  .....  .. . .    .
.  . ..      ..    . .. . .        ...      ...      . ..... . . .  .  . . ..  ..   .      ..   .       ...   .   ..          ....    ...
.  .       ..  .   .. .. .     ..   .         . .  .        .  .         .. . .         .  ..         .     .    . . . ..    .     .    .
. .        . .     .    .  .  .     .     .     .  ...     .   .. . .   .  .    ..  .   .     .   . .    .  .      .    .       ..   .. .
.   ..      ..    .  . .  . .      .   ..   . ...  .. ...         .. . .         .  . ...   .  .  .. .     . .   . . ....  ..  .    .  ..
. .   .  ...  ..     ..     ..  ..  .  . .  . .     . ...    . .   . .     .   .       .          .     ..     . . . ..  .  .  ....   . .
.          . ...  .      .     . .  ..       ...   ..  .    .. .        .      .  .     . ...   .     .. .   . ......    . .   .. .     .
.   ..     .     ..   .  . .. . . . .    .   .    .     ..   ..        .  ... .  .  .. .. ..  .        . ..  . . .   ..  .. .           .
..      ..   .  ..         ...   ..    . .  ..  . . ....           . .   .  . . . .  .            .     .   .   ...    . .. .. . . .   ..
.. .     .    .   ... ...       .     .  .  .   .   ..    ..  ..   .   .   ....     ..   . .  . ..  .    .        .     ..  ..      ..  .
.         .      .  .  . ..             . . .  . .    ...           ... .           .        ..     . ..   .   .  .  ......   .  .     ..
.   .  . ..   .. . . . .   ..    .   ....    .. .   . . .  .   . .  .   .  .       .    .... . .          .   . .     .   .   ..   .  . .
. ..  ...   .       .  .  .      . .      ..   ..          .      . ..   .              . .  ..   .     . .. . ..                       .
. .  ..       .  .   .   .  .   ...   .   .   .  .  .  .   .... ..    .    ..    .  .    ...      . ..    . ..  .  ...   .  .         . .
. .   .    .  ..  ..   .. .  ...  ..  . .  . . ...  ....          .    .        .  ..    .     .  .     ..  . .. . .. ..   . .  . .  .  .
. .   . .           . ..       .      ..     .    .        . ..        . . ..   .  .  ..    .     . .        ..   . . .  .    ...  .    .
.. .   .. ...              .. .  .    . ..... .           .         .   .     .  .  ...  .  .  .     . ..  . .   . .  .          ..     .
. .   .      .        .  .  .         ..         .    .          .. . . .  . .   ..           ..        .    .   . ... .        .       .
.     . . .   .    .   . . .   .  .   .   .. .        .   ..   . .   .  .   .  .    ..       ...              .  ....  . .  .. .   .  . .
.   .  .  . . ..  .. .  .   .       ..  . .        .        ..   .  .  . .  .            ..   . .      .    . .       .  .   ... .      .
. . ....   .    .        .    .  . . .  .  ..   ..     .     .         .         .     ..    .  .   . ........ .    .. . .     . r    . .
.     .          . .  . .  .. ...   .. . . ..  .       . .   ...  ...   ....         .  . .      . .   ..  .  .         ..... .       ...
....         .     . . . .   .. .           .     ....  .. ...  .   .  .  ...   .      . . .  .  . .  . . . . .    .  ...    . .       ..
.             .    .      ... .   . .   ..   .. .. ..   .       . .  .   . .  .    .    .  ..   .  .. .  . .. . .     . .   .        .. .
..    . .   ..        .  .. ..  .      ..      .. . .  .  . . .  .     . .     .... .      .  ...       ...    . .         .      .     .
.. . .  .    .     ...  . . .  . .   .  . .     . .       .. .  .  .     . . . .  .   . .            .   .  .  .    . .     .   . .. . ..
. .. .  ... ..  ..  .      .  .. ...  .   .     .  .. .   ... .    ...  . . .      .... . .   .   .  . . ..   .   ...    .          .  ..
.   . ..     ..   . . . ..  .      .      . .  .. .  ..    . . .   .            ...  .    .      .        ..    X  ..     .          .  .
.     . . .   ..  .    .  .   .     . ...     . .. . ..    .   .   . ..  ... .  ..     .  ..    .    .... .  .   .    .  .         . .  .
.     .      .. .           .   ..    .  .  .     .   .      .            .        .   ..    .         .    . .   ..   .   ...  .  .  ...
.   .... ..    .    .   . .    .     .        . .        .   ...     ..       .      ... . ..     .. .    .     . ...   .   .....   ..  .
.    . .      ..                 ...     .    ..  . .  ....  .   .   .    ..  . . . .      .              .   .         ..     ...  .   .
. .              .    ..    ..    ..  ..   .   .      .    .  .  ..     .. .   .  .  .             .  .. . ...    ... .       .    .    .
.  .      ..         .   .. .     .  .     .   .  . .   .   .. . ..       .     ...  . ..    ..        ....  .     ... ..           .   .
. .  .. .  .   . .      .   .  ..    .         .  .  .   .    . ... .  .   ...           .  ..     .   .  . ..  . . . .      .     .    .
..  . .  .      . .        .   . .     . .   .   ..   .  ..       .. . ..    .    .  . .    . . .     ..   ..  ...       . .   .  ....  .
.. .  .  ...      .       .   .  .      .     . .     .. . .    .. .   . . .   . .     . .    .        .    .   .       ..    ... .    ..
.  .....    .. .  .   .      ..  .  . ...   ..  .   .   . .  .    .      . ...      . ..  ....     .    . . .. .    .  .     .. . ..  ...
.  .      ...            .             ....                  ..       ..  .  .   .        . ..  . .  .    .              . ..      ..   .
. . .  .       . . . .     . .   . .     .    .  ..     . .. .    .     .    .   .      .. .    . .   ..     .  .     ...        .  .  ..
.      ..   .  .  .  .     .  .    ..  .     .        .. ..  . .    .  . .    .      .       .     .    .     ..       .  ... ... .     .
.   . . . . .  .    .  . .      ..     .         .      . .      .   .    .   .. . ..     ..       .          ..         .  .  . .... . .
...         .. .   .    .  . . .    . . .   ..          ..     ...                .  . . .   ..     ..       .   .            .    .. ...
.     ..   . . .  . . .   .  ..  .  .  .    .   .  . . .  . . ...  . .      ..      . ..  . .   .        .  . .  ...    .             . .
.    . .       .....       .. . ..             .  .      .    ..  .       ..  ..     .. . .    ..    .  .            ..   .  .     .    .
.             .  .    .          ...    .  . .  ...  .. . ..       .. . . .  ..  .  . . .              ..  . . ..          .     .     ..
. ... .   . .         .   . .  .             . ..    .         . ..  ..       .    .  .   .              .    ....  . . .         .    ..
..    .             ..                .    . .... .    .   ..     .    .   .    .     . ...     ...   ..   .. .   . .           .     ...
...    .. .     .  .. . .          .  .                 .  ..   .. .   .    . ...  .       .     .        .      ..   .. .        . .. ..
..    .  ... .         . .             .  . .. .  .     ...        . .      .  .   ..         .      .  . .   . . .  . .  .   .   .   . .
........ .     ..  .        .   .   .  ..  ..    ..   ..       .     ..    .    .    ..  .            ..  .        .  .. ...      .. .. .
. ...     .  .         . .... .  .. .  .   ..  .        . .... .. .. ....    .  .   ..    .. ..  ...    ..      .    ..      ...        .
....  . .                .        ...     .  .  . .  .    ..   . .    . .     .       .   .      ..    ... . .         ..  . .. .  .  . .
...      ..      . .      . . .  . ...    .   ..    . .. .  .   .. .  .    .  ... .  .   ...   .. . . .        ...       ...  .  .      .
...   .    . . ..  .  .   .....   .. ... .  .  ..       ..      .  .      .     ...... .    . . .. ..      .  ..   .   ..  .   ..    .  .
.  .    .. . .     .. .  ..      .      . . .    .        .. .  .  . ..    .  .  .       ...   .    .  .   ..  .   . . . ..  .  . .   ...
..    .        . ..        ... .     .      ..       ...  ..  .     . . .  .            . .   .   . . . ..   .         . .      .       .
....  ...  .  ..  .    .         .. ..  .  ... . .      .. .   .   . . .       .. ...         .    . .  . ..     ...  .   ..   .  ...  ..
. .   . .  . .. . . .  .  .           . .  .... .   ..  .  .. ... . .  ..    .                  ..         . .    ...  . .  .  .        .
.     ...    .   . ..  . . .       .. .    .      ..    .   . ..     .  . . . .       .    .  .  ..   ..   .  ...   .    . ..   . . .   .
. .    . ..  .   ..      ... . .   .    ..  .   .  .   .. . . . ..  . . ...   .      .. .     .            ..   . ... . .  ... .  . ..  .
. . .  .  . ..  .   .    ..   ...  ...   . .. .     .. .  ..        .    .    .     .   ....     ..       .   ..    .     ..  ... .   ...
.  ..  ..    .  .    ..   .  .   ..    .  . .          ... .  .   .     ...   ..      ... .      ..... .  . . . .    . .... .  .  ..    .
. ..         .    . .... . . .     ..                .   .    . . ....    ... .   .  ..      .. . .  .      .           .   .. . .. .....
. .     .     .. .    .  . .     .      ..   . .     . .    .      .     .    ..    ...   . .    ..        .. . .   .      ..    . .    .
.    . ..  .  .    ..      . .     .  . .  .  ...   .  .      .   .  .  . ... . .. .     .     .  ..       .           . . .        ... .
. .  . ..     .    .      .      .     .. .  .    .        ..     . .  . .      .  .   ... . .. ..     ..      .  .         .  .  . . . .
..         . ..   ..     .  ...     .       .        .  . . .    .   .     . . ..  ..   ..     .    .   ...            . ..  ..    ..   .
.  ..   .   . .      . . .    .           .  . ..     .  .     . .  .  . ..  . . . .  . .     ..    .  . ..   .   .      .  .       .. ..
.              . ...      . ....  .  ..    .  .           .  ..  . .      .    . . .       .        ....  . .  .....    .   . .   .     .
. .       . .   .   ..    .. .  . ...         ..  .   .  ..     .      ..  . ..    . .           . .      .  ..  .           .     . .. .
.. .           .      ...    .   . .   .   . .  . .  . .. . .  . .      . ...  .    .          ..    ...        .  .. .    . .  .. ...  .
.  ..         . ..            . . .             .  .    .          .      . . . . .. .  .                . .. . .  .    .  ..  .    .. ..
.. . .   ..  . .. . ..  .   .     .. .     . ... .   ... . .       ...  .        . .. .   .    .  ..    ..... .  .   . ..   ...      .  .
. .   . .   . . .  .    ..   . ... .    .  .. . . .      .  . .  .  ...       .        . .   ... .   ..      . .    .  .             .  .
. . .   . . .. .  .        . .  .  ..  . .     . ..   ..     .. .. ....   .  .    .     .  ...  ....  .    ..            . . .  .      ..
.  ..  .        .. .  .. ...       .   .    .      .. . .         ....  .  .         . ..  .       .   .  .   .         .    .          .
.     .          .          .          .  .. .   .  .. ... ..  .    .. .     . .   ..  .        .. .       .     ..    ... .   .       ..
. ..     .      ...   .       ...      .         .   .  ..       . .  .       .  .   . ..   ..... .   ...       ...   . . ..       .    .
.    .     ..  . ... .      . .  ..    . .. .. ...    .  .     ..  .      ..       . ..   . . .    .        .  . .. ..     .  . ..   ....
. .    .    . .   . .   ..    . . .    .   .  .     . .    ...  . ...  .   ....  ..     .  .    ......  ..   ..      ..        .        .
.   . . . .. .             .      .     .       . ..     .  ..    .... . .... .      .. .. . .  .....   .   .      .   . ..  . ...   .. .
.     .    ..   .           .....     . .  ..   .   .  ..    .   . .       . .    . .    . . .       .  . . .. . ..    ..   .. .      . .
.  .     .     ..     . .    .. .   .  ..  .          .    .       .. . .  .. .             .  . .. . ...        ..     .         ... . .
. .     ..         . .    .. . ..  .     .    .    . .  . ..     . .... .. .      .      . ...         .          ........ .   .   .    .
... .       .    . .. .    ...       .   ..      .   .    .     .. . .     . .                  .    . .      . ..           .         ..
..        . ...   ..   .  .  . .        . .   .    .      .  . .  ...    .   .   ...  .      ....  . ....  . .  ..  ..    .. ...    .   .
.  .   .  .    ...  . .       . . .   .  ...  . .         ..   . . . ...             .                . .    . .       . .    .   .  .. .
.       .  .                     .  .  ..  .   ...  . .. .    .  .  ..  . .    .   .   .    .... .   .. . .. ... ..     ..  . .  .  . ...
.  .  .   ..    . . ..  .  ...      ..  . .     . .    .  .  .  . ... .         .    ..  ..      .  .  .     .  .   .  .        .    .  .
.........................................................................................................................................
