..........................................................................................................................................
.  . .   .    ..        . ..  .        ...   .  .  . . . .  .  .  .  ... .    .    .  ..   .. .   . ...  ..        . ..         . ..     .
..   .  .   .            .   .   .     ..    .  . . ....     . . ..   . .     .. . .     ..   ..         . .        .     .          . . .
..   . .   ...    .       . .   ..       . . ..     .     . ..     ...     .     .   .     . . ..    . . .  . .     ..  .           .    .
.      .  .          ..               ..   . .   .  ..     .   .            .   ..  .        ..      .  .             ..   . . .    .. ...
.   .  .         ...      . ..      .  ...  .        ..    .    .    ... .. .  . .   ..        ..        ..      ..    .     .   .. ..   .
..     . .    ....  .. .  .   ...    ..   ..   .    .  .   ..   .   .  .. ..      ..  .  .   ..    ...      .  ........   .. ..   . . .  .
.. . ....          ..  .   ..           . . .  ..   .     .  ..  .  ..  .    .     . .  .   .. .   . .      .   .  .  . .. ..        .   .
... .    ..    . . .  ...    ..        .    . ....   .   ....    .   .     . .   .. ..    . .  ..    .    .   .  ..  . . ..   .       .  .
...     .. .         .        .   .   ....   . . ..  ..  . .      .    .  ..  ..  . . . .       . . .    ....     . .           .  .   ...
. . ..  .    .    .       . . .     ..  .      . .   . . .. . ..    .   . .     .    .  . .  ..   .   . ..       .       .  ..   ... ... .
.  ...   .   . ..  ..   .... .         .    ..     ..  .  . .   .       .      .   . .. .    .   . . .         .    ..   .. .  .      .  .
.       .  . . .   ....     . .               . .   ...    ...  .    .      . . . . . ...  .   .    .       .   . .    .    .    . .     .
..   ..  .  .  ..  . .   ..  .   .     . .  ...         . .    .. .   . .    .         ..  .      ..       . .  . . .   .   ..   .    .  .
.  .    .  ...       .  ..  .  . ..   .  .  .  . .. .    .            .   . .    .      .     .       .  .       ..    .    . ..    .. . .
. .    .            . .  ..  .  . . .   .   ...  .     .    .     ..    .        ....  .   .          .  .   .  .      . .     .      ....
.      . . .   ..  ..         . .    ..  .         .  .. . ..   .   .   ..  .    ..       ..  . ...      .      ....    . .    .   ....  .
.. .         . .    ...  . .  .. ...  .  .... ..       .    ... ..  .      .  .    .  .  .      .        . .      ..    ..             ...
...  .  .   .   ..  .. ..      ...   .    . ..   .  .       .      ....    .     ..           .  ..    .   . .            ..  . .      . .
.       .. . . . .                . .     . .  .. ..   .. .. .  .. . . . .. .   .      . .    . .  .                    .    ..   .      .
.      .  .       ..     .  .   .   .      . .   .    .   . .   ..     . .            . . ..   .  ..    .  .     . .  .  .      .   .   ..
. .         .  . .  .  .  .  .    . .   . .      .      . . .   .  ..    .  ..       .   .    .   . ..  .   . ...      ..    . ..    .  ..
.     . ....  .   .. .   ..  . .  . .     .    . ..     ..  . .   .  ..  ..   ..   . ..    . .           .   .  .. . .   .. .  .     .. ..
..    ..       .  .   . ..    . .   .   . .. .    .  . .   .X... ..   . ..   ..   .    ..  .  ..   . . .    .   .   .   . . . .. .       .
..      ..   ... . ....    . . .     . ..                 ..  .        . . . . .   .      .  ...      .  ..  .....    .. .  ..     .. .. .
.    .    .   .. ..  . ..  .. .      . . . .   ...  .. .  ..   . .  . .  .   .   . .    ..  ....         ..   . .    .        .      .   .
.  . .  .   . .  . ..    . .  .              .  ..    .      ...     .... .   ..... . .      .. . .     .       .    .            .      .
.     .  .        .. . ..       . .. ...  ..   . .     .  .          .                 ... .   .   . .     .          . ..    ..    .   ..
.     .            ..  .  .       .. . .    .      ..   .    ..    .. .  ...    . .  .       .     . .. .  ...  ....  . ....   . .     ...
.        .       ..     .       . .     . . . . ..  .    .     . ..        .  .       ..  .    .  .  . .   .  .. . .    .... ..   .   .  .
..    ..      ..   ... .    .. . ...  .            .   ..  .     . ..    . . ..  .  ....        .  .   . .   . .     . .     .  .    ..  .
.       .   ..     . .    ....         .    ..   .     .   ..  ...  .    .  . .         .      .     ..          ...... . .  . .     .   .
..     ..   ..        .  .    .  .   .    .           ...     .. . ... .  . .  . .      .   ....  . .  ..   . .  .  . .     .      .     .
.  ..  .     .  .     .      ..  . .      ..      .  . . ... . . ....      .  . ..  .  .       ..     .. ..    .....     . .        .    .
. .         .. ..   . ...    . .   .. .  . .  .  .   .  .  .     .   .         .   .    .  . .    .  .. .  ..    . ..     .   .    . ..  .
.   .    .   .    .   ... .     .         .     . .   . .     ..  .   ..      .. ..    ..   .         ..    . .      .    .....   .. . . .
.   ....    . .   .    .. .    . . . .  .  .      ..         . .         .     .. .  ..   .  .. ...    .  .... . ..  .                .. .
.  .       ....        .  .      .  .      . .. .  .    .    . .  .     .        ....   .. . . ..  .     . .   . . . .   ..   .  .       .
. . .    .. ..   . . .   ..                .     .    .  . ..  .    .     .   .    ....   .    .  .  . . ... .. .        .  ... ..       .
.    .    . . ..    .       ..   ...... . .   . .   ...  .   ..     . . ..   .  ..  .  ..            . .. .  .     .     ...  .  .  ..  ..
. .    . .   . .     .      .   .   .  .         . .  . . .   .     .  .     . ..       .          .   ..     . .         .     .        .
.  .         .                . .   ..    ..  .     . .    .   .. ..                     . .   .  ..       .....           ..   . .      .
.      .    . ..       .      .. .   .  .   .    . .      .     .  .       . . .          .  . .       .   . . ..    .     .   .  .    . .
.   .  . ..     ..     .   .  . .  . ..        ..  ..    .   . ..          .  .  .  . .. .   .    ...  .       . .. .  ...           .. ..
.   .. .     ...  ....    .  .    .     .  .    . .            .          . .  ..      ...         .    .. ..  ...  . .  ....      ..  . .
. ..     .   . ...  .  ..  ....    . .    .     .  . . .    ..    . ...   . .. ... .    ..  .          .  ..  .  .           .          ..
... .    . . ..      .   .    .     ..  ....       .  . . .  .    ..          . . . . .  .  . .  .    .... . . .. .  ..          .. .  . .
.     .       ....    ... ..  .   .  .. .  . ... . .    .    ..   ..      .   . ..   .. ..    .  ..  . ...     ...         .....    . .  .
.   .  ..  . .  .     .  .  . .. ..  .     .       .       .  .      .  ..  .  .    .      .         .  . .         . . .       .        .
..        .          .     .  .  .  . .  .... .            . ...  ..  . .      .     ..    .    . . . .    .   .   . .   ..    .       ...
...   .. .   ...        .      .  .    . . .      .  .  . .   . .   .. .   .....   .     .   .    ..    ..  ..  ..   .         . ..     ..
....  ..        .  .....  . ... ..  . . .     .  ...   ..  ..      .  .   ..      ...   . .  .  .    .     .      .      .     .      .  .
.   .    .    ..    ..             ..      .. . .         .    . .  ... .  ...   .  .   . . .         .  . .    ..     ..            .  ..
..  .      ..       .    .                 ..    .. ....  .. .        .             .. .... ..  .      .     .      ..... . .....  . .....
... .          . .     .  .      .    ..    .  .        .  .   .    .       .. .           .  .    .    . .      ... ..    .       ..   ..
.        . ..      ..     .      ..   . . .  ...   .. ....  .    .  ..  .     .  ...        .  ...  .      .  .    ...     ..   ..     . .
. .  ... .       .  ..  .    . . ... .   .. .  . ... ..   .    .     . .  .    .  ..                   . .  ..   .        .   ..  .  ... .
.    .     . .     .  .  .    .        .  .. ..   .. .. .  .      .    ..            .      ..  . .    . .    .. ..    ..  .. . .. ..    .
.. ....     .     .        . .      .  .  . ...   .     ..  ..     ..    ..  .  ..   .     ..   ..  .   .   ..  .   . .  .  r .     . .  .
.      .    . .      ...       .    ..   ....   .    .. . ...         ..        .     .    ..  .... .      ..   .  ..  .   .        ..  ..
.  .  .. .     .   ..             .  . .  .    .. ..         .. . .    . .    .      . .   . .              .      .   .        .    .   .
.        .     .  .   . . .   .      .. . .       .. .    ..        ..  ...   ..   .   . . .... .     .            .  .     ...      .   .
.       . ...     .  .   .  .  . .   .    . .    . .  . .  .   ..  .      ..  .  . .    .    .   .   . .. .  . .    .   ..  .      ...   .
..         .    .. .    ..   .    .  .   ..                  .. .   .  .      . ...     . . ...  .    ..   ..    ..          .      .. ...
.   .   ..  .           ..  ...      ..  . .       .  .          . ... .   .                     ..  .     .  .  ...   ..    .  ...   .  .
..     . .  .  .    .  .. ..   .  . . .  .        ..  .  .      .       . ...   .      .. .   . . .  .  .        . . .  ...  .   . ...   .
.        .. . .      .    .....   . .      ..   .  ... .        .   . . ... ...     ..      .. ..   .  .      .  .    .... . ..   ..   . .
.  ... . ..  . ..  .. .. .   .     .  .   .          .   . .    .    .. ...   ..         .    .  ... .           .   .. .. .. .  .     ...
. .      .  .    .        .   ....  .   .  ..    . .    .   .    ..  .. . ....           .    . ...   . .        . .     .  .  .. . ..  ..
.  .         ..    ... ..   .. ... .  .          ... .... . .    ..   ... ..       .      .       .  .  . ..  .    .      .. .   .   . ...
.     ..   . ....    .. .  .        .       .. .         ..       ..     . .      .  . ...   . .   ..  .     .          ....   . .   .....
. .  .  . ..     .  ...      .     ... .  .  . .  .      ..  .  .        .  .. .    . .   .     .  . ...    .  . .   .     ..      .     .
...    . .   .  .. ..  .. .. .    ... .      .     .      ..   ..  .    . .         .  . .  . .    .       . .          .    ..  .... .  .
. .    ..     . .. .         .   . .. .   ..  .            .             ..         .    .  .  ..  . ...  ..     .     ..  . .  ..   .   .
.      . . .   ..    .  .              .... .    . .  . . .  .. .. ..    .        .    ..  . .... .   ..   .     .    .   .  ..  .. .  . .
..   .         .. . .  .. .   .              ...  .  .   ... .        .  .    . . .  ...    .  ..        ..    .  .     .     .       . ..
...      . .          .. .. .  ... . . .  .  . ..        ..       .  .    .            .   . . ..  .     .     .   . .       . .         .
.     .  .    .   .   ..      ..    ..   .      .  .   .       .. .    . .    . .        .   .   . . . . . .. .  ..     . . ... .        .
. .... .  ....       . .      ...   . ....  .    .   .   .     .   .  ..    .      ..  .       .  . . .. .    .. .. ..  .       . ..  . ..
..      .     . .. .     ... ..   .       ..  .  ... .  .  .     .  .  ..  .  .      .         .. .       ... .    ..     .   . ..      ..
..     .         . .    .    .   ..      .. ..    ..   .   .  . . .          . .           .  ....   . . .    .   .    . ...  .    .   . .
. ...      ... .  . .       . .   .    .   .     .  . .   .  . .  .  .    ...          .  .  .. .  .   .    . ..      ..  . .  . ... . ...
.     .. . .      .  .       ..   .     .    .     . ...      ..  .. .       .           .     ..       .     ..    .  . .    .   . .    .
.  .      .       .      . .    . .     .... ..   . .. ... . .   .     .. .  . .          ... .. .   .                ...    . .         .
.  .   ..       . ..       ..  .   ....  . .   . .   ..                      .       .   .   .     ... .. . .  . .   .            . . . ..
..    ..      .    .. .  ...        .  . .  .  . . .  .  .  .   .   .  .      . . .  .   .  .   .      .  .      .      .     .      .  ..
...     ..  .    .        . .      .    .. .   .  . .  .  .  .   .         .    .   .. .  . . ....   .        .  ......  ..  .      .   ..
.        .      .         .       ..    ..           ..   .  .     .     .       ..  .  .   .  ..     ..   .  ..    ...      .   .   . . .
... .     ..  .       .   . .  ..           ....        ..     .    . . . .   ...  .. . .         .   ..    ..   ..   ..  .   .       .. .
. ..  . .  .  .. . .         ...    .    .   .            .      .. .  ...   .     .           .            .  .     .. . .      .  .    .
..   ... .         .  .     .      .      .    ..   . .            ..   . . ..   . .   .      .. .... .    .          . .  .. . . .    . .
.    .   ..       . ..     .  .     ...             .. .  . .    ..     ...  . .  ...   .. . .    .    .     . ..  .  .   .      .  .  ...
.    ... ..  . .   ..   .. .. ... .        ...  .   ..   .  .   ....        .       .. . .        ..      .  ..    ..  ..    .   ..    . .
.  .    .   .  .  .           .          . .     . ..  .     .... ..   . ..          .  ....  .. .   .. . .. . ... .    ...  .    .. .   .
. .    . .        .   .  .    .  .. ..       .. .       .. . .  .        .    .. .  .  .        .   .   .            .     . .   ..  . . .
.      . ..          .      .     ..  . .   ..  .    . .    .  .. .. .    .     ..       .. .   ....  .. ...  . . .   .    . .  . ..  .  .
.           .  .    . . . .       . . ....     .    .     ...    . .      .  ...   .   .        .   . ...    . .. ..      ..        .   ..
.      .   ..    .    . .    ..    ..    .  . . .   ..     ..        ...   .  .  .  . ..       .. .. ..   ...      ..  .. ... .   .  ..  .
.        .     .  .. .    .  ....  .  .       ....  . .      .  .    . .... .   .      .    . .... . .    .   . ..  ..    .          .. ..
..    ..   . .          ..      ..    .        .. .    .    .   . .. .  ..   .         ..   ...   .  ...  ..       .   .     .    . . .  .
.  .    .  ...      . . .     ..  . .     ...    .               .    ..  .    ..   .    ..    . . . .       .        .  ..   .  ..  .   .
.     .    .   .. .      . .  ..    ...     . . .       ...   . ...     . .          .   .    .  .   .     .       .. . .     . .  ...   .
..   .    .    . .. .  .    ... .   ...   . .     .  .. .     .. .. ....  . . .    ... ..   .  ..      .    .  .            .          . .
.    ...    .  .     ...... ..  . . ....  .       .. ....     .    . . ..  .                .      . ..             ..   .  ..  ...  .   .
.. ...     ..  ..   .  .. ..  . .     ..... .. ..     .   ..           .. .     .    .. ..  .   ...   .  ..     .  .      . .. ..  .  .. .
. ..               .  . .    .   .     .   ..    ....  .   ..  ..       .. ...      .        . .   .        .  . .    . .  .. .. .       .
.  .. .  .      .  . . . .              .    .   ..           . ..   ..  .   .       .   ..   .  .. .. ..         .  ..            .     .
.           .  .   . . . ...  .  ...      .       .. .     .    ..  .. .    .      . ...  .      .. ... ..   ..          ...    .      . .
. ...      .     . . .  . .    . . .. .  . .  .  .     ..     .......        . .. . ... .   .      . ..      . .   .     .    .    .     .
. .   . ..           .  . .  .....  . .   .   ..   . ..  ...         .   .   .            .  ..        ..  . . .  ..                 ... .
.    .   ..        .    . .         . . ..   ... . ..        . .  ...  .     . .. . .   . ..     . ...      .    .         ..  . .       .
..   .  . .       ..       .       ..    .     . ..  .. .  .   .. . . .. . .  ...    ...             . .     . .... ... . .   ....    .  .
.     .. .. . .   ..  . . . . .    .   .     .   .  .        . .   .  .  .      . .  .. .        ...  .    ..  .. .     .  . .  ..       .
.    .. .. . . .. .   . .       .  .   ....... .      . .    .       .    ... .. . .     .     . .          ... ..    ..  .      .  .  . .
.      .    .  . .     . . . ...   ... . .       .          .. . .  . .  ..     ... .     ..  .. . . . . ..         .  ...  .  ...  .  ...
.   . . .      .           ..    ... .   .. . .    .. .   .      ...           .   .      ...  . . . ....  .  . .      ...       .    .  .
.  . ..    .. .        .. ..       .     .. .  .  ..    . . .   .  .  .    . .   .        . .             . .       .    ..    .   ...   .
.  . .     ..    .     .   ...     .    ..  ...  .   .    ..     .    .    . .. . .. .  .    .  .   ..  .        ..    .     .    .   .  .
.         .    ..     .  . .     .      .. .  .      .  .    .  .       .         . .. . .    .      . . .     .   .  ..  .. .  ..   .   .
.   .. .       .        .   .      ... . .. . .        . .    .... ..   ... .  ...     . . . . .  .   .        .  . .     .          . ...
...  .   .          .    .   .   .          . . .    .  .   .  .   ..    ...      .               .   .   ..   . .   .     ..  .   .    ..
.  .            ....          .     .  ..   . . ..    .. .   ....  . ...     .   .    .    . ... .     . .   . .....    . .         .  . .
.   .  .  .      ... .. . .                 ..               .    . .      ..     .. ..  . ..  .     .    .  . . . .   .        .  .    ..
..  .         .     .  ...  .          .. .      . ..      .         .      .    .   .      ... ..    .  .   .. .     . . ..  ..    .... .
. ......   ..    .       .   .. .    ... . .    .    . .          .  .       ..   . .   .   ..   .     .    . . .    .  .          .     .
.   .     ...      .   .       ...   ..   ...  .. ..     .   .    .      ....    ..  .          .  .              .     . . .. .  .     ..
..  .       ...  .    .       .     .. ..         ..  .      .   . ..    .. . .          .     . .     . . .    .       .... ..    .  .. .
.    .         .  .   ..         . .  . . .         ..       .. ...                ....                .... .  . ..     . .   .    .   ...
. .  ..    .  .  ....   .         .. .. .   ..      .  ...     .   .  .. .   . ..   .   . ..            .               .  .       . . . .
.                       .  ..    .      ....  .  ...  . .... . ... .  ..           ...  .       ...  .     . ..  .   .   ..   .   .  . . .
.        . .  . .   .    .  .  . .       .  .  . ..    . ... ... .  .    .  .         ..  .  ..     . . ..    . ..  .          .  ..   ...
.. .     .           ...  .   . ...  . ....    .. .       .   . .    ...    .    .  ... .... .    .                  . .   .             .
.. .       ....  .  .        .. ..   ..   ..      .  .   .  .      ..      .  . .. .. ...  .          ..        .       ..    .  . .    ..
.  ..   .       .   . .     . . .    ......  .     .     .. .         . .  . .   .... .  ..   . .  ..   ..      .  .        .  ....  ..  .
. .      . ..  .  ..   . . ..  .         .   ...    ..      .   .        .             .  . .    .   . .   .  . ...         .   . .. ..  .
.  .       . .            .  ... .  . .        ..     . .  ....   ....   .       .  ...   . .         .   .. .. .    ..      .   .      ..
.  .  . .  ...  .    .    .. .    ..      . . .        .. . .            .   ..     . . .  .. .       .     .             .  .    . .  . .
..........................................................................................................................................
