...........................................................................................................................................
.  .    .  ..       .       ..  .   ...            . .     . .    .   . .  .       .   .  .. .   .            ......     .    .  .    .   .
.  .             .  . . .      .      .   . ......  .... .. . ...    .   .. .. . .   .  ...     .                 .               .  . .  .
.  ..  .   .   .. ..      . ...  .  .  ...              .    .. .      . .  .   ....       ...  ...  . .... .   .   .   . . .   ..    .....
..  ... . .   ..      .               ..     ..  .    .   .  . .   ....       . .           .   . .       .  .  .            .          . .
. ..    ..  . .  . .  .  ..      .    .              .     ....              .    ...  .  . ..       .   ...    .   .  ..  . .    ..   .  .
... .  .  .   .. ..  ..   ..  .    . ..  .    . ..    . . ..       .  .       .   ..         .   .       ...      .  ...         . .  .  ..
.             ..    ...  .     ..   .   .   .   .  ..    .   . .  .     ..... .  .        .    .        . . .        .   .       . .  ... .
.. . .  . .       ..  .  . ..  . .         . ..    ..     .. . . ...        . .  .   ... .        ..   . ..   . ..  .    ..    .   .      .
.    .  ...      .  . .   .... .  .. .  ..       .  . ..  .         .  .. ...  . . .  ...  ..  .  .. ..  .  .   ..   .. .        .   .   ..
. ...    .  . .        .    .  . .  . .          .  .        .  . .       .. ..  .. ..     .. .    .  ... .         .               .    ..
.. .   .   ..   ...  ...    .  .     . .  .     .  .     .  .  . .  . .. .    .  .    .  . .                ..  . ..   .   .. .      . .  .
.  .  .    .      . .. . . .  ..       .  . .   .  .   . ...   .     .... .       .. .  .. . ..   . . .  ..      . .    . .    .   .      .
.... .           . ..  ...            ..         .    .  . .       .      .    . .    . . .       ..            .  .       .   .  ...   . .
.     . .     .   .         . .  .             ..  .  .      .  .      .            .   .   . ..    . . .    .    .        . ..          ..
.   .. ..  .       .    . ....    .      .   .     . . . ..   ....  ..  . ..     .          . .  .  .. . .    ..        .  . .   ..  ... ..
.   . ..    .      . .      . ..      ... . .    .  .  ..         ..  .     ..    . .  .      .  .          .  .      . .    .   . .     ..
.     .  .   . ..   .  .     . ..  .  . .  .. ..    .       .   .     .            .. .     .   .      ..    .     .    ..    .    .   . ..
...  ..    .   .. .   .. .. .   ..  .  . .   .        . .  .          .    . .        .         .      . ..  . .       .  . .      ..     .
. . . .  .  .    .  .. . ...  ..  ....    . . .      . .... ..   . .. .     ....   . ...          .  . .  ..  .   . .   .     .   ....    .
.         .   . .. ..  .   .    .   ....  .  .      .        .  .    .     ...   .   .       . . ..   .. .   .    .  ... .     . .  .   . .
.   . .  .    ..  .  ..  . .... .                    .  .            .. . .      .. . .    ..     ..   . .   ..  .     . ..   ..    .  .  .
.        .   .           ..    .    .   .  .                  . ... .     ... . .       .   . .   ..  .... .      ..  .  . . .   ..  . .  .
.         . . ...  . . . ..    .         ...   .. .  .           . .. .    .   .   .        . .    . .            .. .     ...    . ..  . .
.    . . .. .  . .. . .          .        . .. .    . . .  . ...     .  .          . .  .  ...      .  ....   ..  ..    .  . .         .  .
.         .  ..   .. . .  .   .    .   ..     .    .     . . .       .   .       .      ..   .    .      .  .  .      .  .. ..   ... . ....
.. . .    .        .  .    . .      . .  . . .     . ..     .   ..... .   .. .  . .   .  . .       . .. ..  . .       ..  . .    . .      .
.    .  .  .   .   .     .   . ..   ...   .    .    .  .    ...   ....        .. ..    .         ....    ... ... .  . .   .  ..   . . .....
.   .  . .     . . ..  .       .          .           . .   ..       .     .       .             .   .   .     .... .   .  .  .  .    ..  .
..  .   .  ..  .               ..      .   .. .   . .    .  .     ..  .            .       . . .           . .  ..     .    .    . .  .   .
. .     .. . . . .    .  . .. .     ..    .. . .    .  .  .       .. .   .   .    . . .    .. .           ..    . .       . .             .
.       .     . .      .        . . ...         .        .     ..  ..      .    .      ..  . .      .         .        .   .    .  .  . ...
...     .    ..  . .. ..   . .  .      .      . .  .        .  .       . .  ..  .. ..  ....       . ..    . ... .    ....  . .   . .   .. .
.   .    .      ... ..          ..      .  .  .. ..         .               .. ....    . .   ......            .    .... .   ..  ..  .. . .
.      ..       .   ..    ..  .      .   .   ...  .. ..       .    ..  .        ..  ..   ..  . .   ..     ..   .. .. .     .. .. .     .  .
. .  .  .  .   .  ..   ..   .    .      .       .  .   .  .      .    ..  . .  ..   .  .       . .  ..    .     .    . . . .  .  .   .   ..
.  .           ..    ..     .  .   .    .. ..   .    .         .     ...    ..  .. .        .       .   .  . ..   ..          . . . .. . ..
.    .   .  ....     . . .      . .     .          . . .       ..   .        .   .  ..   .  .       .        ....  ...   .  .  .  .     ...
.     . ..    .  .      .. ..        ...  ..   .      ..    ..  .. .      .  .   . .  .. .  ..   ..    ..           ..  .  . .....  .  ....
.   .. .   .  .     . .   .               .  ..  .      . .     . .. .         ..            .   . .      . ..   .  . . .  . .            .
. .. ..     . ..  . . . .   .  .           .   . . .          .    .  . ..    ..         .   . . .   .  .. .    ..    . .    . .       .  .
. . . .        .    ...      .   .      . .        .      ... . .   .   .    .   .          .    . .    .  ..       ...  .          . . . .
..    . . ..    ..   .   .               .   ..  . ..  .   . .. ..   ...    .   .  .  .    .      ..            .     ..  . .  ..   .  .. .
.   .  .  .   .   .. ..  .     ...   . . .    ....    ...  .       . .   .  .     .            .   . . .           .   .  .      .     .  .
. .  .   .     .   .  .  .    .  .   .... .        .          .. . ..  .     .    ..  .     . .        .. ... ..  . . .      .    .   .  ..
..  ...    . ..   . ....   .  .. ..                ... .  .  ..     .        .          .  .  .    .       . .   .   . . ..        .  .....
..  .  .. .. .  . ...    .  .         .   .    ..  ..    . .   . ...    .    . ..   .    ...... .  ..  .          .   . .    .....    . . .
.  ..  ..    ..  .      .              . .  ...  . ..  . ...   . ...      ..  ..  .    ..    . .        .   . . . .   ...  .. . . .  .    .
.... .  .  .   ..  .        .   . ..    .          .     .  ..    .   .  ..    .      ..         ..    . . ..      . ..   ......      .   .
.           .... ..  .     . .  . . . . . .     ..     .      ....    .. .. ... .   ..   .  .    .. ... ..           .         .     .  . .
.    .  ..   .       .      ..   .         .. ... ...   .. .   ...  . ..        .      . ..   .  .   .  ..     .     .        .     .     .
..  . .   .   ...    .   .    . .....   .      .  ..  . ..   .      ...          . .     . .  ...    . . .     ..  . .         .    .     .
..      . ..      ..  .     .       .      . .   . . . . ..     .    .    . .. .    . .. . .. ..     .  . .    . .        .. .         . ..
.  .     . ..     .  .  .      ..   .  ..    .   .    .   ....  ..     .   .        ...       . .     .    ..   ...  .     .   .   .. .   .
. . ..  . ..   .   . .   . ...      .       . .   .      .  .. .    ..    .  .   .      ..      . . . .. .         . ...        .     . . .
.  ..  . .         .  ..  ..... . .  .  .  .  ..    ..   .     . .         ..   ....   .    .....  .  ..  .    .  ... .   .. ....    .    .
.. .....  . ...    . .   .              .   .. .      .  ...  .      .  .. .    ..   ..    .   .  .         .  .         ..   ..      ..  .
.  ..      .    .  . .    . .... .  .         .   .. .    .  ..  . .  . .  .   .. .      ..       . .    .  .. .  . .  ... . .          . .
.     . . .     .  .       .        .      .   . ..    ... . .   ..      .       .. ..  .....  .      .  . . ..      .  . . .        .. . .
..    ..  .. . .  . .  .  . . ..   .        .. .... .         .  .  .. .. .   .   .    . ...  ..        .   . .  . .   .       .    .  . ..
. . ..     .     .   ... ..   .  .     . ..       . .       ... .. .      ...  . .    . .  . .. . .   ...  ..    ..        ...  . .      ..
.   ..   .     .         .    . .    .. ..         . ...         .      ..      .. .      .       .  .. . .  .   .       ..   .  . . . .  .
. .      .   .    . ...  .  .     . .     .    . . .      .    .  ..     ..    . .   .  .  .      ..    .    .  . .       .   .         . .
. .     .       ..   ..   .     . .     .          . ...     .  . .         .    .   .          . . .                 .. .   .      .     .
.  .  .     .     .    .     . . .  .  ...   ..       .   .   .   ...     .  ...   ... .     . .     ... .  .    . .  . ..   .. .    .    .
.        ..      .   ..     .. ..            . ..       . ..     ..   ..    . .... ..  .     .     ..   ..       .  .   .    .. ... ..  . .
.  . . .  . .       ....  .   .  .      .    ... ..    . .  . ..    . ..  .       .  ....  ..  .  ..  ....  .  . ..  . ..  .    . ...     .
. .    .. . .      ...   . .   ..   .    ...           ... . ..   .    .  ....   ....   ..    . ..          . . .      ..  .       .      .
..   .   .. .    .   .   .              .         . . .  .     .  .     .  .. .  .      .      . .  . ..       .. . .. ..     .   .    .  .
..    ..  .  .      ...      .  .  .  .     ... .   ..    .    .  . ... .   ....     ..        ..     .... ....     .  ...   .     . .. ...
... . .    . .    . . .    .. . . .     ..      .  .     . . .        . ..    . ...  ..  .       .               ... ..        .    .. .  .
..          .  .  . .   .. .  .. .  .. . .      .               . .               ..  .      .. ..            .   . .  .  . .     .       .
.  . .     .  ...  . . .      . . .    . ..  .   ..  ...  .    .  .       .  ..   .     ..         . .. .  . .  . . .   ..      .       . .
.         .    .  .         .           ..  .   . ..  ..   .           . .. .   ..   ..  . .   .... .     ...       .     .  .  ..  .  .  .
.   .  ..  . .    . ....  . . . ..     .  . ....     . .        .   ....         .....  .      ....   . . .    .                 .      ...
. .   .   . .  . ...      .       . .         . .. .  .. .   .    . . .    ..        .   .    ..       .   .         . ..   .  .   ..  .  .
.   .  . .        .   ..    .     .      ...  . . .      .   .   ..   .   ..  .   .         .. ..       . .   ...    .       .    .     . .
.     ..    . .    .  ..    .     .       . .. .   .    .. .     .  .   . . .        ...  .  .    . .. ..     ....  . . .   .     .       .
..      .    . .         ... ..  . . . . ..     .       . ...    ..   .    .  .  .  .   .   ..  .. .      . .    .      ..    .   ..  .....
..    ..      .   ...  ...  ...    .  ...         .     ..  .    .   . .    . .  .  .  .              . ..  .  .  .   .    .. ..   .... . .
.    .  ..   . .       .          .        . ..  . .     .    .  .  . ..         .  .   ..   .        .      .    .     .. .  . .         .
.     .        .  .. .      . ....    . .         . ...   .   . .   . .  .    .    .. .  ..   ...     . .  . ...  .   ..     .    . .  .  .
. . ... . . .   .   . .            .      . .. .     .  ....  .       ..    .  ..      .   .   . . .   .   .... .  .    .. . .     ... .  .
. .   . .  . . ..     .    . .    ..  ..  . .   ... . .       ..   .  .  .      ..   .               .    .. . .   .  .   . ..  ...   ... .
. .  .    .   . .. .     .     . . ..  .. .   .     .  . .   . . .  . . .    .      .    . .  .         ... . ..  .. ..     .  ..  .     ..
.  . .     .   .   .         ..    .    .        .  .....    .   .. .. .  .   . ...   .       .      .      .    ......   .          ..   .
. .  .  .   ...   .. .. .       .      .   .. . .      .. . ... .  .. . .    ..  ..           .    ..   .   .     . .    .. ... . . .  .  .
.   . .    ....           ..  ... ..  .   .      ..  . ..   .. .           . ... .  .   ..      ..      .. .       .    .    .    . .     .
..   ...  . .     .    .   ..  . .  .   . .  . ..   ....            .  .      ..  .  .  . ... . .       .  .. .    . ..... .  .    .. .   .
. ..      .   ...  .  ..  .   ....          .  . .      . .. ..  ...  .   .        . .  .   .    .               . .         . .   .     ..
...        .  .  . .    . .  .   .   .    .      .                .  ..     . .    .   .   . .         .                 .  .  .  ..      .
.   .   .  .  .   .       . ... ...    ..     . ... . . ... . ..     ..  . .           .  .  .     ..  . .      .     ... .. ..    . .   ..
. .         .  .    ...   .         .   .... .     . ..  ..   .     .   .. . ...     .   .   . .          .  .      .     .        .  .   .
. .   ..  ..  .  ..    .. . .         ..  ..  .. .    .      .      ..    .     . . . .  .    .. ..      ..         .   .    .   .   .  . .
..  .      . ..    .     ..   .  ..  . ..  . . .   . .     .      .         .    ... .       .    .    .. . .      . .    .   ....  . .  ..
.. .  . . ...        .. .   .     .  ..  ..       . ..  .  .       .        ..  . ..  .  . . . .     . . . .           .     .    .  .. . .
..     .        .     .    . . ..   ...  .   .  . ..  . . ....     . .   .     .  .. .       ..           ..  .  ..         ....    . .   .
..  ..X  . . .       .    . .  ..  ..    .            .. .        . .  .  ...      . .  .      .     .  .     .    ..          .      .   .
.        . .   . .    ..   .            .. .         ..   .     . ..     .  .  ...     .  ..  .       ... .    .   .      .  . . .  ..   ..
.    .      . . .         ..        . .. .... . .       .    .   .   ..         .      . . .    . .    ...  .     .   .   . ..  ..      ...
.  .....    .   .        .      . .  ...     .    . .  ..  . .  . .   .  .   . ..  .  .. .      ..      ...               . . .  ..  . .  .
.     ..  .     .            .  .. . .. .  .    ..        .    .     .        .       .  . .     ...   . ..  .         .  .. .    . . .. ..
..  .      .. .   .        .      .            . . .             . .   . ....             ..  . .     .... . .  ..  .   .     . .   .     .
.  ...    .   . . .  . .     . . .         .     . ..    ...    ...     . . .       .     . ..   ..           .  .   ..  .   .  .  .   .  .
.  .. .  .. .. .  ..  .      .. . .  . .    .      . . ..             . ..  ..           . .  .... .... ...   . ..  .      ....  .     . ..
...  ....    .           . ..  . . ..     .  ...    .             . ... .   .      . .            .      ..    ..    .      .      ...    .
.   .   ..........        ..               ....  .     .      .. .    .     .   .        .     .              .      . . . .    . . .     .
.  .  .   .     . .  .     .  .   ...   .  .. .         . . . ..... .. .    ..  . .        . ..  .     .  . .     ..  .. . ...     ...   ..
.      .  .....        .. ..  . .   .    .  .. .   .      . .  . ..     .   .       . .    .         .       .  .  . r .    . ....       ..
..       ..   . .     ..  . . .    .    ..   .    .   .      . .  .  .       . . .  ..      .          ... . .  .   ....  .  .  . .. .  . .
.    .     ..  .   .   ... .   ..  .  ..    .    .  ..   ..  .  ..  .      .  .. .   .   .   ..  .    . . .  .    .     ...     ...  ..   .
.    .    .    . ...     ..   ...   .        . .  . .     .   .  .  . . .....    .       ...   .     . . ..          .  . ... ..     ..  ..
.  .     ... .  . .  ..  .  ...  .....   .     ..  .  .   ..   . .   .  .           . .  .. . ..   .       . .  ..    .    .. .          ..
.       .  . ..    .  .  .  ... .    ..      . . .. .. .    .      .   ..         .. .   .... ..             ..  .     .    .   . ..      .
.     . .    . .  . .      .       .      .  ..   .      .. . .       . . .    .    .. .   .   .   . ...   .   .  ..      . . .  .  .   ...
.  .  .  . ..       .     ...     ... . . ... .         . .     .          . ..        .  .  .     .  .. . . . . .     .  . ..            .
. ...     ...    .       . . .    ... .  ....   . .. . . .   .  ... ..  .          ....  . ..   ..   .. . ..      .   .  .   .. .. . .  . .
..  ..    .   . ..   ..   . .  . .....  . .    ..   .  .  .  .      .  ..    . .  ..   .    . ..                .    .      ..     .. .   .
.. ... .. .          ... .   ..   .  ...  ...        .  ... .      .      .   . .  .     .    .  .  .    .   .  ..  .. .  . ..   .. . ..  .
.     . .     . .   .   .     . . ..  .   .      .      .   . .  .    .        .    .   .    .      . .   . .    ..  .   ..      .  .    ..
.  .  ...   ...    .    .        .   .. . ...     ...     .  . .   ..   ...  ..  .        .  .    .   . .. ..   .      . .    .    .  . . .
....   .        ...  . .. . ..      .    .      .  .   .    .   .     .   . ..    ... .. .  ...  .... .  ...          .    .  .    . . ....
.  .   .     .        .  .  ..   .    . .. .     . .   ..   ..  . .            .    .. .  .               .      ..      .  .             .
.. . .   .   . . .   .  .       .  .  . ..                 . .             . ..    . .         .. .   ...           ..     ..    .   ..   .
.     .  .   ..       .   ..  .     . .    .       ..  ....   .  ...     .   ..  . .   .. ..  .. . . .       .. .         ....      .   . .
.  .      .  .. .    . .        .   ..      ...   . ..    .  .. ..  . . .  .  ..  ..    ...              .    .  . ..   . .  ..    .      .
..      .....        .   .   ..... . .         .. .   ..    .. ...           . ..   . . ..   ..  .    .    ...        .  .   ...     ...  .
. .     .  . . . .   .  .  .          .. . .  ..     .        ....    ..   .   . .   .       ...           .       .       . .   .   .   ..
. .      .. .. .          .   .   ..       .       .       ..  .. ..  .    . .  . . .  ..  ..     .   .     . ..  .    . .    .   ..  .  ..
..  ...  .     . .  .  . .      .   ..  .   .  .   .    . ..   .    .     . .  . .           .     ..     ..            . ... ...  ....   .
.     .     .  .         .   .          .   .    ..   .  .    .  .   . .  . ... .   ..           .       .  .    ....        ...  .. .  . .
.  . .....     .    .  .  . . .  . .  .   ..  .     .    ...   .     .     . . ..        .       . .....  . . .   ... .    .   .. ..  . . .
.  ..     .  .. .          ...    .  ...  . ...  ..  ..                 .   . .     ...          .      .  .      .     .      .  .      ..
.    ..          .  .   .    ..    ..      . .  .   .  .  .. ..     ..     . . ....  .       .    .       ...  .  .  .      ..            .
. .   . . . .    . .  ..   .        .      ..   .       .   . .  .. ...      . .   .       ..  .  .     .    ....  . .  .    . .. .   .   .
..    . . ..  .  .      .. . ..  ... .  .  .     .       . .        . .     .           .      .. .             .    . . .   ... .  ..  . .
..   . ... .   .     .. .  .  ..  . .. ...  ... . .  . .    .  ..       . . ..             . ..     ...    ... .. .... .    .  . .  .    ..
.    .    .          .          .  ..        . .      . .    . .   ..  .. .  .    .  ...  .  .  .   ..  . .   ..             ...   .      .
...........................................................................................................................................
