.............
. .   .  . ..
.   ...  . ..
.. ... . .  .
.  . . .  . .
..       .  .
.      .  ...
.  . .   .  .
.   .       .
.   .    . ..
.r   ..     .
.     ... X .
.............
