............................................................................................................................................
.  ..     .    ..          ..    .   .   .. ....  .      .    .  .   .   .   ..           . .  . ..     .   . .     .. .. ..      .       ..
.. .  ..    .   .   .  .  .  .....     ... ......     .. .. .   .    . .      .    .   . .   .      ..  .   . .  .    .. .   . .   . .  .  .
. . .. .    .   .. .     . .   .     ... .      .  .  . .        .     . ..          .       ..    ..  ...         . . .... ... .    ...  ..
...       .    ..  ..    .   .   .    . .   ... .  . . . .  ..      . .                 .  . .      . .   .   .  . .   .  . .  . .... .   ..
.  .     ..     .   . .    ..   .  .  ..     ..              .   .  ..  .  .   .  ...    . .   .. .      . .   . .    ..  .      .    . .  .
. .   ..  .             .   .     .     . .      .       .    ...     .   ..... ..   .  ..   .       ..         ..    . ..                ..
..    .   .     .   .          .    .  . .  ... . .  ....        . .    .   .      .     .. ..      ..  .. .    .   ..    ..         ...   .
. .  . .        . .. .  .    . .       .     .  .  .        .   . .       .  . .   . .                 ......            .     .    .      .
..      . ..   .   ..  ...       .     .     . .. .   ..     . .    .   .   ..   . ..   ..  .  . .      .  .   ...      . .    . ..   .  . .
.   . .  .   .  ...      .       .   .            ..      ..     .         ..   .    . .  . .  .  .  .   .   .  . .     .    ..            .
.  .  .  .       .   .   .  .                 ...   .   . . .   .. .     ...    .. .     ..   .     . .   .      . ..   .  .. .. .    .    .
.     ...          .      ..  .     . ..   ..    .  . ..   .. .. .  . .   .  . ..    .     . . ..   ...   .    . .  .     ..   . . .   ... .
.. ..     . ..   .     .   ...  .. ...   .   .  .. .  .    . ..  .   .    . .     .    .. .         .  .  . . .    . .    ..        ...  . .
. .. ..   .   ..   .             .   .    . .   .        .. .  .. .    .  ...     ...      .       ..  .        .....   ...  .     ..     ..
..        .      ..   .. . ..        .  ...    .       .     . .....   .      ..  ..      .....  .    .         .       . .  ....   .. ..  .
.. .      . ..              .  .    . .     ... ..   .  .. . . . . .. ..  .           .  . .    .     . .     ..    . .  .  .     . ...   ..
...           .   . .  . . .  .  .    .....       .  .  . .  ..       .   .     .     .. ....             .. .  . ....      ..      .  . . .
.  . .   .. ..    .            .  ...     . .. . . ..  .  .. . . ..    .  .   .   ...   .      ..  ..  . .   .       .         .       .   .
.  .      .   . . ..  . ....    .  . .   ... ..  .            . .    ..   .   ... . ..    . .   .    .  . . .  ..  .....    . . .  .    .  .
.  .  ..   ..       .  . .        .   .   . . ..  ...   .     .    . .  ...              .   . . .  ...   .       . .  .  .. .  . .    . . .
. . . ..  ..   .   .  .    .. ..  .   .        .. .         .      ..  .     .    ..  .. ..   . . .. ..        . .    .. .    . .  .   .   .
. ..          .         . . ..   . .  ..   ........ .... .   ..    .  .. . .          ...    ..    .. .  . .. .. .         .. .      ..   ..
.. .. ..      .   ..        . .  .          .        .. .   .   .  .    .              . ..               . .    .   .   .     .. .   . . ..
.       .  .. .   ...   .  .          .       .  .    ... . .     .           ..  ...  ...    .    .   .   .            .  .. .  . .  .. ...
.      . .  .  .        .   .        . ..         .       .   . .     .. . ..   .     .    . .. .. .              .       .  ..    ..   . ..
.        .  .        .    . .           ..  .. ....   . ... .  ... . .. .     .    .                .  .    .          .. .        .   .   .
.    .    . . .. .  . .     ..    .         ..   .  .   .    .    . ..    .. ... .... . .    ..    .                   .. . .  .  ....  .  .
.  ..    ....      .   ..   .    .  .    .    . . ..            . . .    . .       .    .. . . .     .  .  .           . .       ..       ..
.     .     .   . .    .  .  ...      .  .. .  .   . .  .    .    .    .      .  .   .        .    . .     . .        .        .    ..  .  .
...  .. .. ..   ...  .          .    .    .         .  . ..  .     . .         .     .        .  ...  .          .     . ..      .     .   .
.  . .   . ..   .  . . .... ..   .   ..   .   . . .  ... .  .   .  ..      . .  .           ...    .          .          .  ..    .     .  .
.   .      ...  .     .    .     .   .. .    . .  . .          ..   .   ...    ..       .        .   . .   ..  .  .  ..   . . .    .  .  . .
.       .    .   .   .      .     .    ..          . ..  ..  .         .. . ...   . .   . ...         .  ..    .  .           ....    ..   .
.       .   . . ..  .   .           ...         .   .     ..  .  .         ...           .         .      . ...    .    ...    ..    .     .
.   .     . .  .       .  .     .  . .   .  ..  ..... ...        .   .                    .    ..  .   ...        ...    ....   .. .  ..   .
. ..   .. .          ..  ..  .    .           ....   .       . . .            .   .  . .       .     ...   . .   ..  .   ....  .  .    .  ..
...  ..  .   .      .     ..  .    .  .    .        . . .           .   .  ..     .. .    .    .. . . . ..      . .  . ... ..   .  .  .  . .
..... .  .   .  .  .. .   .    . . .  ..         .  .        .    .. .  .. ..               .   .         .   . ..     ..             .   ..
.     .    .. ...  .   .. .. ..      ..    .   . .  .       .  .     .. .  .            .   .  .  .   .      .    .   ...    .    .      ...
.   ..      .   .  .   . .   ... .   . ...     .  ...  . ..   ...    .  .    .. . .      .  .  .  .                   .       . ...  .  . ..
.      .        ..     ..  ...   .   ...  .     ..   .          . ..       .     .. .     .  . .         .  .     ...  ..     .  .   .     .
.     ..      .        .    . . ...    ... ...         .. .   .     ..  ..       .      .    .              ..           .      .    . .. ..
. .   .  ..  .  ..  .      ...     .. .     . . . ..  . .   .. ..       .  .  . . . .  .  ..  . .     . .     .                 ..     . . .
.         .  .      .  .  .             .  .  .. . .        ..   .   .  . . .  ... ..   .           .       .    .  .  .  .  .   . . .  .  .
.       .     . . .      .    .   .  .  .....  . . .   ..    ..    ..  .     ..  ..   .   .  .   . . . .  ..   . .   . ... . .  .  .       .
.      .    ..       . ..       ..      .    ..  . . ..         .  ...  .        .    .  .  . . .   ..   . .  . .    .    ... .      . .  ..
.  .    .        .     . .   . .           . ..    ..          . .  ...  .  ..   .  .     .     .. .    .  ..       .  .  .      . .   ..  .
.  ..    .      .  . .. .  .       .   .        . .     ....    ... .   .  .        .   . .    .           ..   .    .. .  . ... . .     . .
.  . . ..  .    ..         .   . ... .     .  .  .   .  ...   .....  .         .    ..       .    .    . .   . . .. . . .        .  ...   ..
. . ..             . . .    .      .  ..  .    ..      . .  .. .  ..  .. .  ..   ..  . ... ..          .  .    .. .. .            .      ...
. .  .            .         .  .   ..     .  .. .      ...     . . ..  ..      . .    . .  . .  ..        . .    . .   ..           .  . . .
.   . . .  . .   .    . . . .   ..  .    .  ..  ..      .   .  ..  .. ....  .        .  . .     . .. .  . .       . .. .        .... . ..  .
.     . .      .   .  .  .      . ... .  ...          ..         .       . . ....   .       ..    .    .    ..   .... . ...     . .. ...  ..
..  .....  .     .   .       ..  .     .     .   .  .      . .   .  .  .    . ..  .    . . ...     .   .            .  ... .   .     .  .  .
.  .....  ..     . .. . .  ... .. ..    .. ..  .... .  ..   .       .     ......           ... .. .  .  .     .   .  .  .. .       . . .. ..
..       .   .        ...        . . .   .   ..   . .  .. ..     .  .      .   .    .....              .      ... .      .  ..   .    ... ..
.    .  . .  .  .             .       .       .. .. .   ..     .      ..  ... .. . ..    . .    .          ..        .    .  .     . ..    .
..    . .   .     ...   .       .. .  .    ....     .   . ..  . . ..X     . ..        ..     ..   .     .  ..      . .   . .   ...      .  .
. ..     ..     .  . . ...    .  .....    . .. .  .. . .   . ..     .   . ...   ...  ... . .  .   .    .   .   .     . . . .   .   .       .
..  .  .    . .   .. .    .    ..    .   .  ..   .. ...     . . ..   .. .        .   .  . . . . . ..        .  .  . .  .. .   . .    .  .  .
.  .. .   .. ..   . . ..     ..   .   .  ...  . .  .  .  . ..    .   .     . .   ... .   . .      ....   .   .    .. .          ....  .. ...
..      .       . .   ... .   .    . ..  .            . .     ..    .      ... ..    .  .    .    ...   .  . . ..  . .   ..    ..    .    ..
.   .. ...             . . .   .  .   . .  .     ..     .   . . .... .     ...    .    ..     ..     . .             . .     .      .. .. ..
. .       .   . ....    .  . .  ..   .  .. .. ...     . . . . .   ..  .  .    .  ..    .. . .  .. ..  .   ..    ..   .         . .     ..  .
.     .  ..    .  .  . . . .  .. .     ...   .   ...     .. .   .  .     . . .  ..   .   .  .. .     .        .      .      .   .   .      .
. .  ... .   .    . .     . ..   . .  ..   .  . . ....  . .   .  ..    . .. .      .       .   ...        .       . ..  .  .  .   .. .    ..
. . ...   . .. .  . .     ...    ...  . .   .              .  ... .        .. .    .     . .    .   ..     ..  ... .     .        . .   . ..
.           .    .. .  .     . ..   .. . .  .  ...  . .  .     .         ..  .      ...    .  .. ..        . .  ...  .     . .     .....  ..
.     ..  .       .  .. .     . . .    .       .     .      .      . . .     .. .  .    .  .. .   . ..   .  . .  .     .  .     .    .   . .
..     ...      . .   ...       . .  . .     .   .    ...     .   .     . .    ..  .       ......  ..     .     .   ..   ....  .   ..      .
.  . ..      .  .   .    .     . .  ..  .   .     .    . ...  ...          .    .    .  .      ...     .      . ....  .     . .    ...  .  .
.     .   . ...... .      . . .     ...  .  .  ...     ...   ... .    .  . ..    ...    ...   .  . . .  .. ..  ..   .    .   . .           .
..  . ..   .... .. . .   .. .    .  ..   . .    .     .  .    . . ... .         . ...                         .    .  .    .  .      . .   .
..    .       . . .      .         .   .    . ...  . ..    .              .     .    .    .  . . ..  .         .    .    . ..  ...   .     .
.     .   ....  .     . ..  .      .  . .   ..  . .. ..     . ..    .  .       . . .        .    .    .   . .   .  ..  ..  .. .           ..
.      .  . ..... .       . . .  .         ... . ..   ...         .  .     . ..    . ..   .   .  .     ..    ....          .     ...       .
...   .  . ..   .          .     . .. ..     ..     ..        ..         ..          .   . .  .   .. .. .      .    .  .       ..     . .  .
.      ... .. .  . .    . . .  ..  .        .  ..  .  . .  .    .    .   . .        .  .   . . .  .   . . .  ..    ..  ...... .      . .  ..
.    .            . .. .  ..  .  .    .   . ..  ....      .  .    ...    .  .  ..  .  .         ..    .   ..  .    ..  .        .        . .
.   ...                   ..   .        .  . .    . .   ..   . ...        . . ..        .. .. . .  .  ..  .   . ..  .  .  .  .  . .     .. .
.   .      . ... . .   ... .    . . .    . .    .  .    ... ..     .           .   . .      .  .    ...  .     .    . ...   .    ..       ..
. ..  ..  ..    . .  ...  ..        .. . ..          ...    .        .. .       .           .     . .  . .      .  .       ..  . .     . . .
. . .                  .  .   .  ..            ..       .   . .   .        .   . .      .       .      . .  . .  .       . . ...    .. .  ..
.  . .. . ..    .. . . ....   .  ...    . .  . .    .. ..   .    ..  . ..  ...     ..    .   .     .  .    . .    .    ..  .               .
..  .  .      . .  .     . . .     .   ...        ..      .  ...        .  .   .       .      .  .  .   . .        .   . .      . .  .    ..
.        .  ... .    .        . . .    .. . . . .     .      .  ...  .  ... . ..  .  .   .   .. ..  ..        .   ...       .   ....   . . .
. . .  .      .. .  .       ..     ..    .            .         .   ..  ... ...      . ...     .    .  .     .                             .
..     .. .    . .      .    .    .  . ... .  . .  . .  .  .    .    ...  .  .  .      . ...  ...      .  . .  ..       .    ..  . .. .   ..
.        .     ..         .        ..   .   ..  .     .  . . .. .  . . .   ..     .   . ..  . ...   ... . .  .  .  .  .  .  .   . .      ...
. .   .   .  .   .      . .  .         .   .  .    .. .   .   .      .    .   . .  .   ..    . .           .  . ..r .            .  ..   . .
.     . .  ...      ..   ...     .   .  .  .  .     .      ..   .      ..        . .     .      . .    ..   ..      .. .   ... . ...      ..
.   ..      .. ..        ...       .       . .   . ...    . . .   . ... . .    .  ..    .  . ..     ....   . . .     ...     .   ..       ..
.   . .  ...    .  ...       ...  ..  ..          .   ...       . ..         . .    . .    ...   ..    .     .  . . .  .   ..   ..         .
. ...       ...   . ...    .  .  ..  .  .        .       .   .   . .    . .   .. .  .   . ..    ..    . ..   .  . .   .   . ..           . .
.     .   ... . .       .     .   .  .    .    ...   .   ..  .  .     .  .. ..      ...      .. .    ..    .  . ...   . .   .              .
..  .....  .  . . .. . .   .  .  .  .  .. ..  . .    .    ..   ...     .  .    .   ... ...        . ..    ...   .    .  . ..   .           .
. ...    .        .. ...    . .. . ..   .  .   .   ..        . .. ..    .   .  . .   ...   . .. . .  . .     ..  .    ..  .. .. ..     ..  .
.  .     ..  .    .   .   .          .        .  .  .    .     .  . .   ..   . . .. . .  .....     .  . ... . .  .  .  ...               . .
.     .  . .   .  ... .... . ..   . .    . ..   ....   .    .      .  .  .   .  . . .        . .     .  .         .        .      ... .    .
... .       ..... ... .           .   .      .   .  .  ... .  .   .   .        .  .    . . ..    ....      .   .        ..  .  . .       . .
.    .    .     . .        ......   .                  .. .  .    .      .   . ...    ..   . ..   ..  .            .  .     ..   ...     . .
.. .   . . .     .    .    .        .. .  ..      . .. .  .   . .   .  ....    .... .       . . .       .  .    .    .. ..    .            .
..   ..     .. .   . . ..     .         .        . .   .  . .  .  . .  ..  .   .      .    .. .  . ... . . .     .  .    .  .    .      .  .
..        .   . .       . .. .       .     ..  .  ..     ..    .   ..     .      .. .  . .      .  ..   . .  .   . .    .    ..      .     .
.  ..     ..  .. .     .   .   .   ..  ..      .      . ..  .         .    .  ..      ..  .   ...       . .     .       .       .  .. .  . .
. .   .. .. ....     .  .    .      .    .     .   . .   ..  . . .      ...       .   .  ..  ..  .       .  .    .  .  . .    .   .. .    ..
. .              .  ...           ..         ...   .  .      .   . . . .      ... .      .. . ...      .  .   . .     . .   . . . . .     ..
. ....  .  ..        . ..   . .         .    .          .         ... .  ...   .          .  .  .   .    ..    .         ..  .       . .. ..
... ..   ..   .       . ..   .      .. . ..     .. . . .      .   .   .    ..  . . ..  .   ..  .   . ...   . .. .. . . .. .    .  .  .     .
.           . .       . ..  .  .   . .   ..  ..    .        .    .        . .      .       ..  .     .     ...   .    .      .     .     ...
.  ..       . .    ...        ...  .  ....   .       .   .      ..   .   .          . .   ..  .     .    .  .. ..  .      .    .  . ..  .  .
.   . . . .      .           . .    .     .. . .    . ...      . .    .         ...      ... . .... .     .   .       ... . .    .... .  . .
. .    . ..   .       .     .. .    . .   ..    .     .  .  .  ..   .        .       ..    ...  ...          .    .      . .    .    .. .  .
.  .  .  ..   . .  ..          .   . .     .  .  . ..       .... . .  ..   . ..   .. ..   .      .  .  ..  ..    .     ..   ..         . . .
..      .   .            .   ..      .     .. .       ..        ...           ..  .  ....   . .   . .. .       ..  .....      .    ..      .
.   .        . .. . ...    .     . . . .. .  ...   .    .    .   .   .   .. .  .  ..          .. .             . . ... ..     ... .. . .  ..
.. ... . . .   .  . .... . .  ..   . ..     .  ..  . .  . .   .   . ..     .. .      .    .   .   . . ..          .  . ...    ..     . ..  .
.              .    ..        .     .   ..      .. ...    .  .  .   . ..        .     .  . .     . .  . ..  . . . .  . .      . .. ..  . ...
.  ..  . .  . . .  ... .      .       . ...    ..  . .   .    ....             ..     .. ..  ... .   ..   .   . .    . . . . .   . . ..    .
.    .  ... .   .      ..        . .   ...   .   . .          .   .      . .  ...    .      .    ..         .   . ..   .      ....  . . . ..
. . ...    ..  .    .  ...      .       .  .  .        .           .  .    .  . .   ..  . ..  .         .   .    .   .         .   ...   ...
.  .    ....         .  . . .    .         .  . .   .  .         ..       .. .   . . .     .  . ...   . . .. ... ... .   .    . ....  .    .
.  .    .. .      . ..  .  ..   ..        ..      . .. .   .  .      .  . . .  .   .      ..  .       . . .   ...   .  . .     .. ..    . ..
. . ..       ....   ..   ..    .       .   .      ..  ....  .    .       .     . ..   . ...     ...    .               .   .....    .  ..  .
. .      .   .. .     .   ..    .         .  .    ..     .  .  .           .   .      .   .      .  .     .    .    ..     .. .  . .... .  .
...   .  ..    .   .   .     .  . . ...                                .  . . .   .            .  ..  . .   ..         .  . .   .    .     .
.    .   . ... .. .  .  .  . ....    . .      .     .        .   .. ...    . .    ..    .   .     .       . ..      . .         .   .    . .
.  .  ..    ..   .       ..   .     .  .    .. . ...   .      .   . . . .         .     .   .    .  .         .   ..    .    ...          ..
.....  ..   . .    .  . ..    .    .    ..  . .   .              . .  .   .  ..... . ..    .   .  .   . .    .  ..  ...  ..  .      .   ....
.   . .  .        .   .   .          . . .         .     .      .     .    ..      .    ... ..  ..        .     . ..   ..       . ..    .. .
.        . .  . . .... .             . .    .   ...     . . .    .  .    .         .  .      .   .  .      .   ..          .. . . .  . .  ..
.  .   .. .     ..      ...      ..     .      . .. .  .... ..  .  .      .   .  .  ...       .  .  .    ..       .   .    . .   .   . .   .
..  .   ..     .          .      . .     . .  .   . . .       .. . .   .   .  .. . .. .. . .. . ....        ...    ..     . . .   .   .   ..
.       .  .   ..  ...   ...   ...  .   .  .  . .  .   .              .      ..  ..... .  .   .  ....     .   .         .  .  .  . . . .   .
.       . .. ... .    .   .     .. .. .    . .  ..                . .  . .  ...  ..         .  .    .  .. .  . . .  .      . .. ... ..     .
. .   . .   . .. .    ..  ...  . .           .        ..   .       . .   ...        .  .       ..  .     .   .  ... .... ..   .   .   ...  .
.    .     .. . .   . .  .  .          ..    .      .. ... .    .  .      .   .        .  .. .    .   .   . ...        . . .    .        . .
.  .. .  .  .   .. ..    ..     ..   .. ..  ..   .  .     . ..      .   .  .   .      ..  .   .  .        . ..   .     ..       . . .  ..  .
............................................................................................................................................
