.............................................................................................................................................
.  .    .   .  .  .    .  .   .  .  .  .         .    .           .    ..         ..    .  ..   ... .    .    .      .  .        . ..   . ...
.   . .   ..       .   ...    ..         .     .     ....       .  . .            .    . .          . . .     .   ..  ..         ..  .   . ..
..     . ...  .   . .  ..    . . .  . ..  . .      .  ..     .    ...        ..... .   . ...  ... .    ..    .      . .  .        . .       .
.      . ..   . .   . .     ..  .    ...    .. .. .   ...  .      .             .  .  .  ... .  ..    .     .  .   ..    . .  .. .   . ..   .
.....     .      ..   .      . .     . ..  .  .   .  .  . .    .  . .       .   ..  ..         .   ..   ....  .  . .            .  .    .. ..
.      . .  ..    .  ..  .        .     .    .    .         ..   .    ...      . . .     .       . .. ... .       .  .   . . .   ..  .    ...
..  .    ..  .. . .. .  ..    . .... .  ... .  .        ..   ..  .. ...    .  .  ....  .      . .   .  . .     .  .  . ....  .. .   .........
.       ...   .    .   .      . ...    .. .    . .  .  . ..  . .   . .   . .         . .. .    .. .  .   ..      ..    . .. .       .. .    .
..       . .        ...  ..   .   .  .  ..  . .      . . ..  ..     ..       ...  ..    .    . . . ..       .  . .  .  .  .  ..   ..        .
.   .  ..  .         . .  . .   . ..    .  ...   .      .           .   .  . . .   .. ... .   .   . ..  .   .  .    .   .  . . . . ..      ..
..... .. .   .    .. . . .  . ..    .   .... .    ..  . .        .  .  .    .       ...  .          .             .      .          ..  .   .
.  . .  .  .            ...  .       .    . ....    ... .    .      .    .    .  . . .      ..  .    .   .  .  .     .       .   .        . .
.   .     . .  .        .  . .     ..   .  ..         ..      .    . . .      ...   ..    . . ...                     . .     ..    . .  .  .
..   .        .       .  . .  .     ..       .    .    .  . .. .            .    .       .   .. . .     .  . .     .        . .    ..       .
.    .. . ..     ..     ..   .....  ..     . . ..       .   .         .  . .  .   .. .    .      ..    .     ... .  ..   .  ...    . .    . .
..    . . .    ..  .  .   ...   .   ..  ... . . .  .  . .      .   .   .. .     .    ..  ..  .    .         .  ..   .   . ...   ..  ..  ... .
..  ..  .   . .  ...     .  ... ...  .  .      .   .   . ... .           .    . .   ..  . .       ... .   .         .     ...  ..           .
.   .. .  ..      .   ..   ..    . . .        .      .     .. .   ...       .   . .           .  .  .  .    ..    .   .     .    ...  .  .  .
.     ...    .   .   . .  .. . .    . ..    .    . .        ... . .         .   .           . .     .          ..      .  .    . .          .
..     ..   ..       .       . ..     . . .    ..        . .      . .  .    ..  .  ..   .   .  .      ....             . ...   .           ..
..      .    .. .. ....  ..  .     . .  .. ..      .   .  .  ....        .. ..      . .. . .. ..   .  ....   .  .  .    . . ...      .  .   .
... . ..   .  .  .. . .   . .          .           .  .. ..  .   .    .   .     .. ..       .. .   . .. .   ......       .   . .  . . ...   .
.   ....    . .   ..  .    ..         ..            ...         .   .   .    .           ...  .    .   .   . .    ..  .    .  . .  .  .     .
.     .    .   .    . .       ..  .  ..     .     .    . . .... ..      .         ..  .  .   . . .  .     .. .... ..  . . ..       .  .     .
. .      .     . ......... ...    . . .  .   ..       .... . ..  . ..    ...  ...      . .     .. . ..  . . .       .      ..  ..  ..   .   .
.    . .....  .  ...      .           .     .. . . .   .  .   .. .  .   .  . .  . ..    .      .      .    ..  . ..    ..   . . .  .  .   . .
. .  .          .  ..   .   ..   . . ..  .  .     .   . . .   .. . .   ..    . .  ... .         .    .     .  . X  .     .   .       .    . .
. ..         ..  ..    .    .   . .  .   . ...  .    .  .  ...    . ..  .    .   ..........        . .     . . .  .    .. .        .    .   .
.    .          .   .   .                 .     . . .  .   .  . . .   ..     .               . .      .. .   .         .  .   .  . .  ..    .
.  . ..   . .  . ..   .   .   ..           . .       .        .            .    .. . .  . .    ..  .   ...  .. .          ..   .    . ..    .
. .   .      ...  .. . .   . . .          ..  . .. .   .   .. ...     .     . .. .  .   . . .   . .    ..       .  .   ...        .  . . .  .
....      .           . ..     ..    .       ..   ..      .   .... .  .    .. . .  .       .. . . ... ....       .     ... .     ....   ..  .
. .  .      .     .  .   .   . .     . .      .     ..  ..   .              ..   . .   .   ... . .    .  .    .         . . .     ..  . .   .
.   .          .     ...  .    . .   ... .       ...    . .   .   .  .     . .. .            .  .  . ..   .. .  ...  .     ......  .     ....
..        .. .   ..    . .   .     .           . .   .   .. .. .              .   . ... . .  . ..  .   .   ...  .         . .    .. .. . .  .
. .    ..         ..    .    ..  .  ..       .   . . .  .  . .   .  .    .     .           ....        .    .    .       . .   ...   .  .   .
.  ..  .       .  .  ... ..   ..     .  ..  .    .  . .. . .        .   .                 ... .     ..       .       . .  .      .    . . . .
.. .   .  .. . ...    . . .  .   .  . ..   . .      ... ..           .     . . . .    .  .     .  .   .      .  .        .       .   .  .   .
. ..  .. .     .              .  .  . .   .  ...            .. .     . .      . .. .       . .         ..           ....   .      .. .      .
...  .   .       .... .  .  .   .   .      . .      .   ...   ...      .       .                . ..     ....  .  .           . ..      .   .
.    ..  .  .   .    . ...  .  .     .  .    .  ..  .  .  .      .           .. .. ..   ..... ..        .     ..   .. . .. .   ..   ...    ..
. .          .    .         .....   ...     .    . .       .     .  .      .   ....        .  .  . .  ..  ..    .  ...   . . ....  .        .
.   .     ...   .. .  .. .      ...       .    ...  ..   ... ..    .          .    .  . . .            .  .  .       .          ..     .   ..
.            ..     . .  ..      .     .  . ..      . .. ..  .     .      .      .     .        .       .      .      .   . .     ..    .. ..
. .   ..        ..    ..      .       ..  .....     ...  . ... .  .   . ....      . . .. .      ..  ..    . ..   ...  .   .      .     .   ..
..   ..     . .      .    .      .. .   ..          ...   .. ..          .   .     .  .   .   .  ....    .  .   . ...     ...               .
. .  .      . . ..          .  .  .  . . . . . .... .      ..  .   .. ...  .       .     .    .       ..  ..  .         .  ..    .. .    . ..
. . .  .      ...  . ..       .      .    .   .   .     .  ..  . ..  .   .  . .         .     .   . . .  . . ..  .. .   .     .. .....     ..
.       . . ..   .  ..     ......         . . .    .  . . . ....      ...  . ..     ...  ... ...  .  . . .       .  .. . ...   .. . . . .  ..
.. .  .. .......     .. ...    .          .. .      ..         ... . .    .  . .   .  .    .. . .  .. .    .  .   . .       . . .     ..    .
.      .           .  ..    . .  .  ..  .   ...  .      . . . . . ..  .  . .   .  .  .   .  .  .   .. . .    ... .... . .   . .   ..     .  .
.   . .   . .. ..  .     . . ..    .   ..   .  ..     .  .              . .     ..     .  . . .              .        . . . .   .   .  ..   .
.     .    .   ...  .  ..  .  .  ..        .  ...    .  .    ..       .       . .. .    . . .. ..      .    .  ..   .    .     . . . ..  .. .
.. .   .    .   .      .   .  .  . .          ... . . .  ..      .          .   ...     .    ..   .  .   .    .      .   .   .  . .. . .  . .
. .   ...     .       .         .  ..      .  . .     .   ...     . ...   . .   .      . .. .  ..        .    .  .          .  .    .   ..  .
..     .  .  .  .  .   .         .. ...   .. . .   . . .            ...... .   .  .  .. ...   ...     ..   .    ..      . .  .   .   .... . .
.   ...  . .   .  .   . .  . .    .   .  .    . .  .  ..   .   .           . .  .... .  ..    .    . ....             .  .   ..   .  .  .   .
. .. . .    .    .. .     .  .             .     ... ..      .                  .. ..    .  .    .    ...   ... .. ..         ..    .     . .
...  .....  .    .  . .   .. .. .            ..    .  .. .        .  .       .          ....   .      .     ....  ....       .    .     .  ..
. .       . ...   .   .   .  ..     .     ..    .     .   .       .    .  .                  .     . . . .  .          .   ..  ...    .   ...
. .  .  .     .  ..          . .    . .       .        .   .   .         ..         .    . .   ..  .   .     .  ... .  .   .  ..    .   .   .
.  .. .   . .   .. .. .      ..  ..    .. .         . .    ..       .   .    .  . .. . .. .. .  ..     .   .  .  .         ... . .     .. . .
..  . ...  ..          .. .  .     . ..   ..  .   . .    ..     .. .  ..... . ..  .    . . .           .             .        . .  ...  . ...
.      .  .        .   . ....        ...    ... .         ..     .  .     ..  .  . .     . ....   .. .    .      . . .        .   .   .     .
. .   .     . .   ..  .    . .       .     .       ... .       . . .   .   .     ..    . .             .     ..   ...    .. ..  .   ..   . ..
.  ...  .     ..             . ..   .     .  .     . . ..      .     .   ...      . .  .    .     . .....           ..     ....  ....    . ..
.   . ..  .  .  .    .   .        .   .    .       . . .      ..   . ..       .      ..   .. .     .  .       . . .    . ..  .  ..      . . .
...  . .  .. .   . ..  ...     . .. . .  .     .  .      .   ..    . ..  ...      ..     . .        ..  .       .  ..   .   .. .  .         .
... ..            . .  ... ..  .    .   .   ..  .  .. ... .                .      .             ..      ..    ...     .                    ..
.     .  .      . ..  .  .        . .......   ..  .. ..    ...   ..    . . .   ..      . .   ... .. .  .. .  .  ... ..   . .  .. . ..       .
.  ..    .   . .  ..   .   . . ..  .    .. .  .         .   .  .    .  . .. .  .   .   ...   ..      .    . ..  .      ..       .    ...  . .
.   .     . ..   .   ...  ..    .    ...  .  . .     ..   .    . ...    .      ..   ...   .        ..  .. .        . .    .. .   .     . .  .
. . .     .  . . .   . .    .        . .  .  .        . .     .   ..   .  .        ..  ...  .          .. .       .         ..  ..    .     .
...  .. .    ..    . .  . . .    ... .....       .  ..    . . . .    . . .. ..  .  . .      .      . ..  .   ..  ..  .      .   .. ....  ....
.             ..    .    . .  ..   .    .             .   .  ..     . .          . ..      .         .      .  .   .  ..    ...  ..   .  .. .
.. .   .      .  . .  .    .     ....  .    ..   .  .          .       .  .     ..   .      .   ..          ...  .         .   .. .. .   .  .
.  .      .. .        ..       .    .    .       ..       ...    .    .     .. .  .     .  .    .. ..    .   . . .. .. . .    .. .   .  . . .
.. .   .      .   . .       ..   .     . . . .  .  .  .... ..  ..  .             .     .    . .  .    . .. .  . ....   ..           .     . .
.   . ....       ..  .      .  .    .  ...  ..     .  . ..         .   . . .  ..  .  .   ...      .   .               .   . .  ..   .  .    .
.  .   . .  . .   .     .   .  . . . ..   .     ....  ...     .   ...  . .      ..  .     .  .           .      .      .      ..  .  ..    ..
. . . .. .   .   .. .  .  ..          .   . .. .    .      .   ..        .     .   ..   .  . ..        .. ..   .  .   ..  .  ..    . .     ..
.     ..  ..   .     .  .     .. .     ..   .  ..    . ..  .  .  .  ...      .   .   .  ...   .     .  .       .. .      .     ..           .
..     .    .              . .   .  .    .    . .      . .   .    .. .    . .   ..    .   .. . .      .  ...   .   .    ....      ...     . .
. . .    .   .     . .  ..        .       .  ..  .  ..      .      .. .     .            .  . .   . . ..   .     . .. .  .. .   ...    . .. .
.   ..   .. ..  . . .       .. . .      .   . .   .  .    .        .   .  .   .      .   .      . .. ..  . .                .     .         .
.       .          .  . .  .              .  . .  . .. ..       .  .. .         . .    ..   .   .   .        .   . .. ..  .    .            .
..     .       .        .. .    ...  .         . . .      .  ..   . .       .      .  .... .               .. . .  .    . ..  . .. ..  . .  .
.         .    .  ..  ..   ..    . .     .    .      .  ... . .  . .  ..  .. . .     . .   . .  .          ..  .   .   ...     . ..   .     .
. . .  .   .       . .. .  ... ..      .    .       .    ... ...    .  .  .   ....       ..   ..    .        ..  .         .      .   .  .. .
...     ... ..  .      ..         ..  ...   ..      ...                 .        .. .   . . .  .    ..     .     .. ..  .   .   ...  .  .   .
. .  . .  . .       . . ...    .      ..     ..   ..     .      ...   .  .     ...   .. .    ...      .          .. .  .        .   ...  .  .
. . ... .   .        .   . .. .. . .           .      ... .      . . .   . . ....   ..    . .   .    .  . .. .  .  .  . .        .          .
..  ..  .    . .      .   ..    . .  .  . .  .... .         ..    ... . .         .   .      .   .  .     .   ...  .     ..  .      ..    . .
.. .      . .   ..          .    ... . .  ....          . ..    . .     .. ...  . .      .   .   .   . .  ..  ..  .           .   .       ...
...         .  .  .  ...   . .  . .     .       .   .. .  ...    .    . .. ..  .     . . . ..               .  .  . .  . .  .  . .          .
. .   . ...  ... .  ....   .. .      ...   .. .       .     .  ..     . .  . ..    .   .. ..    .    .   . . .  ....  .   ..    .  .. . . . .
..   .. .    .   .    .  .  . .  ..     ..  ......      ..   . .       .     ..     .  ..   ..        .. .   . .   .  .  .   .     .  .     .
. ..   .. ..              .   .  .  .. .       ..   .         . .        .          .. . . .  .       ..     .  .    .  .. ...  . . .  .   ..
. . . . .       .     .   .. .   .    ...      ..     . ...  .   ... .  . .      .  .   .  . ..     .   .     ..       ...      .  ..  .  ...
..  .. .  .     .      .  .  . .  .      .  . .  .    .     .           . .  .  .        .     ..             . .              . . .. ..    .
. .            .    .. . .  .. .   . ..      .           .     ...        .  ..  . .    . ... .  .  ...    . .        . .... . .     .      .
. .. . . .    .  ... ...  ..  .  ...  ..   .. .   ..  .  .     .   .          . ...  . .         . .   ... .. .         .    .              .
.        .       . .. ..  .        .  .   . ..          .   .     .  . . ...     .. .    ..    . . ..       .  ...  .  .   . .   .. .    .  .
.   .   .. ..   .  .  .    . .     . ..  . .  ... . .     . . . . ..     ... .    .   .        .  .     .  . .    .  .   . ... ....   .     .
.... ..    . .            ..  ..  . .. . . .   .  .    ..  .       .        .  ..    ...       ..  .    .. ...  ..  ..   ..   . . . .   .   .
.     .   .        . .     . . .          .      .       .  ..     .   .      . . .     .. ... . ..          . . .    ..  ... . .    .    ...
..      . ..   .   . . . .    .       ..  ..  ..  .... .   ....    ..  ... . . ...    . .      ..  . . ..   .  . .        .     .        .  .
.     . . . ..      .. . .. .  .   .   ...      . .    .  .    .     .     . ..  . ..   ...             . .   .    . .    .  .. . .  ...  ...
.   .. . ..         ..    ..  . .   ..  .  . .  .      .. .          ..   ..       . . .. ..     .    .   .    ..     ..      .         . ...
. . .  . .  ..   ..     .  .         . . .       .   . ...       .     ...     .        .    .             .     . ...  .       . ..       ..
. .     ..  .       ...    ..  .    .       .    ..   .  .   .     .. ... .       .   .. . ..   .    .   .  . .     .  ..  ..  .       .   ..
.  ..   .   ..   .    .  ..   .      ... .     ..  . .  .     .  .      .            .     .  ..      .   . .   .. ..   .    .      .  .. . .
..  .  ..   .   ..   . .    .  .  ..     .. .. .     ..          .    .  ......           . . .   .     . .       . .  .    .. .  ..        .
..  . .   . ..  . ...  ....        .  . . . .  .  .    ..       .  .. ..    .  . .       ....  .  ..    .       .   .   .   .          .   ..
.. .   ..  .   .   .       .  .    ....          .  .   .        .  .     . .... ..       .  .    .                .  .   .  ..  .   . ..   .
.. .  . .  .  .   . . .   .   .   .      .   .       .  . ...   ..  .          .    .   .       .      . .  . .  . . .         ..     ...   .
..     ..    ..    .. .   .. .      . .       .   ..   .  ..   . .     ..     .    ...   .    .  .. .    . .   .   .  .  ..      .  .. .   ..
.        .  .    ...   . ..         . .  .     ...        ..  .  ..  ..   .  ...... .  ...           ..     . .  .    .  .. ...    ....   . .
.  ..    .   . .      .    .    .      .     ..   .       ..       .   .      . . . ....        .   .     .    ..  . .     ..       . . ..  .
.     .    .  .    . .  .  .    .      .   . .                        . .        . . ..   .     ... .        ..        ...    ... . . .   ...
.       ..  .  .         .     .. .         ..     .. .        .  .   . ..    ..  .   ..   .  .     .      .. ........ . . .    . .    . .  .
... ..   . .   .       .. .       .  ...        ....   .. .    . .    . .    . .  .     . . .      r .   .   .  .   .     .        .   .   ..
.                  .    .     .    .    ..        .        .   . .   .   .     . .    .  .   .  . . .    ..   .         ... . ..   . .     ..
..        . . . .  .    . .      .      ... . .    .  .  . . .   .      .. .  .  . .   .     . ....  .  .           ..   . ..   .   .  ..   .
. .    .. .....  .   .   .     . ...  ...       .  .      .  . .    ..     .... .   . . .      . . .           .. .   .. .  ...          .. .
..     . .  .  ..  ..   .  .  .  ... . .     .   .      .             .     . .    .  .    .. .    . .     .   .  ...  . .     .           ..
.  .  ..  .   .  .   .     .. .   .   .      ... .             .  .  ..  . .   .     .  .. . .   .  . . .    ..     .  . ..    .   .    . . .
..        ..   ..     ..  .         . .     .  .      .    . ... .  . ..      .. ..     .. . .  . ... . . ..    .      .     .    .  .     ..
.  .. .. .     ...  .     .    .    .   .  . .     .     .  . .       . .  .     ... . . .  . ...  . .     . .  .   .      . .. . .. ..     .
. .       ..  .  .. . .. .    .    ..     .  . ..   ..           ..  .  .          . .    . ..  ..      .   . .   . ..  .     .  .     . . ..
.  .. . .       ....    ..       .  ..  .        .    .. . .    ..  .  .    .   .       . .  .      .    .     ..  ....      . . .     .    .
.. .    .. .    .    ..  .  .  . ..  . .     .. . ..   .  ..       .     .     ..       .  .   . .  .... . .    ..  . ... .  ...  .   .   . .
. .     . .       .. . ...      .           .    .. .        .   .  .       .      .  . ..    .    .  ..  .  ... .. . .    .   ...     .  ...
..        .  ...   .         ...     .  .     .   .. .   .   . . ..         .           ......   . .   . .   .       .. . ..   ...       .  .
.       .  . .   .. . ..  .      .  ..    ..    .  .   .. .    .  . . . . .     .   . .   ..     .       .         .....  ..     .  . .    ..
. ..  .  . . .    .  . .  .          ..          .    .       . .   ..     ..    .   .  . . ..  ..   .   ......  .        ...   .   . .  . ..
.    .    .   .     ..  .     .  .   . .  .   .  .   .  .  . .   .  ..                  . .  ...      .          . ..  .  . ...    .    . . .
.      ..        .  . ..  ..   . .      .                .  .    .  .. ..  ..    ..... .          . .    ....    .. . ....     .  .  .   .  .
. ..   .   . .     .      . . .      . . .           .....       .        .          ...  .    .             .. . .   .         .. . .  . . .
.............................................................................................................................................
