..............................................................................................................................................
.. .        .  .  ..  .   ..  .  .    . . .  .        .         ..    .   .   ...   .   ..  .     . ....  ....         ..   . .  .   .   .  ..
.       .        . .            . .     ..   ..   ..  .  .    .  ... .  . ...    ..  . . .        ...  .         .    ..     .      .       ..
.. .          ...  .. .   .  .   .    .... .   . . .   .    .. ..    .    . ... .      .  . .     .  .     . ..  .   .  ... ...  .       .. ..
..  ... .    .     .  .. .. ...     ....   .    .   .  ..              .  .  .   ....  .   . .  . ..          .  ..     ..      ..  ...     ..
. . ..   .    .     ..  .           . ...          . ...     .. .  ...  ..  .    . .        ..   . ..  . .    . .    .        .      .    .  .
.    .       ...    ..      .    ... .          .    . .   .     .    .       .    ..      .   .  . .  .              .    .    .   ....  . ..
. .        .  .. ....  .   . .. ..            .. . . .. ...    ...  . ..    . .    . .   . .  ... . . .  .     .  ..   ..   ...  ..     .    .
.      . .    . . ..     .  .    ..  .. . ..     . .    .   .       .      . ...    . ..   ...     ... ..   . .. .        ..   ..   . . ..   .
..  .           .  .  .   .  .      ...    . .     .    . .    .  ....       .            ....  .   . .    .        .       .      ..      ...
.. .      .  .   .    . .   ..  ..        . .  .   . .        ...     . .  ...   ..    .     .. ...  ...      .      .  ...      .    .  ... .
.   . .. .    .. .  ...      ..         .        . .    . .  ..  .   .    .  .     .      . ..    .      . .  .   .     .     ..  .  . .  . ..
.. . .     .    . .  . ....... .. .   ...    .       ..   .    .  .  ..       .     ..  . .   .. .       . . . . .  ..  . ..  .  . . .   .   .
..  .     .   .        .     .   .      . ..     .. .          . ..   . ...       .. .      .   .. . .  .       .  ...     .   ..    .. ...  .
. .       .   ..   ..       ..  .   .         ..      .      .   . . .. .  .   . .    ...      .       .      .       .    ..  .  ..   ...   .
..     . . . ..     .          . . .   .    .  .      ..  .    .  .    ...   .. . ..   .  . . .  .  ...      .     ... ...    .              .
.  .     . .    . ..          .      .. . .   .     .   .   .   .  .      .   .. . .. .    . .  .  . .    ..   ..     .   . . .. .     .. .. .
. .   . ..   . . .    ..   ....    .   ..         . .  ..     . ...     . .             ..  ..   . .     ..       .      .  .  . .. .   .    .
. . .   . .. . .    ..   .     ..  . .      .. .    . ..     .       .   . .    .             .   ... ... .  .      .  .  .         ... .    .
.   .    . ..   .    .  .. .    .   .. .  ..   .         ..    .. ..   .                  ..    ..      .. . .       .       ..  .    .  ..  .
.  .       .      . .. .     .   .   ....     .  ..        . . .  .          ... .      ..    .. .  .. .. . ...           .     ..   ...  ....
.  .. .  .        ..  . .    ....   . . .     . . .. .  .  .       ....     .     .. .  .. .  . .   .          .     . . . ..  .   . .  ..  ..
.   .  .   .            .  .  .  ..        ..  . .  .   .....  ..   . .   ...   ..  ..  .  .     .     .    .           .   . .    .   .. .  .
...  .  .   . .   . .    ..  .    ..    ...   .  .   .         . ......    .      ....  .       .  . .. .  . ....       ...   .  . . .. . .. .
..  ..  ..    .  .   .      .  .. .. .  ...   .    .      ... ..  .   .      .    .   .    .  .     .    ... ...   .......  ..  . .  ...     .
..  .  ..  .   .   .   ..   .. ..  .  .       . ..  .   .. ...  .    .     .  .    .  ..  ...   .    ..              .   .  . .    .         .
. ...  ..    .   .....     .. .        .   . ..     .        ..   .    .          ..   ..    .   . . ...   . . . .     . . .  .   .      .. ..
.        . .        .   .  .         ...    ..  .    .   .         . .  . .. .    .  .  . ..    .. . .   . . ...    .   . ..  .  .   . . .   .
.           . .. ....  ...   .. .. .    ...  ...       ...   ..  . .  . ..   . .    ... .... . .     . . ...   .  .  . .. .           .     ..
.       .. ..           . .   .       .   .  .       .   .  . .      .   .       . .. .    . .   .      .   .  .      .  ...   .. . .  ...  ..
.  ..   . ..   .   ..    .      ..  . .. .      . . .        ..  .    ... . .  .     .. ..  .        .    .   . .        .  .. .. .      ..  .
.    .  .. . .   ..  .   .    . . .   .          .   . ...   ..         .         . . .      .   .     .. .   . .    .    .     .   . .. . . .
.. ..  .   ..    .  .  .. ..  .    .  .  ..       ..  .. ..  ..  .       ..           .. ..   .  ..  .    .  ....   ..  .     r   .          .
. .    .       . . .  . .  ..   . .. ..  . .   .   ..    .  .        .   . ..   .    .  .    .. .       .    . ..               .. ..       ..
....         . .  .. ..   ..  .. .    .        .       ..       ..       ...         .  ....  ..     ..  .... . .. .   .         .         . .
.   .    . .   ..    .. ...  ..          .   .       .     .. .   . .  . .    .    ..   .  ..    .            .. .         .      .  . .    ..
.     .    .  .  .  . .       .  . .   .     ..  .  .     .  ...  . ..     .  ...        ..  ..  .    ..  . ..  . . . .   .  .   .    .  .   .
. .    .  . .    ..      . ..  .  .   . . ..          .          .   . .    .   .     ...... ..    .. . .  .. .    .. .         .     . .    .
.  .      ..          .         . .. .   ..    . ..    . ..  ...    . .     .  . .  .       .              .  . ..    . .   .. ...   .  ...  .
.  .. .    .     .         .   .. .     .  .  .  .  . . .  . . .  .   ..   ...   ..      .. . .           . .        ..  . .      . .        .
. .. .  . . .. .    .    .   ...  ..   .   .       .  .     ...    .    .. .             ..... .    ..   .      .   ..     .  .  .      ..   .
.  . .     . .      . ..            .   .    .   ..  .      .  .  .  .    . .    . .....  ..    .  .     . .    ...  .   .   . .     . .   . .
. .  .           .   . ......    .    .    .. .. .    ..          . .   .          ...  . ..   .    .       .     ..      .. . .  .  .  .  ...
.. .. ..  ...      .     .   ...  ..     .    .       .  .        .   .   . .  .  .     ....     .. . ...   .... .  ..    ..  ..  ..   . .   .
.                ..  . .. ...       ....      .  . ..    .  .     .. . .   . ... . .  .  .   .       .    .          .. .                  . .
..   . .   ... .. .  .  . . .    ..     . .  ...   .            . . . .   .   .        ..     . ...           . .        . .      .        . .
. .    .. . .  . .   .  .  ..    .   .   . . ..        . .  ....   .  .                  .     .   . .  .         .  .. . . ..  ..         . .
. . .    ..   .    .  ..        .   . .     .     . .     ..     ... .   .  ..     .       . .. . .   . . . .     .  . .     ..      ..      .
.         .  .   .      . . .  .        . ...   .   . .  .. . ...     . . .  ...   .  .  .      .       .. .   .   .  . .          .  . ..   .
.    .      .       ...   .      .      . ..   . . .. .    . .     . .. . ...  .      . . . .   .   .    . ..       . .    . .          .    .
.  .     .   .   .     . .   .           . .  .  . . .    .        .  . .  ..       .    ..           . . . .. .  . .  .  .  ..  . . .    .  .
...    .     . .      . .. .  ..  ..     .       ... . . .     .       .  .   .   .. . .      .       .. .          .       .  ..         .  .
..  . .  .           .. .    .   .  .... .  .      . .. .     . . .  .     .     ...  .      ..     .  .         .       .         . .     ...
. .      .  . .     .    .    . . . . .     . . ..   . . .  ..   .  . .. . .. .      .     .. . .    .         .  .. ..  ...      .  .. ... ..
.        .     . ..  .  ..    .  . .      ..      .  . .       .  ..  . ...  ..   ..  .. . ...     .  ..  ...         .      .. .    .   .  ..
.          .   ..          .. .  ..       . .    . .    .             ...  .     ...  .     . ..         .. ..  .         ... .  .  . .    . .
.  ....... .      .  .  .    ..      . .  .....   . ..  .       .     .          .   ...       .      . . ... .  .  . .  ....   ..  .        .
.  .  . .  ....  .     .   .              .     ..    ..   . .  .   .   ..  ... .          ..    ....      . ..   . .    .. ..   ..  ..      .
.  .     ...      .... .   ..  . .  .         .  ... . ..  .  . . .   .   .. ... .     .         ..   .     . ...         .  .  .    ...   ...
.  .   .  .  .. ..    . ...  . ...     .   . .    .    . .     . .    .  .   .     .                     .     .    . .  .          ..     . .
.         .  ..      ...  . . . . . . ..     .    .   .   . .  ..       .             . .   .     .  . ..    .  ..  ..        .  ....     .  .
...      ..   ... . .    .   ..       . .  .   ..              .    . ....   .    . . .  .  .  ..      .       .      .  .         . .       .
.  ....           . . . ..      . .   .              .     .   . .   .  .  .       .... . .  . .  .    .        .            .   .  . ...    .
.                      .    .. .   ..  ..        . ..  ... . .     ..      . . . . . .  .. .         ..  . .     .    .   .   . . ....   ..  .
.    .   .. ..   .     .   .    .   .. .  .. .    .  .      ..  . . ...      .     ...  . .          ..     .. .   .  . .     .            . .
.. .      .  .  .  ..    ..  .. .. . .   . .      .   .  .. ..  .   . .      .  .  .    .  .  .     .       .    . ...    .    .  ....    .. .
.    .. ..         .      . .         ..  . . .. ..  .   .   .   . . . .   ..  .          .   .  .      . . .  .     ..   ... .  ....  ..    .
.     . .    .   ..  . .                .... . .     .   .. ..        .. .      ..  .        . ..  . ... . . .   .     .  .      .   . . ..  .
...   . ..   .......  .   ..   .      . ..    ..... ...  . .  .     .   ..  .  ..      .  .. .         .        .  . .    .  . .    .        .
..     .  .. .   .  .    .              .. .       ..      .  .  ..      . .      .  .        .. .   .        . .  ..  .  . .   .  .         .
..   .   .   ... ...  .  .   ...   .    .. . .     ..     ... .  .      .. .. . . ..    ..    .      ..        .    .  .  .  .  .   ..  .    .
. .  ..      . .  . .      .. ..     .  ..  .  .   . .. .        .   . .     ...  . ... .              .  . .    . .   .. ..  . . . . .  . . .
.    .   .    .. . .  .       .   .  ... .  . .   .   .    .... .  . .   .  . . .       .      .   .   . .. .  .        .     .  ..    ..   ..
. .   .   .   ..       ... .  . . ...  .. .  .           .  .   . ..      .. .  .. ...       . . . .  .  . ..        ..    .  .  .   .     . .
..   .        . . . . ..... .      .   . . .    ..   .  .     .       ...             .    .    ..     .  ..   . .    .  . .. .   .    . .  ..
.     .    .      .  . ..  .  ..  ..                .   ..   .... .    .    ...   .             .    . .  ......   .    ...     . .    . .   .
.  ... ..      . .....  .  ....             . .  .. .  ..      .   .    ..  .       . .            .   .    .. .     ..  .   .              ..
.    . .     .     .  ... ...     .  .  ..  .. ..        ...  ..  . ..        . .   . ..     ..   .  . .  ..     .  . ..    . .   .  . ..  . .
.   ..  .  .        ..  .             . .. .   . .. .   . .  ...  .   .               ..   . . ... .. .         . ..      .   .. ...       . .
. .       .      .. ..     .. .. .   .       .  .     ..    ..  ..    .   .      ....                  .... .. .   .. .  . ..  .    .     .. .
...   . ..   ...        .       ..        ..  ...    .    .  ....   .       . .    .        .  .       .    .      .   . .  .  ..         .  .
. .  . .    . .  .       ....   .. .  ..     .  .       . . ..        .  .     .       . ...  .. .  . .            . ..  .    .  .      .    .
. ..   . .      . .     .  .    .   .    .    ..  .  .    ...  .        .    .        .                 .        .  .  .     . .. . . ...  . .
.  .    .    . ..  .       . ..      ..         .     ...      .      ..         ... ..  .  ...... ... . .    .. .. ... . ...  .            ..
..  .      .     .  . ..       .    .   ... .           .    .    .     . .  .     ...  ..    .  ..   ... ...   .       . .        .  .  .  ..
.    ..     .       .     ...              .  ...    .     .    .       ..   ..  .     .  .     .    ...      . .   .  .   .    ..         ...
.   .  .     .     ... . ...      .      . .    ..  ..        .     .     .    ....   .      .    . .  .   .   .    .     . ..    ..  .      .
. .     . ..  .   .    . .   .          .     .     .   . ..  .   ..         .. . .  .    .             .   ... ..       .. ... .. .  ..     .
..           .               ..  .  .. . ....      .    .       .            . . ...       ..   .. .  .   . .   . ..   ..    .  ..     ..   ..
. .    . .. .. ..   ..    ..     .   ...     .  .    ..   . .    .  .. .      .  ..    .  ...   . ..     .   .    .     .   .   .      ..  . .
. ..  .. . ....     .   . ..  ..  ..  . .           .  .     ..  .   .        ..       .     .   .   . ..   .    .. .  .  .    .    ...  . . .
.  ....       .  . .  .         .                   .   .. ..  ...   . ..  ..   .   .      . .   .   ..   .  .. .  . .  ... .     ..  .     ..
.  .     . .   .  .                   ..         .  .... ..   .      . . .     .         ...  . ...... .        .      .. ..   .          .  .
.  .  .    . . .      .. .     ...   .      . .   .   ...   .... ... . . .       . . .  .             ..   ... .    ..    ..   .     . ..  ...
.     .   ..    .. .  .       .  . . ..  .     .   .      . .       .      ...  .      . ..            .     .    ...          ..   .     .  .
..           .   .    ..   . . ..  .  .     .    .  ..  .   .  .  ..     .   .    .       ..  . . .  ..       ..    .     . . .  ..  ...  . ..
.  .     .      .     ..    ..           . .  ...   .. . ..        .   .     ..   ..  .         ..  .    .. .    .     .       .  . .  .   . .
.   ...         .   . ..... ..                 .. .        ...        .    .             . ..  . .    ..  .       . . . .   . ... . . .      .
.    . .... ..   .  . .     .      .  .   . .. .     .    ... .         .  ..  . .           .  .    . ..       ..    ..   .     .           .
.  .. . .. . .   .    . ...       . ..   . . .  .            .   .     .   .. .   .        ...  . ...  .  .    .   .  ..    .   .    .. .    .
.. .. .... ..    .    ..  ..  .......   .      .     ... . .          .    .. . ... . . .  .   . . .  . ...   . . .      . .    . . .  .    ..
. .. . .    .. .  . .      ..  .  .  .         . .      ..  ... .      .     . .   .  . .    . .  .  ..  . ... ...  .   .                .. ..
. .  .  . .      . . .  .        .  .           .   . ..   .    ...  . ..   .. . ..  . .    ..   .     . .   .  .      ..        .  .  .     .
..   ..  .      .       . .  .  ... . ..     . ..      .  .   ....          ..           .  .  .      ...   ..       ...  .. .. ..   . . .. ..
. .      .            .      ..    .  .    .    .   .   ...     .      .  ..     .  . . . ...   .   .   ..       ... .  .      .    .      . .
.   .  .     ...    ..   .        .  ..     . . .  .     .  .  . .     .   ..       .       ..  .        ..      .. . ....    ..  .   ..  .  .
..  .         . .        .  .. .     ..   . .     . .      ..   ...   .    .      .     . ..    .   .    . .   .  .           . . ..       ...
..   .     .    .   .   .   .   . . . ... .     .   .         ...  .  .        . .     .. .  .  .. . ....   .        .          ..    .  .   .
..   .    ...     .  .     .    .  ..  .  . .   ..   .     . . .      ..     . .   ..   ..   .. .    . . .  ... . .    .  ...   .  .  .  .. ..
.  ..     .   .    .. ..  ...  .    .  . .                 .    ..     .  .   . . .  .    .  ...                       . . . .        .     ..
.    .  . .. .         .. .        ..  ..    .   .   . . ..      .       ..     .           ..  ..  .    .     ...  .   .   ..   .. .    . . .
.   . .. .  . .  . .   . .            .   .    . ..      .   .. ..    . .    . .  .     ...            . .  ....   .  .  ..    . .   .       .
.   .        .   .   ..    .  ... .       ..    .        .   ...   .  .. ..  . .     .   .  .     .  .   .. .        . .  .    .     . .    ..
.  .    ..               .    ....    . .. .  . .  ...  ..    .  .  ....   .   . .  .   .   .  .  ..    . . .    . .           ..  .. .   .. .
.    . ... .  . .       .  ..  ..   .  . .  .   . . .   .   . .      .   .               . .  .  .  . . ....      .   ..  .         .. ..    .
.       . .   ... .      ... .    ...     ..    .    .       .  ....           .    .. ...       .     .  .      .   .  .  ...    .    .  .  .
. .  .      ..   ..  ....     .      .. ... .. .  ..   .. ...                ..  .  ..      . . . . ....       .  .  .. .      .  ...    .   .
.     .  .  .          .           .   ...             .   . . .  .  .        ...   ...   .       .  .       .            .   .       . . .  .
. . .           ..        . .    ..  .    . .   .    ..  .  .  .  .   .     ....     .       ....  . ..    .. . .          ...   .    . . . ..
. . .   .    .     .  . .  .        ..      ...  .   ..      . . .   . . .         .        .      .  .   .   .... .    .   ..   . .. . .  . .
. . .. .     ..   .  ..   . .             ..             ...   .    .   ..  .. . .   ..   .  . .         .       .   .          . .      .  ..
.   .   .        ..  . .  .   .. ..  ..          ..              .   .     ...    .     .. .   . .    .  . .   ..            .   . .  .     ..
.         .    ..   .   . .       .            .     .  .      ..  .  .   .  .          ...     .....    ..X        .   .  . ..     .     . ..
.  .   . ..  . . .  .                  ..     ..     .     ..   .    .     . .   . . ...      ..  .           .   ....  .      ... .         .
.  .     ..  .      . . .      . . . .    .     .       . . ..   . .  ..    . ..  .   ...       .  ....  . . .      .  .    .   . .  . .  .  .
..       ..    . .    .       .   . . ..     .     .. ..   .  .  .   ..  . .      . ..         .    ...  . .    .      .. .. .     . .  ...  .
.  ..    ... . .   .     .        .  .....  .. ..        .  . ....     ......  .  . .     .  .  .   . .      .....     .          .  .     ...
.  .. ..   .. ..  ... .   ..   .  ..  ..           .. . ...    .        ...     ....     ..    . .         . .  ...    ..  .  . ...          .
..   .   ...   .  .             .. .   . .    . ....  .  .  . ...       ..  ...   . . .  .  .    .   .     ...     .   . . .    .      .  .. .
. ...           .      .              .         .    .       .  .. .    .. .  .   .  . .      .  . .  .. ...         ..      .        ..     .
.. . ..  ...    ..    .      . . ...        . ...    .     .      . .   .        .. .  ...         .          . ... .  .   . .. .. .      .  .
..   .  . .      .             .  . .   .  ...      . .      . .    .       .    . .  ....  .  .     .       .  . ..  .  . .   .        .   ..
.   .    ....  .     .    ..    .  .  .   . .   .     ....        .      .   .    ... .   ..      .    .     .         . .    . ... ....     .
.... .. .      .   .  .   . .. .    . ..    . .      . ..     . .          .       .    . .    .    . . ..    .               .. . ..   .    .
. ... .      ..            .  .   . .    .    .      .  .   . . .   . .     .. . .   . . .. . . .  .  .. . .. .  .   .. . .   . ..        .  .
.. . .               .   .  .   .   . . ..       .  .. . .    .. ..     .  .  .    .    ..  ..    ..  .     .  .  .     . .  . .   . ..  . . .
...           .  .        .         ..         . .   .     .  ... .     ..      . .      . . ...  ..     .. .   .     .             . .. . . .
.        ..      .   ..  . .   .  .    .      ....   . ... .  . ..   .  ..   .     . ..  . .     ..   .      .  . ...  .  ...  ... .  .  .   .
. .... .  ..  . .... . .      .   ..   .. .   ...       .  . . .     . . .    .     .   . ..    .    ..  .....  .   .        . .       ..    .
..    .... .. .     .  . ...  .  .    .... ..     .     ..          .     .       .  .    .         .  . .   .   ...     . . ..    . ...  .  .
. ..  .     .   .         ...    .. .   .. ....      .    . .. . ..      .. .  .  .     .   .. .      . .     .   .  .   .      .   ...      .
..............................................................................................................................................
