...............................................................................................................................................
. .            .          ...  . .. ..   . .  .       ..   .  .    .      ..   .        . .   ..  .  ...   . ..      .   .   . .  .  .      ...
.   .  .. ...   .      .         .      .    .. . .   .        .    ..       . .  .. .. ..        ..  . .                .     .      .. . . ..
...   . . ...        .  .   .. .     .. . .     .  ...  . .  .  .... .... .    .   .     ..          .  . ...      . .... . .       ..    .   .
.   .. .        ... .. .  .  ..   .       . .     .           ...  . .  .. .  .       .   .           .   ..    .   .      .  .               .
.. ...   ..     ..   .  .. .   .  .  .. .        . . .           . ..    .     .      ...           ....    .   .       ..     . .  ..        .
. .  . ...   .   .  ..  .  . . .   .    .     .  . .. . . .. .  . .            . .    ....     . ..                      ..               .  ..
.  .  .  .    .   ..  .. .    . ..     .       ...  .  .  .         . ..      . ..   ...  .. .  ..    .   .   ..   . .  ..   .. .   .  .    ...
...  . .   ..     .       .  .. . .     . .  ...     . .         .        .  .      ...  ..                .  .   . ..   .. .   .    . .     ..
..  .. . . . . .    .    ..  .    .       . . ...    .   . .  . .      .  .  .    . . .    . .    . ..     .    ... .  ..   ...  . .   ... .  .
.   . .       ... .    . ..    .   .     .      .   .  . .  ... .   ..      .  .   .   .    . .   .. ...       .. ...   ....   .  . .     .   .
..               .. ....         ...        . .   .   ...  . .    . . . .  .  ....   .  .  .. .  .  ..  ..         .          ... ..         ..
..  . ..   .       .  .  . ..   .            .   . .. .    ...   .     .. .     .  . ..    ...   ... .    .         .   . . . .....   .    .  .
.   . ..   .       .... .  .   .. . .     .  ..   .  .    .         ..     ...    .    .  ..   . .   ..  .     ..             .. .   ...  .   .
..  ..    . .  .   .  . .      ...  .  .   . .   ..            .       .  .        .    . ..       .     .    .   .   ...     .     .        ..
.  .   ..     . .   .... .     . . ... . . .  ..     . .  ...  ..        ... .      . .   .       .   .      .     .. . . .   . .  ...  . ..  .
... ..  . .         ..     . .. . . . ... . ..     .           .   .  .   .   .               .    . .   .  .    .. . ...  .         . .      .
. . .. . . . . .       .. ...             ...   .    . . . .         .....  . . . ..        .     . .  ....       . ..  .      ..    ..  .. ...
. .  .. .  . . . ..  . .   ..   ..       . . .  . . ..        .... .    ..    .  ...   ..    ....   .        .     .. ...  .        .   . ..  .
.       .     ..      ... .            .   . .  .. .    .. .   .    .   ...    .                .        .    ...           ..         ..    ..
.   .. ... .         . .    . .   .   .     .    .. .     .   .  .  ..  ..     ...  . . .   . .  .. .     .  .  .   ..   .     .  .        ....
. . .    . .  .    .   . . .   .. .   ...  .       .               . ...  . ...  ..  ..        .  ..    . ..  ..      .   .   .   .  .      . .
.   .        .. .    . .  ....    .  ...  .  . . .   .  .. .    .   .  .    .    . .  . .    .    .  .. .  .  ..  . .  .     .      .. .  .  ..
.     .  .       .   .  . .              ..     .    ..  .. .   . .    .        ... .    .         ..   .     .  .   . .  .          .  ...   .
..     .   .   ..  ...    .  .   .. ...           .   . .  ..     .  ...   .  ... .  .  . . .  ...    .      .    ..   .     .        .     . .
..   . . . .      .. .  . .. .      ..        .. ..    .  .  .           . .  . ..   .   .   . ..         ... .  .  .       .     ..   . .    .
.       . .     .     .  . .   ..    .  . .  . .  .. .   .... .             . .. .        .. .. .. ..      .   .         . .  .     . .    .  .
. ....     .. .  . .    ... .     . . ..       .. .   .... ..          .        .          . . .    .    .   .       .   .     . .  .  ... ....
..     .   .       .. ..  .   ....    . ..  .   ...    .     ..      . .  .   .. .      .    ..      ..  . . . .  . . . ..      .. . . .   .  .
. .  .. ..          . . . .   ..      . ...  .    ... .   .        ..   .. .  .     . .    ..     ..     ..                  .  . .     .   . .
.         .     ..... ... .   .     .  ..  ...    .                     . .. .       .     . . ..          .    .       .  .  .        .   . ..
..    ..  .  .    ...   ...... .   .    ..   .    ....     .            .. ..   .    ..  ... .  .    ... .   .    .   . .  .  .      .  .  .  .
.     . .    . . . .       ..   .     ..       .. .       . ..  . .          .    ..      ... . .       .         .      . . .  ..      ..    .
..  .             ..   ..... . .   . .      ...   .   .        .. .     ..   .....    .      .     . .      ..    .   . ..    . ....  . .  .  .
.  .  .      .           .  . .             .      .    ..    .. .. . . . .       . . .   .. .. ....   .  ..    ...  .   ..         ...  .    .
.   ..    ...      . ...           .  .. ... . . .   .    . . ..           . .  .   . .       .. .    .  . . . .   ....  . .       .  .   .   .
.  ... .. .... .         .. ...      ..           .   .  ..      .  ..   . .      .     .  . .   .        .   ..     .  .       ... ..   . .  .
.     ..  . .      .        .  . .      .       .. .  .  . . ..   .. .  .   ..      ...   .     ... .      . . ... . .     .. . ..    . . .   .
.. ..  . .   . .  .    . ... .     . ...  .  .    .  .     ..     .    ..  .   .    . ... . . .  .....     .     ..    . .  ..  .. .     . ....
.    .  . .  . .       . ..   .    .    .      . .  .   .    .   .  .      ...   ..     .. ...   .    ...        ...   . . ..... .  .  .     ..
.     .      .    . .  .   . ....      .              . .       ..   .    . .. . .     .       .  .  ..        .    ..     .    . .   .. .    .
.   .  ...        . .  . .  . . ..  .. .    .. ...       . .. . . .  ..    .. .     . .   .     . . ..   ...  . . .   . .  . ..   . .   . ..  .
. ...       .. .    . ..   .  ....   .. ..   .   ..   ..   . ..      ...  ..   ..           . .. .         . ..  .       . ...   .  .  ...  ...
.      .  . .  .      ..   .    . .  . .   .  .  . ..   .          .      .  .      .      ..  ..           .     .   .  ......   ..     . .  .
.   ... .  . .   .   ...      .  ...   .   .   .      ...  . .   .   .    .        . ..   . .    ...   .. .     .  .  .  . ..  .  .. .  . ... .
..   ....    ..       .... ..  ...  .    .  ...    ..   .                 ..   .  .  .     . .  .   .. ..  .   .     . .      . .      . .    .
.      ......       . .    .  .    .           ..      . .         .      ..   . .          .    ..      .      .        ...       .      . . .
. . ...     .       .   .         .          . ..   . .    .     ..     .  ..    . .      .  .   .    .    .  . .      .       .   .  . .  ....
...    .     .         .   .   .   . .  .  .  ...   .       .  . .     .     .   .      .  . . .  . . . . ..          .   . .    .  ..        .
.           .      .        ...       .            .  .  .          .     . . .  . .  .  .   ...      .    ..     .      ...  ..  . . ...     .
. ..       ..    . .  ....   .   .        .   ..    .  . .       .      .     .  ..   .    .    .      ..     .  .    .   .   . .        .    .
. ..  .  ..   ..  ..  . .  .   . .   .. .   .   .. . .   .        ..  .  . .    .     . .   .         .    .        ..  .  ..    .     .      .
..  . . ..  . .  .  .    . . .     ...       .       ..   .. ... .    . . ...            .     . ... .   .       .  . ..   .   ... ...      . .
.  .   ..  .. . .    .          ...    .  . .     ..     ..    ....  . .. .  .   .   ..... . . .    .      .. ...  .  .     . . .     .. .  . .
... .    . .   . .    .     .     ..    .    . .            . .    . .  .      .      ..      ...   . . .         .  .               .        .
.    .       ...      .   . ..    .    ..  .. ....    .    ..   ..   .     .  .       .  .      .  . ..     .  ... .  . .  ...      .   .  . ..
. .          .        .       ..  . ..  .. .        ... . .     .   ..   .         ... .   .    .  ....  . .. .   .    .            .  .  . . .
.  . . .    ..  . .   .   . .     . . ..  ..  .  ..     .   ..  .  . ..   .  . .   ..    . .   ....     .   .  ..  .   .  ...  . .       ..  ..
. .   .   . ..  .  ...     .. . . .  . ....         .. . .  .  . . ...    .     .. . .  .   .  .  .. .     . .  .  .  .. .         ..  .     ..
. ..             .     .      .  .    .                     ..         .    . .. .  ...   .    . . .   .  . .     .   . ....    ..   ..  ..   .
.      .          . .   .           .   ..     .   .  . .    .   .     .      .   .  .     .  .       .    .. .   .  .  .   ..  .   .   .  . ..
.    .  .    .         .     .     .       .. . ..   .    . .   ..    .  . ..   .    . .  .    ..        . . .         ... .     .. ...  .   ..
.  ....          .      ..     .       .. .. .. . .     .   .         ..    .    . ..  ..  ..     .  .. ..   ..       ..  . ....     ..  .. . .
..    .      .   ..     .       ... .   .       .  .      .               ... ..       . . . . ..     .  .  . . .  .  ..     .  ..  .....     .
...   .  . .. ..       ....   ..  .              .        . .   .         .   . . .    . ...    .. ... .    .    .  .     ......              .
..         . .   ..     .        .     .    .      . .  ...     .     .. .   .  .      .   . . ... . .. ...      .    . .  . . .  . .  .   ....
.  .  . ...       . ..  ... .    ..     ..   ..  . .             .     . .   . .  ... .  . . ..        .. ...    ..  .    .  . .   .   .   . ..
...   ..  .       .     ...  . .  .      ..... .      ..  .  .  . ..    .  . . ..  ..   ..     . .    .      .     .    ..        .  .     .  .
..        ... . . ... . .     ..   .     .    .  ..   .     . .   .   .. .    . .. .  .  .  .  .     ...  .  ... . . .     . ..  .     .      .
.    .. ..      . ...   . . .   . .. ... . ... . . .         .  . . ..  . . . ..     .  .   . .   .  . .      .              .... .    .  . ...
.. .  . . ..  .       .   .      .             .        .   .    ..  .. .  ....  .        .        .  .    .  .. .   .  .     .   . .         .
.  .     ...  .      . .    .  .      . .. . .  ...  ..      ...  ... ..               ...   .          . . . .  .           .    .  .  .   ...
..  .. .   .       .   .       .     .   .       . .      .     ..  . ..  .  .  .   .    .. .         .     .        . . .      .  . ..    .. .
.        .    ..     .    .  .  .   . ..              .    . . . . .       . .  . . ..  ..  .  ..     .         ..    . .       .      .     ..
. .  . ..        .    .       .   ..      .   .  . . .     .      ..  ...    .     .  .     ....   ...    .  .   .  . .   ..   ....        . ..
.... . . .   ..            . .       . ...      .    ..  . ..     ..    .  . .         ..  .       .. ..       . .    .. . . ...   .          .
.  . . . ..    .. ..     ..      ....  .   .    ..     . ..    .    ..      .  . .     . .  . . ..    . .  .  X      .  . . .         . ... . .
.   ....   .. .   ... .     . .   . . . .  . .        .. .    . . .         . . .     ..  . . .     .. .    .. ..  .     .  ..    . .  . . .. .
..   .  .      .        .  .     .  .      ..   .. .    ..  .. .     . .          .  . .   .     .   . . . .  .    .. .   .  .. . . . .. . .  .
. ..    ..  . . . .   .   .   .  . . .. .          .   ... ...   .. .... .   .    .    ..           .   ..      .. .    ....     . .    .     .
..    .  ..   .        .     ..      . .  .   .       .     . .    ...    ..    ... ....    . . .   .  ... .     .... .. . ..  . .. . .. . ....
.     ..       .....     .      .  ... . .   ..  ...     .  . . . ..   . ... .  .    .  . .. .    ..     .. .      .          .  .   ...  .   .
.   .     .     ... .    . .   .   ... . .  .  ....  .      .    . .      .  ... .  .  .  .     ...  ..  . . .  .. .   .  .  .  .        .. . .
.   ..   . . . .  ...   .  .  ..     . .     ... . .    .    .   .    . .  ..     .. ..     .     .   ... ...   . .    .      .    . .        .
. .r. .  ..  ..     .      .    .     . .           .                .       .   .     . .    .   .   .   .  .  . ...   . .  .. ..      .   ...
.  .                                .   .  .     . .     .. ...  .  .  .   ..    ... ..  .      . . . .   . .    . .. .  .    .   .  .   ...  .
. ... .. .     .         .     ...  . .                 .  . .          .   .   .     . .  ... ..   .. ..  .  ...   .... .   ..... .   .      .
...     .. . .          ..     ...      . .       ..  ..   .               ..   . .     ..... .   .   . ...  ..  .       . . ..      . . .    .
. . . ...  .   .. ... .  ..  ...   .  . ..      .    . . ... .  .           .. ..     . . .       . ..  . .   .     . .      . . .  .. .   ....
. .   .     .   .     ... . . . . . . . .  .     .    ...  .      .       .  .       .       .  . .   .      .   ..         . ...    .  . ..  .
. .  .    ..      .     .             .           .  . .         .   .  . ..    . . .  .  . .  . ...  .    .. . .   .   ..     .. . .   .. .  .
.   .      .   .  .... .. ..   .      .   .   .   ..       .   .       .         . .       . . .    .       .    . . ..  ..       .  .   .. ...
.      . .        . ..   . .      . ..   ..  .   .   .... .    .      ...   ...    .   . .  .      . .  .   ..  . . .    .     .. ..  . . . . .
.      .     .          ..       .       .     ..   .     ..   . .  .    .  ...     .   . .    .   . . ...  ....  .  .. ...     .  . . ..    ..
...  .    .   . .    .  . ...    ....         .   . . ..   ..           . .     . . .  ..     .   .    . .  .     .. .         . .         .. .
.     .  .   .      .  . .. . .  .   ..  .             . .    .    .... . .     ..    .        .   . . ..   ...      .                    . . .
..  ... .. ..   .  .  . . ...   .         .  ... . .        .          . .. ..     . .     . .   .. ... .      .   . .. .  .   .   . .. . .   .
. . . .  .  .  .    .       .   .           .   .  .     .  ....  ....    .               .     .     .  . . .       .   .. .          . ...  .
. .     .    .  . .        .  .  .           .  .      .    ...  .         .   .   .  .   .   . . .          ..        . .    ..   ...   ..   .
..    . . .   .      ...     .   . .      .     .     .     ..    ...  .   ..    .. .      .. ...     .  .   .    .. .   .  .   . ...    ..   .
. ..  .   . ..         .   .  .      .      ..  . ..     .      ..   . ..   . ..               ..   .       . ... .       .     ...  .. . ..  .
..       ..  ..      .           .  .   ..  .  .        .        . ...   .        .     .  .    .    .    .  .     .. .   .  . .  ..  .  .   ..
..  .. .   .     ..  .     .  .. .  ..    .....         .     .  .       .  ....   .   .   ..    .   ..     ......  .  .  .  ..         .  . ..
.   .            .. . .     . .  . .. .  .    ...   .. .   .. ..    ..   .     ..    .. .   .. .      .  .     ... .. .  . .. .  ..   .  .    .
.   ...     . . . .   .. ... .      ...   .  .    . .    .               .   . .    . .   .  .   . .      .  ..     ..  .   .  ..  .  ..      .
.    .   .    .  . . . .   .     .      .   .       ..      .   .          . . . .      .    .. .  ..  .      . .           .     ... . . .   .
.   .            ......  .  .   ...   ....      .        . .   . .. .    .         . .   .  .. .    .    .    .  .  .     .     .. .      . . .
.       ..  .. . .    .           ..  ...  .... ..   .      ..    .     ...        .  .         ....    ..     .   . .    .    ...  . . .   ...
.  .   ..     .  .  .      .. .  ..  .    . .        .    ...   .  . . .      .        .. .  . .   ..    .    .    .  ..   .   . .. .   .   . .
. .   ..       .  . . . .     .   ..    .   .   ... . ..     . .   .. . . .  .  .             .  .       ..  .       ...      .  .    .       .
.  . . ..      .                .   ... .  ..  .... .. .  ..    .. .   .     .         .. ..       .. ..   ..   ...         .     .        .  .
. .   .    . .. ..   . . . .   .  .  .    . .. .     . . .  .               .      ..  .              .      .... ...  .   .. ..        . ... .
.  .      . .. . .  ... . ... . ...         ..        . .   .. .  ..           .   .      ..  .   .            .            .     . ..      . .
.    ..... . .. . .       .   .. .     .      .    ...          .       .     ..  ..   .  .     . .   .. .     .    ..   .     .  . . ....    .
.... . .          ...     .  .   .   .  .. .   . .           .    .   .  ..     . .   .   .             .   ..   .    .  . .  . .     .       .
.    . .   .   .      .. .     . ... .   .  . . .          .   ..  .   ..   .  .     ..                  . ..   . .. . ..    .  .  .  .  . .. .
. . . .  .. ..     .. .  .   . .           . .   .     .  .     ..       . .... .  . .       ..  . ..       .    .. . .   .. .        .    .. .
.  .       ..  .  . .  .....      ..  ..  . ..   . . ..     .  ...... . . .  .  .    .  .  .  .    .  .  .   ..   .   ...     .   .    .   .  .
.. ..           ..   .    .  . .      .    ..   .      .. . .  ..  .  ..  ...        . ....    .  .     .   .  . .. .        .   .    ..    ...
.   .. .  .  .     . ..  ....   .     .. .   .. ......    ..     . .  .    .   .. .  ..   ..  .   .  . ..  .     .. .   .   .    .  .  .  .   .
.     .   .. ...   ..  .    .            ... ..  .    .    ..  ......   .  .  .     . . . ....   .   .       . . ..   .  .         .  .  .    .
.  .     . .  .     .      ..  .        .   .        .. .. . .  .     .. ..      .     . .   .  .  ... . .    .   .    .      .  . .   .      .
.      . ...... . . .    .   . ..  ..     .       .  ... ..   .  ..  .         .          .. .    ..      .     ..     ...    .. . .   .. .   .
.  . ...       ...   .          ..       . .. .  .  .            . .     .. . ..    .... .  .    ....  ..                 .   . .   . ...  .  .
..              ..      ..  ...    .     .         . ...      .  ..   .  . .     .   ....   .       .  .   .   .       . . .   ... . . . .    .
. ..    . ..        .     ..     . . ...        .  ....  .    .   .            ...  .   .. . .         .   .   .                  .      .   ..
.   ...     .  .. ..   ..    . .   .  . . .   ...        .    .              . .    .. .   .  .  .    .  .     . ..  . . . .     .  .    . .  .
.   .   . .  ..   ..   .   .      .         ...    .      . .   .   .    .   .   .      .     . ... .        .      .. .    . .   ...     .   .
.   .    . .  .  .                  . ...   ...  .. .       ..      ..     ...    .    ...  . .   ..  .    .       . . .  ..  ..            ...
.                    .     .. . ...  . .    . .     ...  . .            .  .     ..  .        ..... ..   . . .  .... .  .      ... . .      . .
.         . .  . ..   . .   .  .  ...   .     . .. .  .  ..       .      ...      .         .   .  .   .  .     .   .        .     .    ..    .
.   .  .  .    . .   . .   .     ...        . .  .   ..      .    .  . ..             .   ..                     .   ..  .   . ..    .       ..
.    . ..       . .  .     .     . .      .  .. .  .  . .     .    .. .       .  ...    .   ..        .      . ..   .  .    .       .       . .
.   .      .. .     .  ..  .  .  . .     .         .   .    .    .    .    . .  ..     ...        . ..  .      .    ...    . .     .    . .   .
. .  .        .   .    .   .  ...            ..    . .    . .   ..     .  .        .   .  ..     ...  .      . .  ...  .       .. . .   . .   .
.        .       . .  . .     .                 .   ...        . .  .      .. . .     .... .  .  .  . .  . . .  .        .        .      .    .
.     .     .   ...     . . .     ..    . . . .       .   .. .  .        .           .      . . ..  .  ..  ..      .  .  .            .  .    .
.   ..      . .     .    .. . .....   .  . . . .  .          . .     .   ..   ..       . .     . . .      . .      . .     .               .  .
.. .   .      ... .      .    . . .      .      . .            ..   .... ..    .. .                . . .   ......    .   .   .  .     .. ..  ..
..               ...    . . .  .             .      ..  ..   .     .   .      .. . . .        .  ..    ..     .     ....      .  .  . .   .....
. .    .   . ..  . . .    .  ..    .       .   .    .  .  . .  . .. .      .  . .      .  . . .   .     .. .     .. .      ...   ..   .     ...
. . . .  . .    ..   .  .  .       .              .   .      .. .  .  ..     ..         .   . . ..  ....       . .. .             .    . .... .
...............................................................................................................................................
