................................................................................................................................................
.  .      .  .     ...      . .    .  .    ..    ..     ..  . .          ..   ..  .. ..   .       . .  .   .....      .   ..       . .   ..   ..
.  .       . .      .. ..      .    ..     .        .    .. ..    .. ..             . .  .        .         .  .   .. .         .. .    . .   ..
.     .  . ..  .  .           ... . ...          ..  ..         .  .   ..  ...   . .         .. ....  ..                    .  . .        . ....
.          .     .  .       .        . .  .    .   .    ..  .    .   .   . ..  .         . .   ...     .    . .  . . .. . . .     .    . .  .. .
.   ..           .....          .     ..   ...  .  ..     . .      .  .               . . .      . .  . .. .  .      .   .   . ....  ..   .    .
.. . ..     .     . .   ... .  ..    .     .  .     .        . . .            . ..     . .    ..   .            . .               ... .    .   .
.      . ....   ..   .     .       ...   .      .     . .   .   .              . .            .                .    .     .   .    .  . .  .   .
.       . . . ... .  .     .    .  ..  ..          .   .  .               ..  . ..  ...  .         . ...      .... .  .      .  . .  .. . .    .
.    ..  .    .. .     .  .  .  . ..  .. .   .  . .  .         .   .  ... .   .    .    ..  .  . .  . .                   . ...  . .     . .   .
.     .. .. . . ..  . .    .  .  ..       .    . .      ..      ..    .      .       . .           .  . .. .        .        ... . .  ..       .
.  . ..        .   .      .    .   .          .      .  .....  ..     ..  .     . . .   .. . ..       .    . ..    .   .    .. .    .          .
.  .       .       . ..  .    .      .     ..     .          .. . .  .  .      . . .. .    ...    . .   .    . .        .      . ...     ...   .
. .    .  . . ..   ..      .. .  .       .   .  ..   . .     .   ...  .  ....   .    .     ..     .  . . .. ..   .    .  .. . .    ...  .    . .
.         .   . . . .      .                    ..   .   .... ..  . ..    .  .   .   ..                    .    .    . . ...   . ..       .... .
.     .  ... .. .          ..  .  ..      ... .      .     ..    .  ..  .    ...  .  .  . . . .      . .  ..  . . .       . . .  ....    .    ..
...     .              .  .  .  .. .      .             .   ... .   .. ..   .      .        . .  .  .  .    . .    ..  . .   ....  .  .      . .
..  .  .   . . .. ...         .    .. .                         .     .           . .    .    .     . .  .  .    . .     .    .  .       .     .
.   . . ... .      .   . .   ..  .  . .....  .. ...      .      .. ....        .  .     .      .   . . .         .   .  . .        ..      .  ..
.      .. .   . .  . . ...     ..  .   ...     ..  .  . ..  . . .          .  .   .    .  .       .   .   ...    . .    .  . ..   . ...   .    .
.   .    .       .       . . .. ...  .      .. . . .         .    . .     .  .  ... .       .       .. . .    .     . .    .  . .  .   ..    ...
....  .  ...  .    .         ... .   ..   . .  .  .   .  ...  . ... . .         .        . .     . ..  .  .    . .  .      .              .  . .
...    ...            . ..         .  .. .  ... ..    .         .  .       .   ..     ..   .   ..  ....   .   .   .                .    ..    ..
.     ...   ..   .    ..        .     .  .  .              .    .               ...  .        ..   ..  .      ....        . .        ..       ..
. ..    . ..       . .                   ..    ..   .  .     ...   .        ... . ..    .  . .  . .   . .      .  .     ..    ..   ..     .. ...
. .       .   .    .  . . .     .   ..     .  . .  . . .    .   ... . ...    ..  ..   . .  ....  ..         .      ..    .     ....   . .  .   .
.      . .       ..  .   .   .  ...  . .   . .    .   .    .  .    .... ..   .   .  ..    ..  . .. . .  .      .  .  .     .    .. . ..  ..   ..
...      .   ..     . .   .    . .. .     ...  . . .    .   .. . . ..       .... . ... .   ..      .   .   .               .    .       ..  .  .
.     ..      .    ..      .    . .  .      .  . ...      .  .. ..     .    .       .   ..  . . .. ...    . .  ..         ...       .   ...   ..
. ....        ..  .    .  .                 ... .       .   .     ..   ..  .    . ..   . ..       ..                .  ..       .  .   .    . ..
.  . .  .   . ... .       ..       ..        . .  . . .   .        . ..  .  .         .    .   . .   .     ..   . ... .     ..  . .. ..  .    ..
..    . .    ...       .    .  .. .           .      ..   . ..   .  ... ..   .  ..    ..    . . .   .  . . . .    .   . .    .      .  .  .   ..
. .  . ... .    .. .       ..   ....  .   .  .    .    . .       ...  . . . . .   .  . ...  . .  ..   . . .        .   .  .  .   .      .. .  ..
....      ...        . .     .              . .  .      ...       .   .  ..  . .   ..   . .  . .  .  . .. . .  ..  ...   . .     .   .   .  .  .
. ..  . .  .               . .  . ..    .      .        ..     .    .....  .  ..       .    .  .    . .    .    ...  .   .   . .       . ... . .
.     .. ... .      . .   .  .  .      . ..   ...     . . ..    . ..         ..  . .. .     .  . . ...     .   .   . ..  ..  . ....        .  ..
.     ... .  .   .   .       ..   .  .. .  . ..             .   .            .         . .    . .    . .      ...    ..   ..   .       ..      .
.    . . .   ..   .  .  .   ...       .  ..    ... .     ..    .  .  . .          .    . .              . ...     .  . ..        ..      .    ..
..              .           .      .  .    .    ...   ..   . . .  . . ..    ...    .     .   . .. .  .   .   . .. .  .    .          .    ..  ..
. .   . . .     ..     ....   .        .    .. .   .    . . .        .. .. .         . . .... . . .  .     ... .     .. .  ..  .        .  . . .
.        ..    .          ..          .. ..  .  .. .      ..             . .     ... ....   .      .     ..     .    .  ..        . .       . ..
.     . .  .    . .  .            .             ..  .  . .   . .. .   .    .      .    .  .     .   .. .     .  . .  .   ..   ..   . .   .    ..
.  .. . . .        .... ..  .  .. ...  .     .      .   .  .    .. ....  .  ..  .  .   .  .. ....  .      ..        .    . ...   . .  .     .  .
.. .  .  .  .  ..     . .                 .  .. .   ..   .  .. .     .    .   . . .              .           . .    .   . .       .  .  ..    ..
. . ..          .   . . ..   .        . .       .  . .....   . .   .    . .. .      ..  ..  . .   . .      . ...   ..... . .  .  . . . ..   . ..
.      ..    .  ..    ..  .  .   .  . ..            . ..       . . .  .  . .   . .. . . .    . .    . .  . . ...  .   . ..          .   . .  . .
..         .   . .   . ..      .        .  .. .  .   .   .      .. .     . .  .         .   .      . ..   .  .. .    . .. .       .      .  ....
.  . ...                    . .  ..  . .      .         .       ..       .     . .  .  . . .  .. ..    ..   ..    . .     .     .. . . .. ..  ..
.      .. ..   .    . . .. ..    . .    .           ..  ..  ..      . .           ..   .         .. .      .  ....  .            .  ..    .  . .
..        . .   .        .      .  ..    .. ..  ..                 .   . .      ..   .    ..     .      .  .      ...  .. .. .. ... .   .      .
.       . .  . . . . .. .  . .    .             .. .   . .   .  .  .  ..   . . .        .    . .    .       .  ..     . .  .    ...     ..    ..
..   .   .     .   .        .. .    .   .      . ...   ..  ..  ..   .  .  .  .  . .          .. . .. ..  .  . .      .     .. ...    .   ...   .
.   . .    ..          .  ..   .  .     .      . .  .. .     ..    . .    .     . .  ...  .                 ..  .. .   ...   .     . .. . ..   .
...  .    .         . .. . .    .  ..          .  .  ..  . .   . .   .  ...  ..          . .    .        .   .   .. . . .         .  .   ....  .
.    .     . ....     ..       ..      .    .    .      . .   .   .  ..      . ..    . .  .    .    .   .    .   .   ..   .    .  ..      . .  .
.. .     ..  .   ..    ..     . ...           . .. . .  .      .      .  .. .    . .   .  .  ...  .        . . .....               .          ..
.. ......      ..        .  .. ..    ...         . .      ..  .    .. .   .  .  .  .     .  ..      .      .  .  .   . .   .        . ..       .
..  . ......     . ..    .  .        ...     . . ... .          .   . . .       . . . .  . .      ...  .  ..  .   .        .   .   .   ... . . .
.    .. ..    .     .. ..  .  .   .    ..  ..    .       .. . .    ...       .  ...       .         ..  . ..       .    . .   . .  . .. .. .   .
. . ..    . .         .  .  .   ..   .  .      ...       .   .   ..   ..  . .   .    . .   ..     .    ..     ..  ...     ..  .     .      . ...
.   . .. . .  ......  . . ....   .    ...         .    . .  .    .    . . .    .       ..       . ....  .   .    ...    .. . .    .    ...     .
..    .        .    .   .   ..   .  ..   . . .. .         .  .  .  ....      . . . .    ..      . ..   .  ....    .   ..      .... ...         .
.. ... . . .          .       .     .  .   . .      .    .  .  .. ...   . .. .     .. ..  .  .   ...   . .  ..    . . .. .               ....  .
.      .     .        ..    .      .  . ..  . . ..   . ..  ..  .  ... .        .     . .     .   .  .         .  . .         ..    ... . .     .
....     .  ..  .  .  ...    ...    . . .      .      .    .      ..  ..  .  . . .   .  ..  ....  . . .     .    . .    .  ... .      .. ..   ..
.   .  .        ..      . . .   . ..  ...  .  . .   ..            .    ..          . ..      . ..  .  . .   . ..   ...   . ..   . .. .. ...  . .
.   ...  .. ... ..  .         .    .   ..      . .  .. ..  .  .     .. .     .  . .      . .  .  . . .    .   .    .   .....  ..       .   .. ..
... .      .              .    ..  .    ..       ..  .  ..  .  .          .. ..   ...     . . .  ..   .   ... .  .  .    . .  .     .          .
.      .. .  ..    . . ... . .     .       .    .         ..       .      . .. .   .  .. .  .       .   ..           .. .          .   ..  .  ..
...     ...   ....          .    .. .    . .  .....   .       ..  .   ...    ... .     .. . ..  .       .  . .    .   .  . . .     ..  . ..... .
..... .   . . . ..   ..  . .          . .   .      .. .  .  .    ..  ..   . . ..  . .. . .     ..  .. .   .    .     .. . .    . .  . . ..   ...
.   .  .... ..  .   .    .     . .  ... . ..      . .     .. ... ..   .       .  .        .  .   ..     .  .  .. ..    ...  .  .            .  .
.                    ..   .. .. .  . . ..     ..       .. .  .. ..      .     ..      ..      . .               ...    . .  .   . . .  . ..    .
. .     ..   .. ..  .  . .  .   .        .      .  .  . .  ...     ..  ..             .     .     .          .    .  .    .  ..     ..    .  . .
. .        .  .           .. .    ..   .  ..     .  .   . . .   ..    .  ..         . .. .       .         . ..   ..   . .. .. .   .. .  .     .
..             . .         .         . ..   . ..   .. ...  .   . .  .  . .  .  .. ..   ..           .    .  .. .    . ..   .   .     .     .   .
.    .  .   .    ..      .  .     .   ....    ..     . ...   ....  .. . .  .   .   .     ..  .. ...       ..   . ..  . . ..  ..   .  .     .  ..
...        ..     . .    ..     . ..     .       .     ..      ...      . . .          . . .  ..  .   . . .     ..         .     .  ..  ..  .  .
.   . . .  ...  .    ..   ...  ... .        .   . . ...     .           .   .  ... . ...    ...   ..        ..    . .  .      . ..  ...    ... .
. .    ..               .           .  .                  ..      .         .. .. ..  .. .. . ...   .  . ..        . . .  ..   .         .  ....
.  . ..  ..   . .   .   .   ...   .. ..    ..  .       .    .  .      .          .  ..         .   . . .      . .      ...     .    .   ..   . .
....  ...      . .       . .   .   .  . ..           ...  .   .  .  . .   . .     .. ..      ..           .. ..   ..        .   . ... ..       .
.  .  .   ..     ..     ..  .  . .                 .. .. .. .    . . .       .  .   .       .                    ..   .. .     ..... .. . .  . .
.  . .         ..   .    . ...   .  ..  .   ... .   ..      .   . ..             ..   . .    ..   .     .  .      .             .   .    ..  . .
. ..     .         .   . . .  .   .      .    .       . . .     .  ... ..  . ..  .   . .     .....  . .. .  .  . . ... ...       .   . . .  .  .
..  . . .    .    .   .  ....     .. .                     . .      .. . . ..    .       ...  .  .. .    .     .   .   .    .   .....   .... . .
.  ... .   .. .  ..  ... .  .  ..       .       .      . . .   .  .       . .  . .       ..  .  ...     .  .  .  .  .          .  ..    . ... ..
..  .      ..    .  .   .         ...   . .  .    . .   .  ..     . .  .     .       ... . ..    .   .. .          .. . .         . . .        .
.   .   .      .           .. . .. .     .. .  ..      ...     .       . .      ...  ...     .  .          .. .  .         ..  .. .  .. .  .   .
.   . .  ..   ..   .  .   .    .....   ..       .  .  .    ..   . ..      .. .   ... .    .         . .    ....    . . .. .      ..       . .  .
. .       ..  .  .     .. .   .   .  .   ...         .. ...          . . . ..    .      .    .. . . .. .  ..   .    . .  ..  .      ...   ...  .
.     . ..      . ..    .. . .  .    ..        .  .   .     .    . .            .  ...   . .   .  . .  . .   .  ..   .       .   ..  .     . . .
. .  .     .. .   . .    .  .  . . . .. .      .     .  .  .      .  .   .. . .     . .  .  .. ..  .  .   ...  .   .    ..   .  ..  .         ..
.  ..  .       ..    .  .    ..  .            .    .   . .. ...  . .     ..     .         ....                   ..   .. .. ..       .     .  ..
.    .      . ..       .    .   .   .    .   . .. .. ..    .      .   .     .  .  .  . ..   .     .  .  ..    .  ..     .  . .    . .   . .   ..
... .  ...     ..       .  .    . . ..      . . .   .   . ..     . .. .  .  .         . .        ..  . ...   .    ..        .  ..... .     . . .
.           .  ....   . .  ..  .    .  .         .     ..  .  .. . ..  . .   ... .   . .  . ..       .  . .    ...   .      .    ..  .    .  ...
... .     .       .   . .   . ..   . .  ... .  . .   ..    ..   ..   .   . . ..     .   ...   . .    ..    .       .. .   .   ...    . .     . .
.  . r.      . .  .. .  .   .. . . .   .       .... ... . .   ...   . .  ..    . .     .      .         . ....  .  .  .            .  .. .  .  .
.       .   .     ...   . .  .  .  .   .          . ..   ... ...   .        .... ..    ... . .  .   .       .     . .   .      .  .     . .    .
.. . ...    .    .  ..     .  .       . .   .  ... .  .    .  .  .  .      .  .   . . .       .     .   .   .. .           .   ..         .   ..
.  ..  . . .    .  ... .    .    .   ..    .    . . . ..  . .   .   .. .   . .   .  .      .. .  .      ...     .    . .                   . ...
.. .           .. . .. .  .. .    .  . . .        ...  . .    ..    .          .     ... .  . .     ..  .  ...       .. ... .      .   . .. .  .
..    .     .     ...... ..  .    . .     .  .  .        . .    . .  . . . . ...     .   .     .   ..   .  .. .      .     .     .   .  ...... .
. ... .   .             .  ... .   .        .  . .. .    .            . ..       . .    .  ..           .  ... .   . .  . .     .      . .   ...
. ..    . .    .   . ..   ....  .    . .  .    . .   ... .   .   . . ...   .  .  .. .   . .. .. .    .     .         .       . .    .  ..  ..  .
. ....  ... .. . . .  .            .     .. ..          .   .      .      . . ....   ..         .  .  . ..             .. . ... ..   .  .   .  .
..    . .... .    . .    .    ..   ...      ..    ..     . . ...      .   ..       .     .    ..    .. .  . ..  ... .         ..            .  .
...    .  . X.... .  . .           .      . .  .   .     . .  ...         .. .      .       .     .. ...      .   .    . .     .  .. .       . .
.      .    . .           .   ..  .  . .        . .. ... .             .   . .    .  .   ..   .  .   .   .. .  . ..  .       ..    . .  .      .
.  .  ..   . .      .   .  .   . .  .        ..  .     .   ..    .   ...    .  . .. . . ..   . ...       .   ...     .  .       .     . .  .. ..
. .  . .   . ..  .  . . ..         ..      . ..  .   ..  ..      .  . .  .  ..  ..  .      ..  .  ..    . . .  . . ...  .   .   .     .  .   . .
.     .          .    . ...      .        .   .   .. .        .         .   . ....  ..     ..     .    .    . .      .        ..      .    .....
.                ..      .   .        .          ..  . . .      .   .      .. .   . ... ..  ..  .    .   .       .   . .      . ..   . . ..  . .
.   . .   ...   . ....   .. ... .    . ....           .  .......    .         .      .    . .  .      . .  .  .  ..   ..      .      .  ..     .
. ...         .... .   ..  .        .  ..  .     .     ..   ..  ..      . .   .  ..    .   .    .. .              .    ..   .    .   .. . ..   .
. .  .   .   ..  .   .  . ... .......... ..    .   .  . . .   . .     . .   .       .   ..   .    .         ...  ....   ...  .  . .. .     .  ..
.   . . ..  ..            . .   .  . .             . ....     .  .  .   . .. .        . ..   . .. . ...   . .     .  .    .      .    .      . .
.      . . .     . .. .     .. . .            .     .     . .       .   .  .   . .  ..     .. .    .. .       .    ..    ....  . .   . .   .   .
.       .    . .    .  .  .  . .   ..   .   .   ..    . ...  ... ..  .     .      . ..  .. .     .  .  .  .. .  ..   .  . . .  .... .      .   .
. .    . .   .  .     .. .   ..   . .   .   .   .     .     . . ..  . .    ....  .       .       .  ..   .   .  .   . .     .  .     . ..      .
.    . .   .  .   . .    . ... .  .     .        .     .. . .      ...   . .   ...    .      .    . . ...  .   .   ..   . . .    . .  .  .     .
.    .     .            . ..   .       .   .   .  ..     .        .  .  ...     .. .        .. .       . .     .   .      .     .      .  ......
.. .     . .   .      .      . . .       ..     .          ..     ..    .  ..   .... .     . .. . . .. .. ..    .         .   .  .  .  ..      .
..   ..  .      ...    ....   ..       .  .  .   ...   .  . .. . . ..  .   .    .      .     .     . . .  . .   .              .. . . ....  . ..
.  .     ..      . .      .       . . ....    ..          .             .  ... .    .  .   . .  .    .  .     . ... ..  . . ...          .  . ..
.   ...        .  ..  .   .    .....      . .  ..    . ..   . .  ..      . .     ...     .             .    .   . .     .        .   .         .
.. .          .       .  . .    ..   .     .  . . .    ..  . .       .       .    ..    .    .      ..  .  .       .  .         .. .      .    .
. .     . . ..  ..  .      .          .     ... ..    . ....         . . .  ....  . .  .  ..   . .  . .      ..   . ..   .     .  .. ..   .   ..
. .   . ..... .. .    . . .       .    ..   .      . .     .   .  .  .... .    .  .   . ...  .                  ..     .   .      .     ..    ..
. .   ...           .  . . . .        . .. . .     ..    . .   ....    .       .   . . . .       ..   .  .  ..    .   .       . . . .  .    ....
.   ..    ... .   .         .. ..    .     . ... .       . .. . . .        .    .              . ..    .  ..      .      . .   .  .   . .   .  .
.. ..     .... . .  .   .   ..        .  ..   .      ..  .  .  ..          .. .          .        .       . .    .  . . .   .. . .   .         .
.. .    .         .         . .   .    .   ..  ...   ..     .  .     ..    .      .            .    . ..  .    . . .. ...   .  .      ...    . .
.    ..  .          ..  . . .      .  .       . . ..    ..               ...      .  .   .         ..    ..          .  .    ..      ..  . .   .
. .   .   .  .    . . . ...  ..   .... . . . ...  . ...     ...    . ...  .  .   .   .    ..  .   ..   .       .           .   .  .    ... .. ..
.   .    ...  .      .          .  . .  .   .   .      .    .  . .. . .  ... .   . ....  ...      ....    .  ....   .   . ..  ..   ... .    . ..
. ..  ..... . .   .         .    .        .   .       ....    . .        ..    .. ..          .     ..  ...  . .. ..   .        .... .  .      .
.   .. .  ... . .   .. . .   .  . ...   .   .    ...    ..  . ...... .   ..   .    .     .  . ..  .   .   . .   . ..       . . ...        ..   .
.       ..    .       . .     .   .    ...  .  .  . ..  .      .         ..     .    .. ..      .  .. .    .. .  .      . .             .     ..
.   .     .    .. .   .  . ..  ... .          . .      . . ..  .  ..  .     ..       . ..   .       . .           .    .    . . .          ... .
.     ..   ..  .  . .  .  .  .        .     . .. . .    .  .     .  .    . ... ..         . .   .  .   .   .   .     .     ..    .    ..  .    .
.            ... .    .  .  .  .  .        ..  .    ..    . .. .     .        .  .. . ..  .   ..     .. .     . ..   .   .     .. .    .    . ..
................................................................................................................................................
