.................................................................................................................................................
.      .  ..         .   ..... . .. .  .      .. ....  .  .       ..     .     ...         .         ...    .  . .  .   .   .        .  .   .   .
.  . . .  ...     .    . .   .  .  .  ..  . .  . .     ..  .      .     . .     ... .  ... .  . . ..       .           .    .. ..   .  . .      .
.    . . . . .. . .  .  .   .  .        .     . . .   . .   .   .. . ...   . .. .      ..         .      .   .   .     .....     .  .       .   .
. .   .  .       .    .  .  .          ..    .    . .   .     .  .    ....        .   .    .   ..  ...       .          .  .    .    .    ..  . .
..  .  ...  .  .    .        . ...          ...        ..   .   .   ... .   .   . . .    .  .     .  ..  . .  .. .      . . . . .  ..      ... ..
. .. ..   .. . .       .  ...  .. .   .   ..         .   .     .        .. .   ... .   . .         . . ...   . ..    .    . ....  ...  .   .  ...
.  .  ..    .   . .    .  .    ..        ..   . . .  ..    ...  .    .     .   . . . .   .    .       ..    .    .        . .  .. .... ..  . ....
. ..  . .  .    . .   ..     . .         ..           . .. .  . ...    .  .                     .. .  . . ...          .     .. ..   ..    .    .
.   ..    .  .  ..       .      .  . . . .  . ..  .       .    .  . .   .   .            .  .       . ... ..   . .  ..   ..  .  . ..  ..      ...
.      . .  . .  ..  .     .     ...  . . . .. .  .    ..      . .      .     .  ..   ... .  .         .      .. . .       .  .       .   .  ....
. .. . . ... .  . . ..  .   . . . ... . . ..  . .         . .. ..      . ... .  .. .  .               .  .    .   ..    .  ..   .    ..       . .
.  .     . .  . ...  ..       .   ..     . .. .   ..                 . .       .  .  ..                  .  . .     .. . . . . .    .   . .    ..
.  ...  .    .   ..     .      .    ...     ..        . ..        . .         .   .     ...   .  ..    ..   ....             ..  .    .         .
.     . ....     ...  .   .. .. ..... ..    .    ... .  .. .  ..  .  .  . .. . ..     . . . .    . .    .. .    ..       ..   .      ...       ..
.    . ...  .  . .. .    .         .  .  . ..      ... .....       . .    ..    . ..    .  ... ..   .. .      .. .     .         ..  .          .
. ..     ..  .. .  . .           .  ..    . . .  . . .    .   ..      . .  ....        . .  .     . .       . .   ..  .   . .    .... .     .   .
.....       ..   .               .          .           .        . .  .          . ... .  ..        ..    ..    .    ..    .    .       .  .    .
.. ... . ...         .  . .       .. ..     .     ..   ..  ..     .   ...     .  .        .   .  . .  ....      ..  .          ..    .. .  . .  .
.  ..   ..   .            . .   .  ...  .       .      ..    . . ..       . ..         ..       .      .  .  .. .   .  . ..    .  . .. . . .    .
.. ..  . .  .     ... .    ..  .. ...   ..   .       ..          . .  .         ...            ...    ..    . .... ...     . .... . . .. ..    ..
.      .. .  ..  .  . .        .           .  ...    .   . .  .       .  .    ..   ....    .. .     ...  .  .                . .   . . . .  .  ..
.   .       ..   ..      . . . ..                 ..       .  .  ..  .   .  .    .      .     .              ..  .       . .  ....             ..
.    .  .     . .   .   .    .  .  . . ..    .. ..           .     .      .       .     .   ..         . ...     .  ..   ...    . .  .    . ... .
. . ..  ..          .  .     ..    . .    . .  .    . . .            .. .    .   .   ... .   .  .  .      . .. .. .  .     ... .   ... .     .  .
. .         ..    .  .   .      ..        ...     .. ...   ...  .   . .           .    ...    ..   .     .  .         ... .. .. . .          . ..
.     .           .        .  . .          ..    .     .  ..   ..   . .     . .  .    .   .     . .      .. .  .       . ..   .       ..  ..   ..
.  ..     .  .         .    .. .  .    .  .     .    ... . .           ..          .  .. .. . . .     .     .    .  . .  . .        ... .  .    .
.  ...   .        ..  . ..   .  . .     .    .      . .. .        .    .   .  ... ..    ..  .   .     ..          ..  ..  .    . .. .     ..   ..
.     .  . .  . .              .  .  ..          . . .   .        ..     .  .      .  .  .. .. .      ..         .  .  .   .. .. .    .      .. .
. .. ...   .     .        .     .      .. .  . .....      . .  . . .. .  .        .   ... .   ....        .     .   ..  .    .   . .      .    ..
..   .. . ..... .     ..  ....  .    .  . ..  ... .  .  .  ... .       . .    . . . ..       .         .  .         ...                    . .  .
.  .        ..   .  .. .           . . ..   .        .  .  .          ..   .  .   .  .       ..   .      .   .   . .   ...         .            .
.... . .   .   .   .   . .       .    ...   .         .         . .  . . .....   ..   .   .. .   ... .  .  ..    .      .   . ...      .      . .
.   .   .     ..   ..  ..        .   .       ..   .   . ..  .   .          ..  ..  .        ..  ...  .      ..      .  . . .  ..       .    .   .
.   .    ..  . .        . ..      . . .  .     .      .   ..    .       ..         ..    .  .    . ...       .  .      ...  ....    .  .  .   ...
.   .. ..    .. ... .  . .  ..    .  ...  ..         ...   . ..  ..     .   .      .  .     .. .     . . .... . .  .       .   .   .. .     .   .
.     .   . ..   .  . .. .   .  ..         .     .  .   .  ..   .        . . . .     . ..       ..        . ...   . .       .      ..    .   . ..
.   .        .  . .          .       ... ....    .       .   .   .  ..    .  .  . . . .  .  .          . ..   .. .     ...    . .    .          .
.  ...   ..  ..  . ..  ... .     ...  .  ..    ..      .    .   ..     .    .   . .    . ...  .   .      .               .   .  .   . . . .     .
.. ...       .. .     .      .   .        .                .   ..   . .   .   .   .   . .  . . ...           .  . .  ... ... .. .   .  . .   ....
.   .    .           .     .    . . . .   . . .                            .   .       . .      .  ..  . .            .   .   .      . .. .. . ..
. .  .    . .  .     ..       . .      .    .   .. .       .  ..   .... . .     . . .        .  .   .     .    .    ..        .         .       .
.  .  ..    .  .   ..  .  ..       ..   .                 ..     .. .  . .  .         .   .     .    . .    ... . . . . .     . . ..  .       ...
.  ..  . . . .  .       .     .  ..  .    . .    .... .      . .    .  .  .       .  .      .   ...  .. .. ..   .   . .   .   ..    .         ...
.     .     .      .  .. .  .   . .   . .... .   .  .....  . ...     .    ... ..     .       ..   .  . .. . .      .    .. .....   ...   .  .....
. . ....  . ....  .. ....        . .    .  .. . .  . ..      . .   .  .   .    . . .    .            ..   ...  . .   . . ..     .     .   ...  ..
. .. . .              ..         .          . .    ..       ..  .          .     .  .    ...  . .  ..          ... . .      . . .     .   .     .
....  .   .           .. . . .       .  ..  .    . .  .  .     ..     .    . . . .  .   .      ..  ..  ....   .    . ..   .. .  .  .   .     .  .
.   .  .   .  .   ...      .. . . ...      .    .   .        . .    .   . ..     .     .  ... .                    .     .     .   .    .. ..   .
.      . . .     ...   .  .  ..  . .   .  . .     .   .   . .     .  .. ... . .   .   ..      .         .         ..          ...... .      .   .
..   . ...  .   . .       .    .. .  ..  .  ..    .     .   ..         ....     . . .  ..             ...     . . .       .        .   ..       .
. .        .        . .   . .    .   .  .          .   .       . .    . .      ..    . ..  ..    . .. .  .     ...         .  .   . . .     .   .
.     .  .       ..  .  .      .   ..  ..   . .  .    .     .    .       . ... . ..   . .  .. .   .  ..  .. . .   ..      ..  ..  .  .          .
. . ..   ..     .   ..         .  . ..     . .   ....        .   ...   . .    .        .  . .   .  .  . ..          .        .            .. .. .
...               . .              .  . ..   .        .       .   ...  . ...  . . ...   . ..  . .       .       ....  .    . ..  ..  .. .    . ..
.   . .  .   ... .     ... .       ..     .. .        . .          .         .   ...    ..    ..  . . . . .  ..    .  .    .      . .  ..... .  .
... ..  .  .  ..    .... .  .   .    ..  .  ... .     .   .   . . ..  ....  .    ..    .      ..            . .     .    .    .   .           . .
. .    . ..  .  .    . . ... ..  . .      .    .. . .    .. .      ... . .  .   .   .    ..    .. .         . . .  .. ..  .. . . .      . . .   .
. .     ... .    .    .    .   . . .   ..    . . ...      .        .       .    ......   . . . ...   .. . .       .   . .   .  .  ..      .     .
.           .. .       .  . ..  ..   .  . .   .       .    ...  .    .. .  ..   .  . . .       . ... .    . . ..         ....     .  ..     ... .
. .   .         .  .   .  ..  . . .    .  .    ..            ...    ..       ..  ....   ...  .   .      .    .  ..  ..  . . .     .....  .  .   .
.  . . .       .   . . .    .  .   . .         .     .     .         .  .       . .  .... .  .  . .  . .       .     .  . .  .  .   . .         .
.  ..  ..         ..       .              .  ..   .   . . ..  .  .   .   .  . ...             .                .   .    .    .        ..   ..  ..
.   . .  . .  . .  .  .   .      .  . .    ..  . .   .  .     .  .      .  .      . . .. ..   .          . ..   .    . .  .      . . .    .   . .
.    .         .    .. ..   .     .     .    .   .    .  . .  .     .   . .   ....   .   . . . . .     .     . .  .      . . .        ..   ... ..
. ..  ..  .  ..... ...         ..      ....  ...    .    . . .   .. .    .  .  .      ..     .  ..    .     ..    . .            .  .     . . ...
.   .  ...       . .   .  ..   .      .      ..   .    ..    ..   . ..      .  . . ..  .     .                . .  ...   ..   .. . .   .   .  ...
.. .      .             . ..... ..     .  .    .  .     .  .    ...  . .    .... .    . ..    .. .  .    . .   .   .  . . ...    ..  .    .     .
..       . .     ..   .  ..  .      ..     ...  . . .     ....        .  .  .        . . . .. ..  .    .                .  .. .   .           . .
..    . ...        .  .             ..   ..   .       .  .        ..  . . .  . . .  ..   . . ...   .. . .  ..      ..    .    . .  ..  ..  .. . .
.     .             .          .   .          . . ..  ...  . .   ..  .     .            .   .    ..... ... .  ..    . ..  ...   .   .  . . .    .
.. .  . ..          .  .     .   . .  .       .. .. ..     .. .   .        . .  .     .  . .. ... . ...  .. .    .       .        .    .        .
. .. ..   .    .       ..        .           ... . . . ..   .. .      . ...        .    .  ..   .. . ... .. .            . . .  .  .  .         .
.     .... .  . .  ..    .   ..         .  .  ..         .  .         . .     .       .     .. .     ..   .. .   .   ..   .   .   .   ...   .. ..
.  .     . .. ..       ...   . .  .    .  .   .   . .     ....           ..        . . ..  .  .   .     . .     ...     . . .    . .   .     .  .
..... .. .       ..  .      .. ...       ..   ..  ... .   .   . .. .  . . . .         .              .  . ...   .  ..    . .      .    ..     . .
.  .    .   .... ..    .    .  .             .           ... .             .  .  ..    .    .   .. .   . .  . .  .    .   .  .         ...    . .
.  .   ....   . .  . ..  .     ..     .    ..   . . .  .  .  .        ..    .       ..  .    . ... .    .    .  .   .  . .   . .       .    ..  .
.            . ..     . ....   . .  .   .   .. . .  .      . .  . . .      . . .  . ..   . .      ..  ..    . .  ..    . .   .     .....  ....  .
..     ....  .   .      .. ..    .      .  .  .  .   . .     .   .     ..     .   .      . .    ..    .  . ..     .  .. .  .   .    ..          .
...  .  ..     .       ... . .  .          .   ..         .   .      .   .  .     . .  ..  .   . .                 .    .   .      .       .    .
.  .        .      .   .. . .      ..    . .                    ..       .  . .     .. .         . .  .. ....    .          . ...    . ... .    .
..  .  .         .    . .     . .  .       ..  .. .  .. .  . .          . .      .  .  .     . .   .. .  .    ..        .   . ..         ..     .
....   .. .. .    .       .     .     .          .  .     ..        r... . . ..    .  .. . ..  . .  . ... ...     . ..    .      .    .     .. ..
.   .   ... ..  .  .        . .  . . ...  .      .  .. . .. .     ...      ....  .  . . .  ....  ..   . .   ...     ..  . . .    . . ..... .  . .
.   ... . .. .  . .  .     .  .   .. ... .  .   ..         .. . ...  .  . .  . ..  ...   . . ..  ..  .         .      .  ...  . .  ..       .....
...  .    ..     ..     .   .  .  ..          . . .   . .    .  .. .   . ..  .. .     .  . ..  .  .. ..  ....  . .      .   . ..               ..
.   .  .  .          ...       .      .  .     .     .   . . .... ..    ....    .  . .            ..   . .....  ... .          .     .... .   ...
.  ...      .    .   . ..    .    . ..     . .   .  .            .   . ..   .   .   .          .  .        .      . . . . .  ..          .   .  .
.     .  . . .    .          . . . ..  . ..           .   .   .....     .          ..   . .       .  . ..   .   .     ..     . . .     ....     .
.  ... .   . ..      ..  .   . . ...        .. . . ...   ..   ..    ..   .   ...    . .        .    ..    .. .        .  . . .        . .  ......
.    .. . . .     .   .  .            .  ..      ..              . . .  . . .  . . . . .  .    .  . .       .    . . .   . ..    . .    ..  .   .
.  .  . .. .  .        .  . .  .  .  . .    .           ..  .    . .   .. .     .       .   ..     .  ..   .   .. .    . . .  . . ...  .     .  .
.    .      ...  ...   . .      ..   .. ..   .. . . ...      .  .  .              . . . .          . ...  ....    ...   .     .       .  .  . . .
..  . ..   .   . . .   .. .      . ..          .   ..   .      .   ..  ..     .          .... .   .      ....   .    .     .    ...       ..  . .
. .   . .   .   .  .     .       .  ..  . . .    .. .   .. .. ..       .       ..     ...    .   ..    .        .  . .  .  .       .. .   ..  ...
.  .. .  ..   .  ..     . . .   .   .         .. .     ..       .     . . . . .           .       ..   . . .   . ..     .   . ....        ..  . .
..    . . . .       ...  .   .   .    .   . .  . .  . .  .        .  .    ..      .      .   .    .  .   .    ...    . ..    .   ..     .  . .  .
..     ..     .     ..    ..       .    . .  .     . .    . .   .     .   .. . .  .    .   . .. ..  ..  .     ..  .       .. .  .. .      .    ..
... .  ..    . .      .       .  .  .       . .  ...    .         . .     .     .      .    .  ...  .. ..       .   .   . ...      ..   .       .
.. .  ..      ..      .     .       .. ... ....   . .    ....  ..        . .   .          ..  .  . ..... .....  ....  . .      . ..  .     .. ...
. .     ..  .  . . .          . ...     .   ....   . ..   .     .   ...   . . . ..   . .      .  ..    .....  .   ..         .. .  . .    . .....
..    .     .   .           .       .   .    .     . ..   . . .   .    ..  ...    ..    ...   .  . .  .   ..   .   .    .      .       ..    .  .
.  ... ..    .         .  .    .   .  .       ..    .        .    . . . .      .    ... .  . . .  .  ..      . .  .    .  .      . . .   .... . .
..  .       ..    ..  ... .  .. . .    .. .   ..    .    .    .         .   .       ..   .   .  .       . ..       . .  ..  . .    .   . .  .   .
. .       . ...  .  .      .   ... .     ...  . .       ..    ..       . .  . . ..  ..   .. ..      .         .  .     . .   . .       .   .  . .
.    .  . . .  .  ..   ..    .      ...             ..   .    ..  ..... .      .      ..  ..     . .    .    .   .     ...    . .  .   .  ...  ..
...    .        .   . .        ..  .        .     .  .. . .  . .  .         .   . . . .   . .   .     .  .      .                .  .      ..   .
. .      . .... ..   .      . .    .  .  .  ..   ..  .    ..  ..   ..     . ...         .  .  .. .    .   ...             .     . .. ..       . .
.. ..   .    ..  . .  .      .  .  .  .. . .   .    .    .. . .  .   ..     .       ..      .      ..     ..   . . .. .  ..  ..    .    . .. .. .
.. ...  ... . . .. . .. ..    ...    ..   .  .. . ... . .. ..     .    . .  .    . ...   ..   .   .. .        .  ..          .  .      ..     . .
.  ..        .  . .   . ...      . . .. .. .     .       .          .  ...         . . ..  .    .  . ..   . .  .   .... . .. .    . ..  .    . ..
. .           . ....    .  .  .      .       ..   .          ...     .    .  .      ..  .. ...  ..... . .   . .    . ..       .   . .. .   .    .
. ..     ..... ...          .   . .    ..  .     . .. ...  .        .. .     .   .        .  .  ..    .  .. .        . . .  . ..  ..  .        ..
. ..   .. .  . .   .  .  .  .  .       . .  . . . ..         .  .      ..            ..  .. . .     .  .. ..     .          .  ..     .  .  .   .
. .   .. .      ..       .     . ...     .  .  ...     .      ... ..     .. .   . ...    .   . . .  .      ..    .  ...   . ... .   .  . ....   .
.    ..          .        .          .      .       .. . . .    .           . . .  .  .  .           . ..  ..   . ...         . .     .     . . .
..  . .    ...       . ...    .          .    .   ..                .   . .    . .   ..   ....   .       .  . .  .       . .. ..  .    ..  .   ..
.  ..   ..   ..  ..    ...    .    .   ..    ...        .. ..  .     .     .  ..      .   ..  .     . .   . . .   ..  .    . .   . .       .    .
.  . . .   .                    .    .    .  .    .....  .          .      .     . . . ..    ..  .  ..  .          . .   .   .  .. .   ...  .   .
. ..  .   ....   ..   .  . .  ..   ..   ...               .  .   .  .    .      .         .   .   .   .. ..     .  .    ..      .  . ...  ..    .
.              .  . ..   .     .     .  .    .   .          .  ..         .   . .             . .  .     .     ..  ...  .   .  .     .        ...
. .      .  .          .   ... ....  .  . .     .    .... .   .     . ..    .      ... . . .              .. ..    .  .    .  . .   .  ....  .  .
..  ..  .   . ..  . .   .    ..     .   . .    ..     .       .   .               .   ..  .   .   ..      .  .  . .  ..  .....    ..  .  . ..  ..
.   . ... ...  . ..     .      ...... .  .   .   .     .  ....  .  .   .  ... .     . ...  .      .  .   .    ..  ....   ..     .       .  .    .
.       . .. . ...    .      . .  . ..    .   ..    .  .       .   .      .      .          .     .. .    .      .....        .    .  .        ..
.   .  .       . .    .           .    . .  ..   . .....    .  .  .    ....      .             .....          .   . ...     .    .  .  ..   . . .
......    .   .. .. .  ..  ..        .       .    . ..  . .  .     .    .    .    . .    .   .                 . .  . . ...              .      .
.   ..   . . .. .   .       .. .   ..  . ..      .    .  .     . .   . .    .    .    .      . .   . .  .  .. . .     ...   ..              . . .
..   . .  .  . .  . .. ..  . ..     .    .. .      .    .  .    .. .   . .   .. ..     .  .     .    .       .  ..  .  .     ...  .      . .    .
..      .. .     . .. .       .     .          .  .         .. .   .   .    .  . . .. .  .           . ..    .  .  .  .  .   .        .....  .. .
. ..   .  ..     ... . ..  . .  ...   .  .      ..   .. .          ..     .    .  ....     .  . .  . .    . ..  . . . . . .      . .            .
.        ..           .  ....  . .   .            ..    ...     ...  ..    ..  .    ..    . ..  .. .     . .        .  .     .  ..   . .   .    .
.   .     ... .  ..  .       . ...   .  .    .      .   .. .    . .  . ... .       ....    .      .          . .      .    . .   .   ...        .
..    . .      .     .        .    .. .    .    .     .  .        .        .  .       .    .    .    .. .   .      .   ..   . .. . . .   ..     .
..     .. ..          .   .   .     . .    . ..   . .       .. .  ..     ..  ..   ..  .    .     ..  .. .     ..   .  .    .         .     . .  .
.         .    .....  ..    .  ...        ...     . .      .  .      .. .  .  ..    .   . . . .  .   .              .  ..    ..    .   .  .   . .
.   .. ...  .  ..    .   .  . .    .. ..       ..   . .    .   ..  .   .    . .  ..   .  .    . . . . .    .  ..     . ..  ..  .. ... . .....   .
.    ..  . .     .    ..     ... .   .   .  .. .  .  . . .  .      . . .   .  .. .. .    ..   .  . .  ..    . .  ..   ..     .      .    .  .  ..
.   .   . . ..         .       . .  .  ...  ..  .. .     .        .    . ..  .  ..  . .  .. . . ..   .   .   . .   ...      ..            .  .  .
.   .   ..  .        . .    ...    .     ...   .       .   . .            .   .  .  .   ...  ..   .     . ...    .      . . . .. .   .  .     . .
..  .     .    . .     ..     .. .       .  .  .    .    X .  .  .           .  .  .  .   .   ...   ... . .. .  .  .  .     . ..       .  .   . .
. ..    . .  .   . . .     .. . . .       . ..  .   . ....      . .  . ..   .                   .  ...  . . .    .  . ....  .             . .   .
.................................................................................................................................................
