..................................................................................................................................................
.  . .         . .  ..  .   .    . .  ..    .      . . .  .  ..   ..  . .    . ....     .     . ....           .              .       .  .       .
.. . .      .  ..    .. ..   .          .         .           . ..    . . .    .      ..  .   .. .     .  .  ..   .. .. . . .. .   .   .   . .   .
. .      .       ..  .. .      ..   .  .  .. .. . ....   .  .  ...  .       ...  .  . ..    .     .  .  .   ...    .       .    .     ..  .      .
. ..     .. ..      ....   .. .   . .   .   .  . .  .   ..  ...    .  .   . .  .   .      .. .              .   .. .  .   . .     .  ..          .
. ...    . .      . . ...  . ..     .   .  ..  .     . ..   . ..          .    .            ..  . .     .        .    .     . ..    .  .  ..  . ..
.  .    .  .   .   . .. .     .    .   .  .           .  . .  .              . .      . .  . .           ..     .  . .  . .       . . ..     .   .
.            ..    .  ..   ..        ..      .         .  ..   . .           ...   .        . ..  .. .  .  . .  . ..     .   .    .. .   . .     .
.   ..      .   . ..     .  . . . . .    .    ..    ... .      ....  . ..  .   .     .     . ..  ..   .   . .    ...             .  ....  .      .
... .       . ... ..  .   .   .       .       . ... .  .  ..   .  .. .   ..     .  . ..    .                 . .  ... .  ..   ..       .     . . .
.. .       .  .  . .  ..  .            .                 ..     .  . .          ..   .   .   .     .      ..  ....   .    ..  .    ..   .    .   .
.   .  .               .. .  .   .. .     .        .. .. .   .        ..  . . ..   ..        ..       .  .. .     .    . ..  .      .      .     .
..  .   ..  .             .      .   ..  .   .       ....     .. ..  . . .... .    .    ..  .     .  .    .    . ..   .    . .    .    ..        .
.        .  . . .   .     ..  ..             ..  .  .            ..   .  . .   ..    .      ... . .    . ..       ..     .  .     .  .  ..  .  ...
.  .   ..  .     .  .    . . . ...     ... .    .   ..      . .                 .. ...    .  . .  ..  .            .   .  ..                     .
..    ....    .. ..  ..   .      .   .    .    .  ..     .   .        . . ..  .    .   .   . . .   .  .  .. ..       . ..     . .    .  ... .    .
.    ..   . .  .    .      ..     .  .. . .. .  ..    ... ..   .     .     . .  ..           .       .   ... .          .     ..          . ... ..
.     .  . .   .   .     .  .  .. .  .       .   . .       .. . .. .  ..  . ..  . .    .   .   .     .       .  ...   ..  ...     .    .   ..  . .
.         .. ..   .  ... .  .  .   .       ..   .        .   ..     .          .         .   .   .  ..   . .    . .     ..  .            ..   . ..
..  . .   . . .   .. .   .    .      .  .  .            .X.....   . . .          .   .  . . . .   ..  .. .  .    .   ..  ..    .   . . .      .. .
..        .... .     .             . ...     .. .  .  .   . ..  ...  .. r .. .   . .        .  .  .  . . ..    .    .         .    .   .  . .    .
.  .     ..    .   ...   . .. ..    .     .   .  . .           ...      .... . ..  ...           .. . ..        .   .       ..     .  ...      . .
.         .      . .  . .   . ...  .                .    .   .  ..    ....   .     .  ....     .    .     .  .         .   .  .     .    .  .    .
.   .  . .   .  ..   ..     .       ..       . ...  .        .  . .       .     .        ..       . . .    .            .       .   .. ...    .. .
.         .       .   . .  . .      . .      . ... .    .  .       . .      .        .  .   . ..       .. .    . . ..  ...    .    ...         . .
. .  . .     .  .    . ..      .   .. .   .      .           .   .  . .  .     .. . ..     .     .      .    .   .  . .       .     . . ..  . .  .
.   .    .  .. .. . ....    .. .   .. ..   .  .. .    .  .   .     ...    ..     .  .  .  ..  ...   . . ..  . .. ...      . ..    .... ..  ..  ...
.    .  ..    ..     ..  .     .    .  .      .      .  .  ..     .     .  .  . .       . .       . ..      .       .  .      . .    .     ....  .
.      . .   . . .  ...   ..     .. .. . .  . .   . .    .   ..   .. .    .      . .     .     . .    .   .   . .       ..       .  .  . .  ..   .
.  ..   .              . . .    ..        . .   . . .  ...   .    ..      ...   .   .. . . .   .   ......             .. .  .. .    . .   ..   . .
....      .  .. .  ..   .    ... ..             ..  ..     .        .    .   ..      . .      ..  .  . .            . .     .   . .   .  .. .    .
..      .              ..   .. ..    . .    .      .  .   . .   .      . . .       .. .  .  .   . ..  ..   . .     . .        ..    .  .  ..     .
. .   .   . .      . .  . .  .. .  ..       ..       .      .   .     ..    .  .   .      .. .   ..     .   .        .   ...    .   . . .  .   . .
.        .     . .   .        .   . .      ..   . .  .      .      ... ..   .  . .    .  .         .      ..   .   . . .. .   .. ..  . .     ..  .
. . .  .      .     ... . .       .     . .. ..  .   . . . ... . .    .   ....     .. .. ..  .. .   . .  ...    ..      . .  ..  . ..  .. .  ..  .
.. .        ..    .    . ..   .    ..    . ..       ..    .. . .   ..   . .. . . ..  . .   .   . .  . .       .  ..  .  .. ...   .  . . ..     ...
. .    ...   .      .        .. . ... . . .    ..    ..       .   ...   .  ..     .       .   . .             .   .    .. .     ... . . ..       .
. .   .  .  .  ..   . ..  . .    .    ...   .  .  ..   .     .     .   .   . .  .. .. ...      .   .      .   .   .    ..  .    ..... .   .  . ...
.      ... . . . .. ........    . .  .    .  . .      . .  .       .    ..  .. ..    . . .        .  . .  ..     .. ...  ... . .           ....  .
.  ..    ..     .      .  .   .      .....      ...    .. .  .   ..    . .    .  .    . ..  . ..       ..  .        ..        ..    ..       .  ..
. ..   .    . .      . . .. . ...   .      ..   . .. . .   .    .      .     .  . .    . ...     ...  .           . . .  .. . .... .     . .  .. .
. ..           ..    .   . . . .   .   .    ...      ..    .    .      .. . ....    . .   . .         .  ..  .    . .     .  . .   .          .. .
..   ..     .   ...  .    .    .  ...  . .    ..    .       .. .  .   ..               ...     ... .      .  .  .        .   .  .     .. .. .    .
.   . . .      ... ..  ..    .    ..    . .       .       .   .      . .   .    ....     .  .. .. .      .         .. .      . .      .   .      .
. ..  . .    .  ..     . .  .   . .   ... ...                 . .       ....... .   .  . .     .  ..        . . .  .   .    . .. . . .  .       ..
..  ..  . .    .. . . .    .   . . .    .   ..   . . .  .    ..   .     . . .   .           .     .. .. ..           .              ..   .    .  .
.   . .  .  . .          ... .     . ..  . .   ..      ..      . .      .        ... ..              . ..   .            .. ... .   ..    .      .
... ..    .   .     .  .      ..    ..     . .. .    . .  . .       . ...  .  .    . .  .. ...    .   .    .  . .   .   . . . .    .   .  ..  . ..
.    .     . .     .    . .      .. ...            ..   ... ...    .    ...... .  .          .. . .     . .     .    .  .  .   .         .   . . .
.      .   .   .   .   .    . .          . ..  ..    .     .      ...  .  .    .     . .     .    .    .     .  .   ... .  ..  .      .. .  . . ..
..          . .         ..        .    .   ..     .    ...    .    .. .  .    .          .. . .  .  ..       ..  ...   ...   .  . ..   .  ... ....
.. .  .  .  .  . .    ... .  .  ..   .   .         . ..  ...           ..      .    ...      .        ...  .. .. .   .   . .  .        .         .
.  .  .. . . .     .      . .  . . .. ..  .    .. .  .         .           .      .   .. . ..   .       ...   ..       .    .           . ... .  .
. . .  .    .    ...   .   . .  .  .  .   . . ...    .  ..  .  ...        .  . .   .  . .. . . .        . .   ..       . .     .  ..  .     .    .
..   .    ...  .     ...   .     .. .      .    .. ..    ..    .   . .   . . .         .    . .. . .   . .  ..   .     ... ....   ..   . .    .  .
. .   ...  ..  .  ..  .      .  . .  .    .        .  .  ...      . .      .. .  . .                . .  .......     .  .  . . . .  .       ...  .
..    .  ... . ....  .    .  .   ... .. .    .    .          .   .. .                   .   . .         ..  . .   ....      . ..   .. . .  ..  . .
.   .   .  ..      ..  .     .    .. ....   ..    .   .  .   ...... .   .       . ..  .    ..  .      .  . .      . . .      .. .  ... .      .. .
.      ..   .     .    . .  ..   .    .   ..  .     .  . . .              .  ..   .    .              ..        .   .. .. .   .    .     . ..    .
.. . .  .     .  .   .  .  .   ..  .   ....   . .. ..        ..   .            .  .  ..      .       .       .  ..    ..       .      .  ..   .. .
.    . .....   . .      .             . .         ...       .  ...  ...   .    .   .. ..    . .   ..    . .  .  .  ....      ..   .  .      .. . .
.  ..  .... . .   .  . .       .  ...          ....     ..  .     .    ....    .  .     .    ..         ..  . ....    .     ...  . .. .         ..
.   ...   .  .  ..  .  .     .    ..      . ..       .    ..   .    .. . .        .        ..             ..       .   .      ..  .      ..      .
....  . . ..      .            .   ..     .....    . ...  .. ..    ..... .          .   . .. .   ...   .  .     ..         .. . . ...          . .
..   ...  ..  .. .  .      .  ..     .. ...    .   ..       .  . ..           ..     ..  . . ..    ..   .   .....  .  . . .  .   .    .       . ..
.  . ..    .      . .   .    .     .  ...           .    .    .  .  . .      .      .     .  ... .    .   .       .     ..        .      ..  . . .
.  .        ..      ..  .  . .  .  .. . . .     . ...     . ......   .   .   .. . .. . .  .  .  .      . .  .  .   . . .  ....         .     ... .
.  .   .      .   .       ....   .     . .    . ..   .  .                   ... ..        ...        .      .  .     .   .   ..   ..   ...  ..   .
.   .   .    .    .. .             .  ..   .   .      . .    . .   .     .    .           .      . .      .  .   .     .     .       .  . . .    .
.  .      .  .    .     .      .  .   ...    ..   .       .  .. .   .   .  ..      .  .    . .  . .   .        .  .           ..  .. . ..  . .   .
.    . ..      . .   . .    .  . .     .     .. ..     .  .  .....    . . .     .    . ...       .    . .    .   .. .  .   ..   . .    . ..     ..
.  . .        .  . .  .   .    .   .   .... .        .         .. .   . .       ..     .  .   . .   ..  . .      .    . ...  . ..    .  ....  .  .
.  .     .   .           .. . .    .          . . .     .  .  .  ..   .  .....            ..  ..  ..      .    .             .   .   .      .  ...
. .   .      .    .   ..   .    .  . .  . . ..  ..  ..  .  .    ..    .     .     ....   . . .  .    ..    ..       .  . ..    .     . . . ..    .
.    .  ..... .  .        ..  .         .   .     ..   ..    .    . .  ..       .  . .     . .  .  .    . . .       ..      . .    .  .  . ..   ..
.   .        .. .  ..      . ...  .   .       . .  . . .        . .... ..      . .    .   . ..                              .   .    ..  .       .
..   .     .   .. .   .   .   .   . .       . .  ... . .  ...  .    .    .   .        ..    .   .  ...   . .. .       .        .      .   .  . ...
.  . .   .   .. .   .     .     .  .....     . . .   .....  . .    .  . .  ..    .   ...  .. .  .  .         .    .  .   . .    ...             ..
..   .       ..      ..     . .    .         .. .    .......               .        . .   .      ..    .. ..  .  . ..    .    ..  .. .  .        .
... . ..    .          .    . .  .. .   .  . .  .   .             ..            .     . .. . ...        .. .  .   . ..   . ..                    .
.          . ..  . .   .      .  .    .  .....             .. .      .                    .      . . ..      .    .. .   .           . .       ...
..  . .  .           .  .    .  .    .                             ..    ..... ...     . .       .    . .  .     .  ..   .      .  .       ..    .
.   .    . .   . . . .   .  . ..         .  . ..  ..    . ..    .        ...  .   .  ...     .       .      . ...   .  .     . .   .          .  .
.  ..     .  . . . .     . .  ... ..  ..        ...      ...       ..       .      .  . . . . ...... . .      .          .    .   .  . ....      .
.       .   .    . .        . . . ..       ...    ... .  .          ..  .    . .   .  .... .    .       .         ..  .        .      .  .. ... ..
.        ..  .. ..         .  ..  .           ..     .      . .   ..       ....    . .      .   . .     .   .     .                  .     .     .
.. .   . ..   .      .          .     . . ..    .        . . .     .    .  .  . .   .. . .     .   ..  .           ..     .. .   .    ..  .   . ..
..           .   .. .    ...        .   ..        .           .  .            .  ....     .. .         .   ..      .  ...  . .   ..   .  . . .   .
.       . . . . ..  ..             .  .      ...    . .   .   .. . . . ..  ..  .        .    .       ..   . .        ..  . .  .  ..  ...      .. .
. ..  . . .       .  . . .  ..      .    .         .         .  .      . .        .     . ..  .      .      .  . . . .     .. .....  . ..   ...  .
.    .    ...       .     .   .   .       .  ..        .         . ..    .  .  .    ..      .. .. ..   . .  ..         .. .     . .   .  . .    ..
.. ..  ..    .    .   .     . .. . ..        .  ... .           .   .   .. .    .   .         .....  . ..    ...   ....    .  .   ..   .. ..  . ..
.. ..    ...      ...   . . ..    .  .        . ..     ..  .   .     . .   .  ..  .  ..   ..           ..  ...  . .  .  ..       .      . . . .  .
.   .. ..  .. .     .....     ..   .  ..   ....  .  ..     . .  . ...   ...  .... .     .  .            .     .  ..  ..   ..   .    .. .  ..   . .
.  ..  . ..    ......    .. .  .  .. ..    ...    .   .  ..       ...  . . .. .       . .     . ..   .   . .. .   ...   .  . ...    . .    .. . ..
.     .  ..  .           .  ... . . . .            ..              ..  . .   .  .  ..       . . .  .   ....    .  . . .  . ..      ..  . ..   . ..
.   ..    .  . . .   . .   ... ..    ..    ..   .  . .      .  . . ..                 .. .  ..  .    ..  .     .       .....  .   .    . ..   ....
.  ... .        .. ..    .                  ..  .  ... .. . .. .       .   . .. . .     . .   .    . .   .     .   .. .    .    . . . . .. .  .  .
.   .     . . ...  .        .     . .. .      .. .         .   .   ..   ..  .   ....         .      ..    .....      ..       ..   .. .    ..  ...
.   .     .. .    .    . .. .  ..  .     .   ..    .   . .    .  . . .    ....      .    .     . .    .   .  ...      .  .  .   ..       . .   . .
.    . . .    . . ..    ..       .   .. .    . . . ..    .  .. .. .     .  ..... ... .        .  .    ..  .            .  . . .     .   .        .
.   ..   .    ...  ...     .    . .    . .         .            . ... .     .    . . . . . . ...  ...          . . ....   . .. . .     .  ..     .
. .  .   . . ..   ... .        ...   ..  ....            . . ..          .   . . .  .  ..  .   .   .       .   .   .. .  ..    .  . . ..     .....
....  .. .    .    ....        .  .   .      . . .  .. .   ..   ....           . ..   . .  .  . . .      ....   .   .      . ...   . .     .   . .
. . . .     ..        .. .  .   . ...... .. .     . .    .  . .     .. .  ..  .  ..  .. .     ....       ..  .. .   .       .   . .. . ... . .   .
..    .  .   .   ..       . ..        ..   .      .   ..        .  ..     . . ..           ... .  .  .    .. .  ..     .  .. . .     .        .. .
.... .  . .       .    . .. ..   . ..       .       .  . .  ..      .. . . .     . . .      .       .   ..   ..    .    . .. ..  ..   .  .   .   .
.  . .  ...         ..       ...   .. .  .   .  .  .    ...        .  .. . .     .      .  ..  .     ... .      . . .       . .  .  .  .      .  .
..  .  ..  .      ...             . .  .    . ...      .  .  ..    ..    .  .       .  .  .                      .  . .  . .  . .  ..  .  .     ..
. .  .                 . ...    ..       .. .   .. ..         .  .. . .  .      .  .           ..   .       .   . .. ..  .     ..         . .   ..
.    . .  ..      ..  . . ...       .. . . . .   .    .   .   .  .  ...    ...    . .  . .      ..             .. .   .       . .. .    ..   . . .
. . .  ..  ..  ......           . .   .  . .   .   .  ..   .   . .  .. .  .    .       . . .   .  .     ..   . ..  .  .  .        . ..    . ..   .
..  .    .        ..   .    . .    .         .    .   .. .  .   .       .  .  .        . .          .  . . . .   .   .        .     ..    .   .  .
.   .          ... .  .     .     .  .             ..         . . . ....     ... ..        . ..  .   . ..   . ...   .     ...               .   ..
.      .. .  . ..   ..   .      . . .  .   . .  ... .   . .    .       .. .   .  .    . .            . ..  .   .  . .. ....       .. .   . ..  . .
.     .  ...  ..     .   .     .   . .  .. .    .     .  . ...  .  . .  .   .. . .   .   ..       .     . . .   .. .   .       .. ...  . . . . . .
.   .  .  . . ..    ..         .  .      .       .. .     ... .    ..   .   .  ...  . ...     .    .  .  .  ..    .  . .  .         .  . . .   ...
..  .. ..   .            ..    . .     .         .   . .  ..  ...   ...     .    ..   . .  ..    . . . .        .     . .     . .  ...  . .    ...
. . ... .. .... ..   .       ...   ..  ..  .  . .      .   .   .  ..     .    .  .   . .     . .  .  ..     . . . .  .     .. .      .    . ...  .
.. .     .  .    .    .  .       .       . ... ...    .. .      .   . .     .    .     .     .. ..  .   ..    .       .    .          .         ..
.  .   .      ..  .  ..    . ...   ...  .... .  ... .. ..        .        . . .                  .  .   .. ...    ..  .         . ...     . .    .
....      .            ...     ..            .    . . . .   .          .         . .   . .. . .    ..  ....    .           .  .  ..     ...     ..
. .. .     .       . ..  .          . .   .  .        . .  . ....    ... .. .       .. . .. .. . . .     . ..  ..   .. .. ..    .   .    .    .  .
..         . . ..  .           . .    . .. . ... .   .       .  .     .  .  ..   ..  . ...  .     .    ..   ..  .          .  ..      .          .
. .  ..  .  .      .  . .   .     .   .        . .  .  .     ..  .  .. ..  . ..    .    .  . .   ....    .    ..      .. .  .  .    .   ....  . ..
.    .   . .    .  ..  ..            .   .   .  . .  ..       .. .... . .  .  .    . .... .           .      ..  . .   .    .   ..   . . .....   .
.   .    . . . ..    .  . . .  .     ...   .  .   ..  .    ..  .  .... .  .. . .        ... . . . .  ...           ...   ..   .            .... ..
.    .        .   .  .. .         .     .     .    .      . ..   ...    .   .  ....    ..  ..     .     ... .    . .  ..    . . .     . .   .   ..
.  .     ..          .    .     .         .    .     ..    .. .    .   .    . .  .        .   ..     . ..   ..   .    .. ...    .       . ..  ....
.  .   .         .        . .              .      .   ...   .         ..               . .  .       .  . .    .   . .    .   .  .     .       .  .
.  . .... .. ..  .    .    . .    ..    .  ...      .   .  . ..     .... ....    . .    .   .     .  .     ..        .  .          .   ...  .. ...
. .   ..   .  .. . .  . .     .        ..   .   .      . .. ..    ... ...             .  . .     . . .  .  .  . .       .     . .  . ...  . .    .
.       . .      .               .     .  . .. ..     . ....  .   .     .. . .   .  .  ..  .    .  .  . .           .   .     .   .... ..        .
..       ... ..   .  ....  . .  .. .      . ..      .. .  . .         ...     .   .    . .. ... ..    .      . .  .     .  .    .  .  . .  .   ...
.        .  . .  .  .        .    ..   . .     .  ..     .    .  ..   ..  .  . .   . ..      .. ...    .              .  .  .   .  .    .  .  .  .
. .. .   ...  .  .      . .   . .           .  .. .       ....   .   ....  .  .. .....   ..  .   .     .    .. . ..    .  .   .    .  .         ..
. .   . .         .    .  .   .   .  . .. ...  .     .            .        ... ..      . . .   ..  ...      .  . . .   ... .    .   .     .  ..  .
.    .       .  .  ....   .       .  ...    . . .   ...        ..  .  .       .       .  .  .. . ...      ..  .    . .   ..  .         .        ..
.  ..   ....   ...  .. .          ...   .  . . .  ..       .   .      .. .     .   .  .          .   .     ...     .  .     ..  ..      ..    .  .
....         . .   . .  .    .  .     .         .  . ... ..   ..      .  . .  .     .     .            .  ..    ...   . . ...    ..  .         . .
.     .       .. .   .      ... .           ..  .. .   . .  .     .              .  . ... .. .. .   .         .   .  ... ...  .   .   . .  .. . ..
..     ...   .. .   . ..    ... . .   . .     ..   . ..  .... .      ..      ..      .  . .  . . .       .  .       ..   .     .  .    .  .  .. ..
. . .          . .       .       . . .      .      ...  ..  ... .  ..  .. .     . .        . . .  . .  .    .    ..   .  .  ..  .      .   . .. ..
. ...  .        . . .   .       .  .    .. .    . .  .       .    .    .. .  ..  . .   .        .. .    .   . .              . .. .    .  .    ...
.. .    .   .   .. ..  .      . .   ..  . ..  ..  .  . .. . . .. .  .      .  ....  . .  .  .      ..       .          .  . .  .    .   . .    . .
..................................................................................................................................................
