...................................................................................................................................................
..  .    .       .         .        .   . .  ..   ..         .               .     . . .            ..   .  .   . ..  .. .           .    . .    ..
..     . ..    .       .   .  .     ...  . . . .. . .  ..    .    ..  .  .  . .  .    .          .      ..   .   .     .   .  .  .  ..    .  .  . .
.          .   . . .  ..        . . . .. .   ...    ...       .    .  .. . . .... ...       .       ...  .   .. . ..     .    .  .   . . . .      .
. .  .   . .       ...           .    . . . . .   .    .    .     .. .     .  .  ...     .         .  .. . .   .  .   .   .      . . .   ..   ..  .
..  ...       .  ...   ..     .     .   .   ..    . .    .  .  . ..  .   .          ..    .    ...  . .    .    .   . . .   .     . .   ..    .   .
...     .  .  .. . .. . ..  .. .  .            . ...    ..      ..  . .  . .. ..  .          .  .         .         . .  .  .   .....   . .       .
. .        .     .       .          .. . .     .       . .  .  .    ..   . .    ..        .. .  ....  . . ..         .        . .        ...... ...
.    .   ..    .        .          .       .    .     .     . .. .. .     . .   .   . .  .    ..   ....    . ..      .. .    .   . .        .     .
.   . .  .  .   . . .     .   .     . .   .  .   .   .     ..     . ..      ..  . ..      .. .    .        .   ... ..      . .     . .     .   . ..
..   ... ... ..  .     .     ..   .  ...     .   .    . .  ..  .    . ....     .    .. . .     . . .   .  .     . ..   .   .  .         . .       .
.       .      ....   .  . ..  .    . ....    .   .   .  .   ..   .       .   . . . ..       .       .   . ..  ...  ..   .  . ..   ... .    ..  ...
.  ..   . ..     .  . .    ..    .     .        .    .     .  .   . .         . . .  . ..       .. .  . .   .     .      ...      . .  .       .  .
.  .. .   .    . ...          ..     .. . .     .          . ..       ..   .    .    .     .   .  .. . .     .       .   .  . . .      ..    . .. .
.   . .  .  ..      ..   .         .      .  .      .  . .     .      .   . . .      .   .  .   ..    . .       . .      .        ..        .   ...
.. .      ...  .     ... ......   ... .. .    . ..   ..   . .           .    ..   .   . . ..    .. .        .  .             .     ..   ..   ..  ..
...    . ..  .        .     .   .  . .   . .   .     .    .         . ..    ..      ... . . .  .. ..  ..  . . . .      ...  .  .     ...    .     .
..   . ...  . .  ..  .     .  ..  .  .   ..    .    .   ..       . . .      . .  ..    . .    .   .      .  .   .. .  ... .  .. ..     .    .   . .
....   . .       .   .       .. .  .  ....  ..   .   ...  .  .     ...     .  .   ...     .     .       . ....   .  . .      . .        .  . .    .
. ....  .     ..    .  .  ..    ..     .      .     ..      .. . . .....   ..    .   .  . ..       ..  .        .      .   . .... .  .. .         .
.   ..   ....  . .  ...      .     ..      .  .  ....  .    .. .      .  . .         .    .   .    . ......     ..   .         .    .   .   .     .
.    . .           .   . ..  .     . .  ..   .   .   . . ..  . .     .     .      .   .  . ..   .  .    ..     .   .. ..  .      .    .. . . .   ..
... . ...         .   ..    .  .    .. . .  . .  .        .      .    .       .  .. .  .        ..  ..   .    .  .       ..  . .    .        ... ..
.         .   . . ..  .     .. . .        ...    ..           .  . .  .   .  .        ..  ..  .  .  .      ..    .         ... . .  .  ..       ...
.  .    . . .    . . .            .    .         .       . . .  ..    .   . . .       .        ..  .  . .... . . . .    .     .   ..   .  .       .
.   . .   ..        .   . ..    ..  .  . . ..   . .  ..    . .  . .  .       .       .. .   ..     ...    . .. .. .  . ..   . ..  . .  . .   .    .
.... .... ...  .   ...     ...    .   .   .   .       .  ...             .         .  .   ... .   .      .    . . . .  .   .      . .. . .   .    .
.   .. .  . .. .. ... .       . . .   .   .        . . .... ...  . .  . . . . ...     .      ..  .     .  .   . .     ..  .   . .        ..  .   ..
. ...  .          . .  . . .   .        .   .       .  ..       . .   .   .  .. .   .  ... .   .. ..           . .  . ..      .    . ....  .  ..  .
.   . .    ...   ..       . ..        .. .  ..               .  ..    ..   .               .  .. . .        .. .      .       .                  ..
.      ....  ..           ... .   ... .               .  .  ..  .  ..   .         ... ..   . ..    . .. ..  . . .            ..     . .     . .  ..
. .    .   ...         ..    .      .  .   . .. ..   ... ...   .  .  ..      . ..   .    . .    ..   .   ..      ..  .  .  . .     ..           ...
.     . .    .      .   .   . ..    ....    . .   .     . ..       .        .  .        .. ..   . .    ..     ..  .       . . ...   ..  .   .  .  .
.  .. . .. . ...    .   .  . ..         .    .  .. .  . ..   ..     .       .   .       ..   ...   .  .. . . . .   .  .     .   .      . .   . .. .
.    ..      .    . ... . .   . . . .     .     .   . .     . .  .. .   .  ..  .       .    .     . ..   ... ..   .   .  .     .  . .  .      .   .
...      .. ...   . .        . .   ..   . ..  ....   .       .  . .      ...   ..   .    ..  .. ..   .    .. .          .      .  .     .. .  .  ..
. .        ..      .   .  ..      .... .      . .  .           .   ..  .          .   ..  .      . . ...    .. .    .. .        .  ..  .   .     ..
. .             .  .      . . .    . ...     . . .  ...     ...     . ..        .    .           . ...... ..  .   .     .      .  . . ...  . . . ..
. .       .   .   ..  ..   ..  .   .        .  . .  .   ..  .   . ..      .        . . .      .   ....       .    ....       .   .  . .  .    .   .
.. .     ....         .     ...    .    .  .. .      . . .....  .. .  . .          .   . . .. .  .       .   .. ..   .        . ..  .   .    .   ..
.         . . .   .  .   ..       . . ...  .. . .... ....    .       ..  ...  . . .  . ...     .   .     .  ..  .      .  .  ..... .      .   .  ..
. . .. .  . .        . .   .   ... .       .   .    .    . ..     ...      . .... .    ..                   .  .  .   .        . ... .   .   ..   .
. . . .  . .    .     ..     ..         .   ... ..   .  .. .  .  .   ...... .     .  ..   . . ...        .          . .  .      .      .  . .  .  .
.    ..  ..  .  .    .. ..  ..  ....  ..  .   ...  . .. .. .    .     ..      .  ..     ...       .   .   .       .   ..   . .     ..  ..    .  . .
..    ..   .  .  .     ..  .. .     .   ..     .  .. .   .  .   .. .   .  . .   .  . .  .    . ...     .        .       . .   .  .  ..    ..  .   .
..         . .  .      .   . . . .  . .... .     ..     .   . .   ... .  .      ... ..  . . .  .    . .. ..      . .. . .  ..        ..      ..   .
.     .     ...     .           .     ...       ..     .        .      . . .  .  ..    .  . . .     . .   . .     ..    ... .. .     .   . ..    ..
...       .  . .   .  ..        .  .      .     ..  .  . . . ...    .. .             .    .     .        . . .  ..    .    ..    .    ..  .   .  ..
.   .  ..   .    .    .   .    .  .       .   .. .          .     .  . .   .  .  ..     .  ..   .   . .   .    .    ...       .   ...    . .      .
.  .   .. .           .   .   .    .     . . .  . ...   .  . .          ... .  .  ..   ...         .      .  .   .  ..           .    ..    .  .  .
.   . .  .  .   .    .  . . .     .   .  .     . .     . .   .  . . . .    . . .  .   ...   .  . .  ...  . . .  . .     ..  ... .    ..   . . . ...
....     ...    .    . . .        .  .    .       ..   .  . .    .      .       .     .  ... . . .   .   .     .    ..     .. .  . .  .         . .
.    .  ..      .. . .  ... .. . . . . .  .... ....   .   . ..   .        .  .     . ....    . ..  .        .  .  .    . ..  .    .    .  .      ..
.   ....               . .     .        . .   .   ...  .  .  .     .. .  ...  ..    .   ..       .     .  .  .     ..    ..  ..   . ..    .   .   .
.        .   .  . .... .. . .       X.         .   .  .  .  .           .    .. .  . .... .    .  ..      .     ..  .    ..        ..     ..  .   .
..      .    . . .    .        ..  . ..    ..     ...         ..    .     . . ...     . ....  .    .    .         ..   .        .  .     . .    . .
..  ..     .. .   .        .   ..      .  .    ..   . .. . . .         .    .  .  .    .  .    .  .  . ...  ....     . .  .  ... . .  . .         .
.  .        . . .  .   .     . .   ..               .. .    . . . ..  . .          .        .     .  .. . .           ..  .       .    .. . .  .. .
.   ..      .. .   .   .       .   .  ..            .         ..   .     .. . .  ..  ...  ..       .. ..    . .    .         ..          . ....   .
..   .  .   .   .  .    .       .. .  .     ..      ...    .      .       .    ..           ..     ..   .   .  .      .  .   .    ..   ..   .   . .
... . .             ..   ..  .   .  . .   .... . ....  . . .. .       .  . ....       ..   .. ..                 . .   .  ..     .. .          .. .
. . .. .   .      . ..    ....      . .. ..  .      .... .  .  ...   . .   . .      . . ..          .. ..           ..     . .   .   .   ..    .  .
..  .   .. .        ..  . .....     .      . .    ....   . ..       . ..  .          . .   . ..   .       .        .      .             .  .   .  .
..               .  . . .   ..   .  . .   . ..  ....  ...  . . .    ... . ..         ...    .         .... .    .   .   ..  ....    .   . .  .    .
. . . .     .      ..       .. . . .   ..   ..  .      ....    .      .  .  .      .    .    ..        ...  .. . . ..  ..   .    ..   . .      ....
. .   .            .. . .       ..     . .     . .. .   .. ..                 .   .. .   . .  .    . . ..   .      ..    . ...            . .  ....
.  ..  .        . ..  . . . ... .    ... ..      . . . .. .    .    ..  . ..    . .... .  .     .      ..     . .    .  ..  .. .     .   .... .   .
. . ..    .  .       ..     .. .  ..           . .. . .  . . .   .  . . . .   .    ..   .  .  .   .. .   .  .   ...  ..      .            ..     ..
.   .    .   .     ...        .  ... .  .   .. .       .  .   ..  ..  ..     .    . .   .     .      .    .  .     ..    .        .      .. ...  ..
..  .  .  . .. .  .   ..    .  . .  .. .     .   ....  .  .  . ..  . .     .   ..   ..   .      .....    .   ..  .  . .  .  . . . .   .  .     .. .
. .    . .     .    ...       ...        ..   . .            ..  .    .        ... .    .. ..  . .   .    . .           .  .     .                .
.   . ...  .          .  .       .    . . . .   . .  ..  .             ..        ..  .. ..  .       .                   .. .   .. .    ..   .  .  .
.. .         ..    ....  . .     .  .    .      . ..    .   .     .       . .  . .  .      .     .. .    ..   .   .    .  .    .   .  .   .  ..  ..
.      . .  .    .  .   . .. .     .  . .   .    . .  ...    .  .     .     .  .     .   .... ...     .  .   ...   .  ..          .      .    .  ..
.. .       .. . . .    .     .  . .    ...  ..  .      .        .. .     .   .    . . .  . .    ..   .  .. . .    .     .    .   .    ..     . .. .
..   .    . .  .    .     .       .  . . .   .. . .  .      ..  ..  . .  .. .     ...       .  .    .         .  .. .  .. .      .   . .          .
.                 .    .   ... . .     .   ..    ....   ..      .  ..     ... . ..    .  .  ..        .         .     . . .       .    ..    .    .
..    .         ..        .   .        . .   ...  ... .  .      ..      . .      .      ..      .   ..... .    . . ..         .      .            .
. .  ..           ..   ..      . .  ..  .  ..  . .    . ..      .      ..            .  .. .        .   .  . .   .       .  ..   .  .     .       .
.....         .     .  .    . .  . .. ...  .....   .  . ...         ..         .  .   ... .   .  ..     ...            . .  .     . ...  ..      ..
.  .        ..        .          ...   . .   .    .      .      .     .   . .  ..  ..   . .   ..   . ..      .   ..  . ...    . ..   .   .. .   ...
....      .  . ... .     .       . . .  .     .   .  .. .   ... .   .  .  .  .    . .   .   ...       . . .       .....    .    ....    ..... .  ..
.  .      . .. ...   .. . .. . .        .   ...           . ..      .. ...        .   .       ..     . ...         . ..   .     . .    .   .. .   .
...  .     ..     .     .  .. . .  .  ...    . ..  .  ..    ..       ..    .              .   ...  ..           .     ...    .            ..      .
.  . .   . .    . .  .    ... .    .. .   ...       . ..  ..  . .  .         .  . .      .  .  .    . .  .   .. .   .  ..     .. .         .     ..
..  .          .       .     ..             .  .      .       .   .. .        .     .   . . . .   .       .   ..      ..      .  .  .  .    .    ..
. .     .          ..     .   ..  .          . .   .   .  .  .      .         ...      .       .   .... .. .  .   .   . ...         ..  .   . .   .
.         ..    ..    ..      .   .    . .   . .  ...         ... ..  .      ..    ..  ..  . ..  . . . .    .      . .  .          .... .   .  .  .
... . .     ..  ..         .   .       ...  . ..    .. .. ..   .  ..   .     ..   . ..     ..   ..    ..  ...     .       . .         . ..   .    .
.. .. ..                   .   .              .   .  ..  .  .    .   . .  . .. .. .. . . .   . ..    . .   ...  . ..     .     . . ..     .   . . .
.. . .   .. . . .  .        ..  .. . .      .    . .           . .    ....  ..     .   ...      .          ..          ... .      .        ..   . .
. .  ..    .  .. .   . .. . ..    .       .  . ..  .. .. . .   ..       ..  .     .....   .      . .  .. .        ..   ... ...   .    .   .  .   ..
.              .   .  .. .    ..  .   .          ..  . ....  ...       .    .    .       .. ..         . .   . .   .  . .           .       .   ...
. .  ...  .  .   ..   .   .  .  ...     .. ..        .         ..    .   . .    .   ....   . ... .      .  ..      .   .  .   . .  .    .  .  ..  .
.    .  .  .   .           .. . .    .  .   . .    .  . ..      . . .      ..  .        .    .   .        . .... .  .  . ... . ..           .     .
..           .          ...        ..  .. .     . ...   .     .  ..   .    .. . ..         .    ..       .    .  .     .  ....    ..          . ...
....            .      .  ..  .  . . .  .  ..  .       .   .      ..  ...... .   .   .  ...    .     ...    . .   .   ..    ..   . . ..          ..
. .   . .   .     .   . .            ..  ..    .. ...          . .    .  ..  .. .    . . . .   ..               ..       . .  ...   ..     ... . ..
... .   .    ..   .  .  .     . .     .      .   ...   .     .   . .     ..    ..   . ..      . .   ...  .       ..       .            .  . ..    .
.   . .     ...... .  .     ..  .   .. .    .       r  .   . .    .       .  . . .      . .   .        ...  .    .     ..      .     .   ..       .
... .  .. ..   .         . ..  . . .    .  .       .   . . .  ...   .   .  .           .   .      .   ..  . .   .  . .  .     .       .   .. . .. .
.... .  .  .          . ..       .   .    .         ..   .. ...   .. ... ..  .  .   ...   ..   .   .     .        ..     .. ..   .   . ...      . .
.   . .     ..    . .   . .  .  .    .   ..  ..    .. .      .  .   .. .    .  .    .   .   ..  .   .  ...  .       . ... .              .  .     .
.        .      . ..     ..  ..   .     .    . .       .    .    .         .  ..    . .     .. . .    .              ..          .  .      .     ..
. .   ........  ..     .  ..  .      ..  . .    .. .   .            .     ..             .      .  .     ..         .      .. .... .     .       ..
..   .       . .     .  .....   . ..  .    .     . .        . ..    .      . . .. ..  . . .. . .   . .   .    .  ..    .      .. .      .  ...    .
...   . .        ..    .  ... .     .   ..   .     .       .  .    ..  . ...    . . .      .  .  .   . .  .  ... .    .. ..        ..  .  . . .   .
.    . .  .    . .   .   .  . .   . .  ..           .  . .   .    .. ..     .  .  .      .  .   .... ...  . .    .  . .   .  .   ..        . .    .
.    . . ..   ..  . . .   .      .      .  ..  .  . ..     .        . .   ..      ..   .    .    ..  ..   .  ...      ... ..   . .. ... .     .. ..
. . . .. ..     .    . .    ..     .  .    .      ..      .            . .. . .     ..  . . .   .  .. .     .. .     .  .. .  .. .     .  . ..  . .
. .   . . . .    .        ..          . ..  ...  .  ..     .              .           .... .  ..    . ..    .        .  ..   .  ..   ... . . ..  ..
. .  .  .           .  .    .    . .  .    . .     . .        .  .  ..  ..    . .        ...           .    .        .       .   .  .  .... ..    .
.  .. .  .   . .. . . . .     . .       .   .     .  .. .  .  .   .  .  ..  .   .. ..         ... .    .        .              .   ...      .  .. .
.    .               .         ... .     .. ..   ... . .  .  .    .  .   ...   . . ..  ..   .  .   ... .         .   .  . ... . .  .      .     . .
.. .   .  . .   .   . . .  .    .  . .      .. ..    .     .  . . ....      .  ... .. .    .        ..     .     .  .. .           .  . ..       ..
..    .   . .    ..       .    .   . .  .      ..  . .  ..   ... .  .    . .   . .        . .         .     .  .  . .  .       .    .... .  .     .
.     .  . .   ..    . . . . . .  . .     .   . .     .   ... . ..     .   .   . .     . .  ...       ..        . . ...  . ..  .                 ..
. . .     . ...      .   .     . ..  .      ..   .         ..    .      ....   .. . .    . .. ..       ..       . .      .  .   .  .. .           .
. ..  . . .      ..    .. . . ...  .....      .   . . ...         ......  . . .    . ..   .      ..  ...   . . .  .      .    .. . . .      ..  . .
. ..   ...  .  .  . ..   . ... . .      ..    . .  ..      .     .   . .     .    .......    . .    .      .  ..  .      .  ..    .   .  .        .
. . .   ..  ...  ..   .     .. . .             ..       ..  .      .             .  . . .  .  .   . .  ..  ..       .. .       ..     .         ...
...    ..    . ..    .     ..  . .         .       ..  .      ..  . .    .     ..     . ..   .  ....  .  .        .. ...   ..   .              ....
..       ..  .        . . ..        . ... . . ..  .   .        ..    . .        .  .  . . .. .       .         .   .    ...      .  .     .  . .. .
. .  .     ..        . .   .         . .    . .  .. .    ..     .    .  ..       .    .        ..   . . .      ..   . ...  .        ..  ..  .     .
. . .     . .       ..    .    . . .  .           .   ..    .     .   .  .   ... .  ..      . ... .   .       .   ..       .   ..   . ..  . .     .
..  . .      .   . ..  . . ..  . .  . ..   ..       .     . .....  .  .        ..  . .  .     .      .    .. ..  .      ..  .    ..        ..  .  .
. .   .        ... .   . . .     .   .   .      ... ...             . . .       . . .    ..   ..         . .    .  . .   .      .. ... . ..  . . ..
.        .    .     .     .. .   ..  .   .           .      . .  ...     .         .         .   ....  .   .      ... .      ..  .   . ... .   .. .
.   .  ..... .      ... ...   .     .. .. .    .     .     .   .  . .      ..  ..   .        .  .   .. .   .  .  .   . .  .  ..  .  . ...         .
.   .  .       ....    .    . . .        . .         ..   .. .   .           . .       . .      ...    ..  ....    . .  . ..      .  .  .  .   .  .
.  .. .  .        .   ...      .    .  .   . .   . .    .. . ..     .  ..     .    .       .  . . .        .   ...  ...      ..     .   ..  . .....
.. .    . ..   .. .           .  ... . . . .   .  .  .      .   ....  . ..  .  ..  ..        .  .  .   ..  ..   .    ..    .    .      .      .  ..
.   .           ..   .. .   . .        . ..               .  .         . ...  . .     ...    .    ...  ..   . .  .       .. .     .           ..  .
.   . .   .. .  . .. .  .. .  . .  .       .     .. .            .  . . .    ..     ..  .  .          .          . . .      .   .. .  . . .. ..  ..
.  .  ..        . .. .         ..        .     . .           ....           . .. ..   . .  .. ..   . ..     .        .    . .      .  .       .  ..
.  ... .  .        ..... .      .   . . . .    .        .     .  . .    .   ..  ..   . ..       . .  .    . .  ... . ..  . ..   .   .  ..  .. .   .
.  .... . .   .      ... .     .      .   .  .     .    .         .    ..... . .. .   ...     .          .   .   .   .         ..   .  ...     .  .
.  ..  .    . .   . . .. . ..  .  ..  .    .  .     .     ..       . ..   ...    ..               .       .             .  . ... .  ..   . .  .   .
..   . .  ..         .      ...   . ...          ..   ...   .    .. ... ..  .   . .     .         .. ..    .            . . .... .  .      .  .   .
.       ..    ..    .   . .   .  ...        .   .  .            ..  ..     .           .      ..       .      .   .  .  ...      .. .      ... .  .
.    . .   ..  .        . ..               .      .    .   .... ..   . .  . .     . . .   . .  . .  . ...   .       .   .    ... .  .  .   . . .. .
.    . ..     .    ..  .      ..  . ..         .    .  .   .. .. .       ..   . .   .  .   . ..     .    .  .... .    . .         . . . .   .   . .
.   ..  .       ....   . .           .   . .  . . .... .. ...  .   .    . ....      ..   .         ..   ...   ..  ... .  .    .  .. . ..  .  .. ...
... ..  ..   .. . .  .  .     .  .      .  .  .  .. .       ..  .. .     . .   .    . .  . .      .         .   .   .  .  . .        ..    ... .  .
.   .       . .  .     ...       .    ....   . . . . ..             ..  ..    .   .   .    ... ..         .  ..   .  .     . .. .     . .         .
...  .    .   ..    ..        .       ...  . .  .. . .  .     .. .       .  .. . .  . .   .    . .. .  . ..       ..     . . .   . .  .  ...    . .
...................................................................................................................................................
