....................................................................................................................................................
. .     . .    .  . .  ..    .     . ... .   .    ..     ..  .  .   . . ..     .             .  .     . .  .... ...       .  .   . . ..  .     .   .
.      .  .     .   ..        .  .   ....    .  ..   .       . .  ..  ...   ....   .   .. .    .    .  .         . .      ...  ... ..        .    ..
.       .      .          .   . ..    . ...         .   . .    ..     .  .. . .  . ... .  .        .  .   ..   .  .       .      . . .   ..   ..   .
.. ..     ..              .              .X        .           .   .    ..           .  . .    ..     .  ..   .  .    .  .   .  .          . .   ...
. .. ..  .     ..       .         . . ...  .    ... ...  .    ..  .... ..   .   .      .     .       .   ...    .   .      ..    ..               ..
.         ..  ..      ..    ...   ..  ..  . . .    .       .  ..   .. .  .     ..   .    .       .    .      .      .   .       .   ... .  .   .   .
. .  ..  .    .. .    . .  . ... .    .      . . .     .. . .        .  .    .        ..   ..  ..   .     .   ..    ..   ...  .   . ..   . .. .    .
.. ..    .   . .    .   ...  . .  . ..   ... .. .     . ..     .  . . .  ..  .  .        .    .    ..   .    .    .           . .. .    .  .  ..   .
.. .    .  .     ..  . .     .   ..       ..      .. .. ....  ..    .   ..  .  .       .    .  .             .          . ..     .    . .    .  .  .
.  ...    .    .. ... .  ...     .  .  .   . ....   .   .    .   .            ..  .. .  .   .    .     .     ..         .     .   .     ..   ...   .
.         .  . .  ...  ..      .... .      . .  ... .       .  .   . . . ..  ..      ..  ...   ...  .   ...  .    .         ..  .    .      . .   ..
....  ..      ..  .    .   ..        .   . ..  ..          . .. ...  ..    . ..     .   . .     ..        ....   .  .  .         ..     .  ..    . .
. .. .       .  ...   .     ...... .          .       .. ..    . .  . . . .     .      ... ..  .    .    .      .      ....  ...  . ... . .  ..  . .
. ..    .  .          .  ..    ... . .   . .     . .   . .    .  ..  .  .         .. ..  .   .. ..  . .... .    .   ..        .     ..  .  . .  .  .
.  .    . ..   .      .        .  .   ..     .        ...        .. .   .        .          . .    ..          .. . .. . .. .. . .. ..  ...     .  .
.    . .... .   .. .  ...  .       . ..  .... .     ....         ....    .. ..   .    ..        ..        . .   .  ..           .          .  ..   .
. .     .... . ...       .  .   .      ..   . .  .           ...           .            ..   . .    .    .  .. .       .           . ..     .     ..
. ..         .     . .   . .  . .     ..    .   .  ..  ... . ....             ..    .  . .    .     ..    ..     .   ..   .     .   .   .     ..  ..
.      . . . .      .    .....   .  .   .    ... . .  .    .    .  .     . . .. ...   . . .  .  .    . .     . .   .    .   . .       .    .      ..
..      .        . .  ..  . . .   . .     .  . .   ... ..              .     .  .   .  . ...   .    .       .   ..                    .  .     .  ..
.  ..   .     . .        .. .          . ..       . .. .  .     .  . .           ..   .         ..  ..       ... .   ..   ..  .   .    .  ..       .
.    .   .    . .    ..    ..   .  .    ..  ... .. ..   . ..    . . . .  .      .. .            . .. . .. . . ......   .  .    ... . . .. .    ..  .
.    .    ..      . .  ....      .      . . .   .    .   .    . .. .  .   ..    . .. .. .. .   . ...      .   .. . .   .   ..        .       .   . .
.        ..    ..  .   . .       .  .         . .. .         .  . ..     .         .   .  ..   .  .   .      . . ....   . .       .   .  ..  .  .  .
. ...  ...   .  .     .    .....   .     .         . .  .      ..    ..  .      . ..          .         .     . .   .. .   .  .. .   .. . .      . .
. .    .      ..      ...     .. ....    .     .. .    .  . .     .  . .     .  . . ..         ...... .. .  . .  .           ..     .  .  . ... .  .
.   .      . ..   ....        .        .             .  .     ...   .  .            .  .  . .. . . .   . .    .  .       . .  . .  . ..    . .  .  .
.....     . . .     ...    .     ..  ..   .. .  . .  . ...    ..  .          . . ..  .   .. .  .        .    .  .   .  . ..  ..  .    .    ....    .
.    . .     ..      .      .     ..  ..      ...  .   .  ..                .. .     ...      .  . .      ...  .     . .   .  .      .       .  .. .
. ... ...   ..  .. . .          . .  ..     .    .  ..   . .  .. .   . .. ..   .     . .   . .  .  .  .            ..  ..    .     . .     .    ....
.    ..  ..         .   .   . ..    ..   .  .   .    . . ..   .  . ..  .    .      .  .    . .. .... ..     .       .    .. .    .  .      .  .    .
..     ....         .. .   . .  .  ...  .   .      .  .  .           . . .                  .   ..  .. .      .   . ...  .   .  .   .  . . .  ..   .
.  .  ..      .    .  ..                    .   . ..  .   . ..... ..               . . .    ... .       ..  . . ... .     ..    ..  .  .   . ..    .
. .  .    .     . .       . .   ..  .    .          .  .           ..   .    ..... .   .  .     . .  .   .  .. ....     ...... .      .   .     . ..
.   . . . .    . ..  . .   . .   .   .   . .  .     . ..   .       .  ....    .   ...          ..     ..    . ..   .    ..        .               ..
.    . ...  .   .  .   . . . ..     . .. .    .  ..  . .   ..  .    .   .  ...          .... .  ..  .  .      .  . .  .....       . ..       ..  . .
.    ...  .. .   .... ...     . . . . .    .      ..        . .   . . ....  .  .       ....         ..     ... .  .   .   .         ....     . .   .
....  ..    . . .  . .   . .               .  .        . .    .      .        .    .   .   . .  .     ... .        .   .. ..      .  .       .... ..
...  .  .  .   ..   .. .  .  .  . .     ...  ..  ...        .        .    .   .. . .. .. . .   . .     . ..    . .     ..   .      . .        . .  .
.  . .  .    . . . ..     . .        .... .    ..          .   ..  .. .        .     .   ..   . . . .   . . .     .      .    ..  .. . . . .    .  .
.. ..     ..     . . ...   .  .   ..         .        ....   .   ..   .       .   .   .. .    .     .  .. .....     ....      . .. .         .     .
.  .  .           ..  .       .  .  .       . .       ..   .     .   .. .      .       .  .. . .     .    . ..  . .    .     .      . ...   .      .
..       ....  ..      .  . .     . ... ..      . .   ..    .       . . . . .    .  .  .        .       .      .          .    .. ..     .  .. ... .
. .      .   . ..   ... .   ..  .   ..  .              ...  .   .  .         ..   .       .     . .  .. .  . .   .   .. .    . . .  .. ...   .   . .
. .  .   .  .  . .  . ..              ..   . .  .       . ..  .    ..        .    .    . . ..        .    .   .  .. . .    .         .  ... ..   . .
..  . . .       .    .    .. .   .     .  .   ..              .    . . . .   .      .     .     .. ..     .. ..  .  .  . .  . . ...    . ..      ...
.    ..  .   . ..           .     ....   .  . .    .  .   .  .. .        . .  .  .      . ...   .  .        .      .   .  .  .   ..  .     .. .. . .
. . .    .  .   .   . ..         .      ...     .. .  ...    .      . .  ..        .    .  .                .    ... .  . .. ..    .  .  .       ...
. .    . .  . .   .  .    . .      . . ..  .   .. . ..      ..     .  .. ....  ..  . .     ..      .         . .   .  .    ... .   .   .    .  .   .
.  .           .           .. .  .  .  ....  .  .     ..      ..  .. .    .  ..    ..  . .   .     .. .      .   .  .     .. . . .     .   .   .   .
.       .   ...  .. .. .  .   ..  . .  . .              .   .  .. .  .  .   .. ...    .          .  . ..      .   . .   .              ..... ...   .
. .....    .        r .  .      ..    . .... .     .  ...         ..      .  .    .. .  ... .      ..  .  .. . ..      .       .  .. .        .    .
.        .  .           ... .     .    .    .       ..       . .  ...     .           .      .    .. . .         ..     .   .  . . .               .
.  .   ..   . . .  .   . .     .          ..       ..   . . .     ... .  .       .      .    . .  .       .    .     .       . .    .. .        . ..
.     . .       .  ..      ..          ..      .             .. .  .         ..   .  .  . .. .        . ...     .  .     . .    .. .  .   .   . .  .
.            .    . . ..           ...   ..     .    .  ... . . ....  .  .   ...   ..             .  .     .. .  ..        .    ...    . . ..  . ...
. ....... .    ..  ... .         .   . .  ..        ..                  . .    .       .  .     .. .  .. .      ..           .  .  .  . ..    ..  ..
.   . . ..  .        ..     ...    .. .   .     .   .   .    .   .   .  .. ..    ... ...       . .    .     .   ...... .     .     . . . .  ...    .
.      .   .     .       . ..            ...        ..     .   .    .   .      .      ..  ... ..      . . .     ..     . . .   .       .  .        .
... .  .   .  .  .      ...   ...       .    ...    .    .   . .      .    .      .  .  . .        .    .   . .. .   ..     .      . .  .       . ..
. .    . ...    .       .  ...     .  . .    .    .  .          .     .  ...         .  .....   ..  .   .         .    .   .      .  .   ..  .  . ..
.  . ...            .   ..     .. ..  .   .   .                   .      .   .     .  .        .   ..     . .  ..   .  ... .. . .        .       . .
. . .  ...    .   .   .      .  .          ..        .   . .  ..      .. .. ...   . .  .    ... .  ..       .....      .  .  .        .     . .    .
. .  ..  .      .      . . .          .          .   .... ..    ..   .   .           . .     ..       .   ....   .   .        .  .  .  .  ..       .
. .    .     .  .  .  . ..    .   .     ....    .        ..   . .    ..    .    .   .   ..      .  ....  . .  . .      . .   .  ..    .    .   . . .
.. .     .  .    ... . .   . ..  .   ..    ..  .. .    .  ..  ..     .. .        .       ... .  . .  . .   . ... .   .   . .. .  ..  .   . . ..    .
..          .      ....   .     .    .. .  ...    ..  . ..     . . .  .   .       . .  .....  ...         .   . ..  .       . ..  .    ....     .  .
.  .  ..  .      . ..    ...   .   .. .. ..  ... .  .   .    ..     .   . . . .  .   .  . ..     . .  . . . .  . ..   . . . .            .     .. ..
.   .. . ..   .    .       . .         .. . .. .              ..   . .      ...      .    ..  . .    .   . .  . .             .     . .  .   .  .. .
... ... . ......       .      . .    . ...   .  .   .  .  .... .              .  .      .. .. . .  .   ... .   .  .    . .  ..  ..   . ..   .     ..
...            .    .           .        .   ..       .      . ..  . .      . .    .  ..  . .   ...   .         .  .    ..        ...  .....    . ..
.   .        ..        .. .. .   . . .   .  .  .    .    ... .  .   . . .      ..  .     .   .  .   .   .  ..   ..   .  .   .   .   . . .     .  . .
.   ..      .  ... .  .        .   .    . . .... ..  ..     .  . .       ..      ..      . . .    . .. .    .     .      . . .  .   ...   . ..   . .
..          .       .  .            .     .. ..    . .  .               .... . ..    .   .    .     . .  . ....  .  .   .   .     . .  .. . ....   .
.... .. ..         .   ..          .     . .  ... .     .          . . ..        .  . .  .  .         ..       .    .    .  .   .    .    .   .  ...
.           .         .   .     .    ..  .      .     . .. .  . .  .  . . .  ..     .... ..    . ..      .     .    ...   .  . ..   .   . .     .  .
.   .     ..          . ...   .. .  .    ...          ......  ...   ... ..    .    .            .  . .  .        . ..                    .   ...   .
.  ..   .   .     . . . ... ..   ..  ...  . ...  .. .     .. ....  .  ....    .  ..    . .   ..   .     .  . .. ..   . .    .   ..   ..  .  .   .  .
. ..   . .. ..   . .  . .    .             .       ..   . ....         . . .     .  .   .       .  ..   .   . .   .      .         ...    .        .
. .    .. ..    . ..        .      . .   ..    . ..  . ..         .  . .  ..                 ..   .     .   ..      .. .    .     .  .       .. . ..
..    . .     ...  ..     .  ...     .       ..        .   ..  .     . .  . . . . . . .   .    ..   . .     .     .   .  .   ..        .  .. ..    .
..  . .         ... . .  .     . ..     .   .       . .     ...  ..    .      . ..          .          .... ..    .   . .. .   .     .. ..      .  .
..    . .              ..  .  ..      . ... .  .  . .      . .    ......    . ....     .     .  .   .. .      .    ..         .... .    ..  .   .  .
.      . . . . .   . .     .  .      . ...   . .          .     .  .  ..   .  .. .    . . .   .    ..    ... ....   .  ..      . .            .. . .
. .  . .. ...        ....  .         .  . ..   .   .    ..  .          .     . .  .  . ..      .       ..       .   ... .  .. .  . ..      .   . . .
.  .. .   .      ..    . .  .  ..   .     .  .        .       ...              . .   ..  . .            ..     .   . .  .     . .           .   .  .
. .     ..   .      .  ..        . .   . . .   .     .      .  .  . .   . .. .      .  .         ..  ....    .    .    .    .   . ..        .     ..
..     .. .       ... .    . .  .    ..        .   .  . .. .      . .  .   .  .      ..  .. .. ..            ...   ..    .. .    ..   ..  .    . . .
..    ..    .   .     . .. ..      .  .   . ..  ..       . .  .      ..  .   . . .     .   ... .   . . ....     . .      . .   .. .     ...  .     .
.     .  .  ..   .   ..  .   .    ...   .   .. .   .. .  .  .       .       .  . . .  .             .   .   ....     . .. .. .       ...  . .   . ..
.        .   ..        .. .   .      ..  .      ..       .  ...    ..... ..     ..     ....    ..  .  .  .              .      .    .. .       . . .
.  .    ..         ... . ....   ..    ...     ....  . . ...  . . ..     ..      .     ..     .        . . ..   .         ..     .  .  .. .  .  .   .
.. .        .   .. ...        .   .   .  . .   ..         . ..    .         .. .  .  .  ...     . .                   ..  .   . .. .   . .    ..  ..
. ..  ..      .    ..    ..  ..  .      . ... ..            ..            ....   ...  .  . ...     .      ....   . . ..    ..        .         . . .
. .  .        .   .. .  .   .   .    .   .    .    .      .       . . .          ..        .      ...  .      .     .           . .      .    . .  .
.. .   .    .. .    ..      .    . . .  . .. .. .  .   .     .      .      ..  ...    ...        .  . .  . ..  .    . . . . .    ......  ..  .. .. .
. .. . ..   .    .... .. .    .....   . ..   ..  . . .        .          . .  ..   . .   .     . .  . ..        .    .. . ...   .   .    .  .  .. ..
..  .         . .   .    ..             . .      .   .     .   ..  .   ...       ..   ... ....       .     ..  .... .  .  .    .... ...  . ..  ..  .
.   ....    .   .          . .  .   ..    . .    .  .    ...  ..  ..  .  .     .     .      ..  .. ...         .    ..       ..  .... . .   ... ....
.    ..          ..   .   ..   .    .      . .  .    .      . .  .  .  .          .. .   .. .             .. .  ..  . .    . . .         .. .      .
..  ..   . .      ..      ...  ..  .  . . .   .   ..  ..   .  .      .               .   .    ..   ..       .  .           ....   .            .   .
.. . ..   .  . .   ..  ..  ....    ..        ..  .  .     . .    . .   .  .        . . ..   .. . .  . ..     .    .  . .   .    ...  ...           .
.  .. .   .  ...  .          . .  .  ....         .  .. . . .    .         .            .    .  .   . .  .  .     .  ..   .     . .    . . .    .. .
.   . .  . .. ..   .  ..   ..  .    . .. ..   ..   .   .   .. ..    .. . .   .   .   .. .   . .  .  .. .     . . . .  . ..  .       .  .    .     ..
..  ...  .     .  ..   .    ..  ..            .      .      .           ..     ...   .   .       . .      .    . .      .   ... .    .   ..       ..
.  . ....         .     .. . . . ..   .. .. .. ...        .    .  .... ..   ...        .                  .    .. . .        ..       ..  . .      .
...    . . ...     .      .      . .         . ..   ...  .  ...   .     . .  .      . .     ..  .   .      .        .     ..   .   . .       ...  ..
.  .    .   .    .   .    .. ...        .      .      .  .    ..     .  ..    .  . .  .. . .    .     .  .   .. . .   .    ... .  .   .   .  . . ...
.   . . .... .      ..   .   .       .       .   . .. ..   . . .       .  . .     .     . .    .   .  .   .        .      ..     . . ..       .  ...
.   .   .    ... . ..   .      . . ..          .   .           .   ..   .  .   ...      .  .  .  ..  .            . .          ..       .    ...  ..
.      .  . ..  ....    .     .....  .          ...   .       .  . . .      ...       ..      .    ......  .    ..    .           .     ..  ..  .. .
...     ..     . .      ...  .   ..         . ..   .... . .        .  .   ..     . .  .             .  .. .       . .  .   ..  . ..      .      . ..
.        . .    .  .   .  .      .   ... . .   .   .  . .    .   . .   .  .    . .  . . . .  .      .  ..    .  . .     ..      .    .      . .    .
.. .  .  .   . .. .   ..           .  .  .   .  . . . .        .. . .   . .   ..     .    .               . ..   .    .    ... .      . ..  .    . .
.   .    ..  .  .  .  .   .   .             . .. .  ..   ..     .. .   . .        ...   .   .  .    .   .    .    . .   .. .          .    .      ..
. .  . . . . .   ..  .  .    .   .       . . . .  .      .  .        ....     . .... .     .    . .   .   .                .          . . .  ..... .
.   .   .    .    .    . .   ..  .  .             . .. . .   .. .  .   .    .  . ...       ...   ..  ..   . .... .   .  ...      . ..     .       ..
..  ..    . ....      . ..      ..  . ..       .     .      .  . .   .  . .   ..  ..  ...        .         .. .  .. .. .          .   .     .. .   .
. .      .  . .  . . . .       . .  . .      .  ...         .    ..         .  ...  .. .  .       . ..     .  . . . .    ..  ...  .    .. .       ..
. . . .     ... ....           ...       .   .       .    .. ..    . .       ... .   ..  . . .            . .  ...    .. .             . . .    .  .
. . . ...  .    .          .        ..  .   .      . . .. .     .          .     . .  .    .  .          . .  .    .  ..    .   ..         . .. .  .
.. .     . ..          ..      . . . ... .     ..    ...      . ...  .   .    .       .  .. .. .  ..          . ..  .  ..  . .. . ...  . .        ..
.   . ..   .   .  .. ..  .     . .       .  ..      . .  .   . ... . .  .   .     .  ...   . ...    .   .  ..   .   .      .  .  .   . ..    . ..  .
.  .    ..  .        .  .  .  .    . .  ... ..   .. ...    . .   ..  .  .               .    .  .          .            .         . ..      .      .
...    . ..   . ..    .   . .   . .    .     .   .  . ..     .   .     ..   ..     . .  .     ..    . . . .. ....  .. .  ...      ..  ...   ..     .
. ..   . .   .      .   . .       . .   .        .. ..   .    ..   ...  ..    .. ... .   . ..  ..      .  . ..    ... . .    . . .   ..  .       . .
..    .   . . . .  .   .       ..  ..  .     .  .         .   .        ....            ..   .   .   .  ..   .   . . ..    . . .. . .        ...  ...
.   . .  .  .   . .   .. .    ..  ..    .   .  .  .  .    .  .    .     .    .    .  . ..             .       .    .... . .       . ... . .  .     .
.                . ..... .. . . .  .   .  .   .. ....     ..  ..  ..     ..    .         .    . .      .  ...               .      .       .      ..
.  ..      ..     . .       ...     ..  .   .   ... . ..           .           ..        .       ..  . . . ..  . .  . . . .  ...  .   .  ..        .
.     .   ..   ..  . .. . ..  .    .   . .     .    ..   .     . ..   .   .    .    .  .  .    .   .      .  ..   . .  .    . .  . .   . . ..      .
.   ... .   .   .  ....      . ..   .. .  .  .           . .    .   .. .  . .  . .   ..   .     .         .   .  .    .          ...      . .      .
.    ..  ..         . ...   . . ..  .    ..      .  . .  . .  .          .   ...          . .   . ... . . . ..  .      .    . ..   .        .    ...
.         .     .    .         .   ...    .. ... .     .  . .  .      ...     .  . ..    ... . . .  .        . .     .. ..   .        .       .    .
.  .     .  . .  . .   .     . ..        ..       .  .. .    . .       .  ...  ..  .       ..  .. .   .  .  .          .         .        .        .
.  .    . .      . .. .  .  .  .. .  . .. ..  .  ...    .          .. . .   .    . .   ... ..     ..        .  . ..  ... .  .....   ..    .      ...
.   .       .   . ..     ....    . .. . . ...    .    ..         . .            ..   ...          .             .    .  .  . ....   .        .   . .
. . .   .... . . .......       .   ..         .  ..     . .   .      .         .    . . ..   .   .      .       . ..     ..       . .   .     . .. .
.  ..   .   . . .. . .....  .          .       ..    .   . .      .  .    ..   . ...        ..            . ...             .   .  . .    .   .  . .
..        .  .       . .....   .....     .  ..  ..  .  .     ..  . .  ...  .. .  .. .. ....  ....    . . .    .     ..  ..           .. ..         .
..    ..   .    .    .. ..     .    .       . .  ...   . .. .     .   ..  .  .  ... .      .         . .   .  .  .       ..      .   .       .     .
..    .....    .. . . ..   . .    . ....  .    .       .  .. ..  ..          . . . ..      ..     ..  .  ...      .   ..    . ....   ...      ..   .
.. ..   .         .   .  . .         . .   .  .  . . . .    .....  .            .  . .      .      .   .    .    .. . .  ..   . . . ..  ...   ..   .
.  .  .    .         ... ..                    .        .. .   . . .   . ...   .   ..       .    .  .      ..   .    . .  .  .        .        .  ..
..   .  ..  .  .  ...  ..      .   .  . .    . ... ..    ..  .. . .      ..  . .. . .    .       .  . . .....        .  ... . ... . .   ...  . .  ..
..    .. .. .. ..   . .. . .    .         .    .. ..          .           .  .    .  . . .   .  ..  .   .         . .. .   .  .   ..   ... .  .   ..
....................................................................................................................................................
