.....................................................................................................................................................
.   .       .   . ..  .   . .       .          ..  .  .  . ..    ..    . .      .  .    ....  .  ..         .. .  .  ..   . ..  .   ..      . .     .
.  ..  .       ..    .                 .. .   .     . ..    . .      .   .    . .     .    ..   .       .   .      ..    .... .      . . ......    ..
.  .           .  .     ...        . .  .... .  .....      ..    ...  .. .. ..                     .   .    .  .      . ...   ..... .  ..   ..      .
. X   .      .   .   . .. ..  . .            . ..  .       . .     .       . .  . .        . .. .  .  .   . .   . ...     . ..  ..      . .   . . . .
..   ... . ..  .         . .       ..  .           .  ...   .  .  ..         .  .  .   .      .   .       .      .    ..       ..  .       .   .  . .
...  ... ... r .    ..    .        .  . .     .   .   . . . .. .  .  ..   ..   ..   .. .  .  .  .            ..    .     . .  .       . . .     .. ..
.                .  .       . .   .          .  ..  .       ... .  . . ..          .  .   .      .    .. .   ..  . . .       . . ...       .   . .. .
..     .. .. .  .   .               .      . .    .  .  . ..  ....     ..  . .      ....  . .    .  .. .       .    . . .. . ..     .     .   .. .  .
.  . .   .         .       .       . .    .        . .         .            .  .  .   .     . .  ..   .  . .     .  .. . . .   .  .                 .
.   ... . ....   . .    ...  .. ..   . .     . ...  ..         .           .. .   .. .    ..    .  ....        . .. .   ...   .            .   . .  .
.. .       .. . .       .  .   . .. . .. ..  .  .   .  .. .. . .    . .. .  .     .      . . ..    .   .  .. .  ...      ...    . .    .    ..     ..
..         ..       . ..     .. .. .  . .        ..    ..     . .      .   . . . ... . .    ..      .     .            . .             ......    .. .
. ..      .. .  .  ..   . ..  .. .. ..    .      . .  .  .      .       .. . ..  ..  ...     ...  .         . . .  . . . .   .  .. . . .    . .   ...
.  .              . . . .  ..  .      .      . .      .. .   .   . .   ..   .    ...     ..  ..  . .    .  .  ..  ..  ....  .  . ..    ...  .       .
.     . . . ...   ..     ....... .   .    .   . . .       .. .     . . .  .    . .  .    .  . ..    .  ....  ... . . .  . .        . .  .        . ..
. .. . ..   .    .   . .  .  ..    ..   .         .. .   ...     .   .   . . . .. . ..   .   . ..           .      .       ..  .       . .  .  .   ..
..   ..   .   . .    ...  . .    .      .    .  .     .     ....    .    ..   .. .......     . ..         .  . .... .. .   .   .  ..  . .  .  .  .  .
.                   .      . .   . .    .. ..    .  .. .   .. .  .   .. .                .       ..               .  .   . .       .  .         .. ..
..    ..     ..     . ..    . .        .    .  .   .   .       . . .  .       .   .       ..     . ....     .  .   . .        .           .   .. .  .
...  .          . .  .  .. .     ..   .  .   .    .  . . ..     ...        ..  .     ..  .     .    .  . .. .   .  .... .. .      .         . ..    .
. .    ..    .. .      .     ..  .  .   .. ..  .   ..    .    .. .   ... . . .. .       .            .       ...    ..   ......     .  .     .. .   .
.   .     .     .  . .  .  ..   ..       .  ... .  .       .   .  . .    .  .        ... ..            .  . ..               .......    .. ...  .   .
.    ..   . .   ...     ..         . ...  .   . . .  .   .  ..       .  ..   ......    .   ...    .  ..  .  .       ..         .. .  .   ..  .  .   .
.      . .. .         .  . ...     .   .  . .  .. ..   ...     ..  ...    ..      ... .     .... .  . .   . . ..  .. ...   ..  . .      . .. .    . .
.    ..  ...  .      . ... ....       . .    ...              ... .    .           ..    ...  ..   .  .   . .       . ..    . .  ..    .  . .    .  .
..   . .      . ..          .  . . ..   ....      ... ..   ..    . . . . ...  .            . .     ...   .             .            . ..  . .       .
.    .     ..    . .        ... ..  .    .          ..    .  . .     ...    .       . ...  .. ..        .    .          . .  . ..         ...      ..
... . ...     .. .. .. .          .      .   . .    ... .  . .    . . .  ..   . .  ..  ..     .   ...             .     .  ..   . ...      .  . .   .
.        . .     ... . .. . .    .      .            .  . ..  .   .  .      . . ..  .  .     .      .     ..  . .    . .         .. .. .  .. .      .
. .   ..   ..    .    . .   .. . .  .     .          .     .    . ...  . . .       .    . .....    ...  .  ....  .  .   ... ..  ..  . .  .         ..
...    ..           ..  .. .   ..  .. . .  ..        .     ...          .   .  . .  . .      . .  . . .  ..           ..    .       . .. .   .  .   .
.   . ..  .       ..         .     . . .  . . .    .   .. .. .  .     . .       .  .. . ..  .     .  . ..   .   . .    ..  .     ..   . . .  .      .
.  .. .  ..  ....  ...  ..  .   ... .           ... .. . ...     .   . .    . .     . . ...  .  ...   .  .    ... .   .  .  . .  .   . .      .   . .
. .   .   ..         . .        ..       .       .. .                .             .    . .  . ..     .            .. .  . .   .  ..  ..    .       .
..    .      .. .      .. .    . .. .     ... ..       .    ..      .                ..    .  .  .      .  .   .     .   . .. . ...   ..     ... .. .
..         ...  .    .   . ... ..                                                   . . .   .. .             ..     . ..    ... . .   ..   .. .  .  .
. .   ... ...      .      .             .. .       . .  . .   .... . .  .  . . .     .. .      . ... .   . .        .  .  .     .. .  .  . .    . ...
.  .  ..  .. . ..          .    . .  .  . .    .  .  ..  .     .  .  .  ....     ..   .   . .  .        ..  . .  . .  .    .  .  .    . .     .   . .
.  .     .      .   .   . ..  .     ..   . . ...  ..             ...   .. ... .  .  . .  ..   ..       .  .    . .  .     ..    .             .  . ..
...  .  .     .    ... .  .. .    . .. . .   ..   ..    .  .     ..    .  .   .   .  . .     ... .    .        .. ..        .  ..    ... .     .   ..
. .  .   .                 .   ...  . . ..              .     .  .. .. .       .      ... .        .   ..     .  ..    .. .  ..   . ..  .... .    ...
.   .. .  .   ..  .....               .       .   .  ...      .   .. .. .. ..   .. .  . .      . .  .   .  . .  .     ...    .        .       .  .. .
. .  .      .. .    . .   ..  ..     ....    .  . .         . .   .    .      . .   . .   ...                 .   .  .  ..   . ... ..  .    .     . .
. .  .   .  ..  ..     ..      ....    ..   . .   . .. .       .  . .  .  .      . ..  .  ...    ...  ..  . ..  . .. .        . ..      . .  ..  ....
..  . . .  ..  .        .. . ..    . .   . ..     .     .   ...        .  ..   ..      .. ..   . .  .....   ..     .          ..     . .       .... .
. .        .      . ... ....   .  .  ....  ..   ...     ..    .  . ..  .... . ..   .  .         .   .    ... .               ..  ..    ...   .   .  .
.    .    .    . . ..   .  .. .     .  . .   ..   ...   ..    ...     .           . .   .  ..  .     .    . .          .      . .      .. ..  . . . .
.. .. ..   .       ..  .. ..   . .... . .  . .. . .        . ...  .    .      .       . .  . . ..   .  .. ...           . .           .   .         .
...   .  .   .   .   .       . . .. .     . .  . ....   .. ..     ..     ...  .  ..  .   ..  .. ..  .      . .       .. ...    .          .       . .
... ...  .      .   . .   . .    . .   . .   . . ..    .   . .   .. . .. .      ..   . .     .          . .   .    .  .      .   .  .     . ....  . .
.             ..     .. .  .  ..  .   . .  .      . . . .   .   . .       ...    .    .      .    ....  ..     .     ..    . ..        .. .    . . ..
. . ..   ..    .  .        .    .  . ..  .  . . .  .   ..  .    .. . .      . . .    .       . .  ...       .     .       .    . .. .   . .     ..  .
.   .  ..    . .  ..     ..   . . .   .  . .     .     .       .        .  ..  .     .   .  . .....   .   . . .  . .. ..  . .     .   . . .   . ..  .
. ..  ..      . ..   .   .. .. .             . . ... .  .    . . .       .          .  . .  ...  .  ... ..    .   .  .     . .  .     . . ..   .   ..
.....      .      .    . ....  .    .              ... .         .. ..   . . .  .                  . ..  .    . .      .  . .         ...  .  . ... .
.  ..   . .  . .  .     . .  ..   .....  . .  .   .   ..  .  ..     .   .  ..   .. ..     ..  .         ...      .       .  . .. .       ..  .  .  ..
.  .    .   .  .       ...   ..  .. . .   .   ...... ... ...     .      .   . . .    .   . .   . .             .     . .    .   .  .  .   ..   . .  .
...  .... .         . .     . . . . ..   . .              .  .                    ..  .   .    .   .    .      ..  .          . . ..     ... .      .
.   .      .  . .    .     . .. .      .       .. . ...     .      .  .   . .  .     .                  . .     .   . . .  .  .           ..      ...
.   . .    ..   .     . .  .         .  . .           ..      .              .   ..     .  . .. .     ..  ..     .   ..        .  .  .  ..   ..   . .
. ...                       .   ... .     . ..   . .. ..   .  .  ... .   .       .      ..       . .  ..   ..  ... .  ..    .   . .         .      ..
.  . . .  .     .  . ..     .. .. ..          ...  ....  . . .               ..   . .   .     .  ..   ...  . .     .    .. .   .  . .     .  . .   ..
.       .    .....   .  .  .     . .             .   .. . .  . . .   . .   . .. . .  .  .    .    .      .   .. .     . ..  . . .     .    ...      .
...       ..    . ..     .   .        . .     .. ..    ... ...         .       ...   .   ..  .    .  .    . .  .. .    . ...     .  .     .     .   .
. ..   ..     ...      .  . .  . .  .      .    .  .    .          .    . .  . ...         ..      .  ...  .. .  .      .        .          .       .
.  ..       .  .     . ..          .   .  ... .  . . .          ..     .       .. .   .    .  .      ..  ..  ...   .. .     .... .    . . .    .    .
.. .  ..   .      ..   .. . .   .    .     .     ..  .  .   .  .     ..        .     .  .   .  .     .. . .        .  . .   .         ... ...   ..  .
. . ... .. . .  ..  .  . . .    . . .. . . .        .   . ..           ...          . . .   ..  .  . .    .   . ...  ..  .    . .        .  . ..  . .
.  .  .    .  . .     . .. .   .. . .   ...  .   .. .     ...  . . ..   .   . . .   .      ..      .  .    .   .     .. .      . .       . .  .. .  .
. .     .  . .   .  .                    .  .. .   . .      .   ..     .. .    ...           ..  .     . ..  . .       .   ..    .   ..            ..
. . . . . ..  .        . . .  . .        .         . .  .   . .  ... .  .  ..       .     .  .      .  .   . .  .  .  ..    . .       .        . .  .
... .    .        .. ..        . . .        .        . .    .. .  . .  .          . .    .  . .. . ....... . ..     .....  . ..    .       .        .
.  ....      .    .   .... .           ....    .        ..   .   ..   .         ..   .         .  . ..     ..            ..   .   . . .  ..    . .  .
..         .... . . ..  .      .     .  .  .     ..     .        ..   .. . ..  .          ..  .    .  .  .... .. .  . .  .. ...       .  .. .   .   .
.    .        .  .    .    .  . ..    . ..   .    .   .   .. .   ..   . .  . ..     . .  . .  .  .    ..      . ... ..     ...    . ....    ..    ...
.   ....    ..         .   ..   .      ..      . .     .    ..     .  ..    .     . .. .  ..       ..   .     ... .           ..     ..   .       . .
. .. ....         .     .  .    ..   ..   .    ...  .     .  . .. .      ...       .    . ....      .    . ..   ... ..    .     .     . ...   .  .  .
..  .  . . ..  .       . . . .      . .    .  . .   . .. .          .          .   .  ...  .   ..     .     . ..     .. .  .. ..   .  . ...   ...  ..
...  .  ....    ..    . ... .   ..   . . .            ...     .       .      . . .    .  .       . . .  ...    .    .  .  ...   ....  ......   .  ...
..      .  .  ..   .      .        .. . .       .. .     .     . . .          .  .    ..    .. .  .   ....  .. .   .   .       . .     . .  ... ..  .
...        .  .      .  .     . .  ..     .. . .. .        .   .        .     ..  ..    .    . .    ..  .   . . .        .   . .  .      . .   .   ..
.   . ..    ..        .  . . . .. .. .   ...  . ...  ..         ..   .     .  ..       .   .            . . ..... .  .          .     .. . ...  .   .
. . .   ...    ..  .    .  . .       ...  .       ... ... . .      ..  .  .   .      ..    ..   .  .. .       .. ..   .  .                  .    .  .
.  . .    ..      ...     .  .   .          .     . .  .    . .   . .  . .  .       .           . ..  .... .   .    .   .. .        .. ..  .    .   .
.   .   .    .            ..  . . .  .   ..    ..    . .    ..   ....  .    .      .  .   ..       ..   ....    .  ... ... .     .    . ..  ..      .
.   .  . ..  .        ..  .. .    .          .     .     .         .    . ..  .         .....        .  ....   ..      .   . . ..  ..     .      .  .
. ..   .... .    .    .   .  .   .. . .  .   . ...   . .   . .       .       ..    .  .     .    .     ..  ..  .    .. .. .       ..   .            .
. ....  .. . . ......      . .... .. .    ..   .  ...  .  . ..    .  .. . . .      . ..     .   .     ...  . .   .   .        .  .      .   .    ....
.   . .   . .    ..  .     .. .     ... .    ..  . .  ..   .   .......  .   .     .    .    .   .   . .     . .  .  .      .   .       . ...  . .. ..
..    .  .  ..      .      ...   .  .  ..   .   .   ..   .  .   .  ...      .           .  .      . ..      . .  . .. .... .       .  .   ..  . .   .
. . .  .     .    .     .....     . .  .... ..         .  . . .        ..    . .. .. .. ...      ..         .. .   ..            .    ..  ...     . .
.. .. .. .  . . ..  .     .   .. .  .    .  .    ... . ..    .    . .    .  .  ...        .   .  .. .       .   .       . . ...  .      .  .      . .
. . .      ..    . .    . .  .   .   .             .. . .    . ... .   .  .. . .     .. .  ..   .  .. . ..   . ..     .           .  .    . .    . ..
..     ...        . .. ...   .   . .. .     ..  . . .         .      . ..       .      .       .      ...     .  . .              . .   .           .
..        .   .. .   ..      .  . .. .           .    . . ....   .  ..    .  .          ..       .     .    .  . .. . . ..   .   .   ..  .  .  .  ...
.       . .  .  .    ...  . ...    .      .        . .     .   .      ..      .  ..    .      .   . .      . .   . .       . .    .    . ..  .... ...
.    ..             . . .  . .        ...  .  . .  .    .  . . . ..... .    .          ..    .     .         .       .   .    .. . .               ..
.   ..   . . . .   .   .     .     .         .   .  . ..     ...  .          . ...          .  ..  . .      ... .       ..      ..  .           ..  .
.        ... .   .  .   .   .  .   . .. .   .   .. ..    . ..  .  .. ..      .  .  .....  . .    .  .        .   .      .      .    .    .    .   ...
.     . . . . ..     ..  .  ..       ..   .. .  .   .  .  .   . .  .    .        ....        ...   .   .. ..  .     .   ...         ..  .    .    . .
. .  .   ..    .   .   .      . ..    . .   . .               ..         . .   ..  .  .    .    . .       .  ... .. .       .  .   .  . .. .     .  .
. . ....   .   .  . . .        .   . .. . . .    .. . . .   .  .      .   ..     ... . .....    .  . .          .  . .   .. .     .  . .   .. .. .  .
.  .  .  .             ..   .. ..  .  .  ...   .   .         .  . .         .   ..        . .    .      .. .   .    . .             ..    .   .   . .
.  .     .. .       ...         . .       ..   .   .   . .      . . ...        .     .       .   ..   .. .       .. .  . .    .  .      .      . .  .
.    ..   . . ....     ..       .   . .     ..      .... .. .  . . .  . .  ..   .   ..  .  .      ..    .   .. .  .  ..  .            ...     .     .
. . . .  ... .  ..   .  .  ...   .  .       ..  ..     ..              .    ..    .   .   .  ..  ..        .          . .       .  .    .   . .     .
. ..   ..    .  .. .   ..     .      . ..  ..          .   .   ..    ..    .. ..     . .      .  . .  .      ......   . .  ..       .  .. .   .. .  .
... ..  .  .  .   ..    .  .      .       .  . ...  . ..   .         ..  .  .      .  ....            . .   . ..     .          .      .       .. ...
..   .        .  ..  .  .  . . . .  . .    . .        . .               .  .  ..  .  . ...  . .      .  .    . .  .    . ..  . .  ..   .  .    .    .
..  .   . .   .... ...  .     .. .   .. .   .  .     .  ... .   .      ..    .    .  . .    .       .  . .    ..       . .      . . .   .. .  . .  ..
.  . . .   .    ..    . .. .              .          ..  .           . ...  . .   .... .  . . ..  ....  .  .   .  .   .  .  .   ..    .   .     . ...
.  .  . .   ..  . . .  . . .   .  . .      . ..        .. .   .   ..  .  .  .      . ..  .  .  . ..  .       . . ..  .  . .  . .  .    .  . ..  ... .
. .    .    ...      ....  .            . . .  .  . .    .            .          . . .    .. .. . ..   .   .    ...        .         . .  .      .  .
...   .  .... .         .     .     .  . .   .  ..  ...                . .  ..    ..         .. ... ..          . . ..    .  . .   . .  ..  . . .   .
.   ...   ...   ..    .     .   .. .   .       .  .               .  .  ..  .           .   . ..    ..  .       ....  .. . . .    .    ..       .  ..
. .    . .  . ..        ..   .. . .   . ..    ...  . .   .     .     .    .        . .   .    .    .        . .       .  .   .  .      . .      .  ..
.       .    .       .    ..    .   ..   .      .         .  .           ..  . .. .          ..   .     . .. ...  .           .               .  .  .
.       .  .  . .  . . .   .    .....   .  . .  .. .   .        .  .. . .  .. .  ..      .  .         ...     .    .  .    .       .  .  .   .  ... .
. .      . .      .  .    . ...    ..   .  ..   .    .  ... .  . .. ...  .   . . .  .. .  . .        .   . .  .   . ..  ... .        .  . ..       ..
..            . .    .    .   . .   . .         . ...    .    ...    .   . ..     ..    .    .     .          .        .   .. .    . .     .   ..  ..
..  . .....       .        ...   . . .  . . .      .   . ..  . .  .    . .    .            ...  . .  .   . .           .   .      . ..  .. .     . ..
.  ...    .  . ...   .   ..     . . .     .     .    .  .   ..   . .     . ..               .      . .  ... ...  ..  .. . .             .  .... .   .
.. .   .   ..  .  .   . .  ..      .  .. ..        ..            .  .  .     ..  .    . .        .   .  . ....     .  .     .    ..  .             ..
.    .    .    ..   .   ..     ..   ...      .       . .. ...          . .    ..     ..           .             .   .  ..     . .      .            .
. .   ..  . .     .      .         . .        .  . .     .        .  .  ..   ..     .       .  . ..  .    ....            . .    . . .. .       .  ..
.             ..        .   .             . ..  . .                 . .        .    .  ..  . .       .. .  .      .            .  .   .     . .    ..
. .                 .  ..   ..       .              .  . . ..  .      . . .        .      . ..     ... .          ..        .   . . ..       .   .. .
. ....  ...   ...       .. .    .   .. . ..  . ...  .       ..   .  .     .   . ..    .      .     .   ..   ..    . .. .     ..          ....    . ..
.  .           . ..   . .. ..       .  ..       ..       .  .  ..     .     .   . ..    .  .        ..     . .  ..   .     .    . .                 .
.    .  .   ..         .  ..     ..   . .     .  . . .  .       ..   .    ..       .     . .   .  .  .  .   .  .   .. ..    .. . .            .   . .
..  . . . .   .    .   ..     .  .  .    .    .     .  .   . .    .    .   ..   .     .   .    ..  .  . ..   .         . . .  .. .   .   ..   .     .
. .        . ..        .. ... . ...  .    .       .   . .            . .    . .  .... .. .        .      .    .  .  .        .      .    .     .  . .
.. .  ..  .       ....       .  .    .  .      ..      .    .          .     . .. .  .   .     .  . . .  ..     .  . ..   ...          ...    .    ..
.      .      .....    .  .  .  . ..   .      ..  . . .    .  .  .          .  .. .     .         .    ..     .    .              .       ...   .  ..
. . .. . . . .     .  ....         . .  ..   .     .          .   .    .   ..      .   .   . .        ... . .. . .  .    .  ..  .  ..  ..   .  .  . .
.  .                . . . .     .  .   .  .  ..  . .    .  .  .    .   .. ..       ..        .. . . ... . ....      .  ....    .  . .   . .. .   .  .
.                  .   ..   .     ..  . .   .      . .         .. . ...  . .  ...    .  .       .  .. .      .   ..       . .  ..    . .   . .  .  ..
. .   .  .    .  ..   .   . .       .  .     .     . .     .      .         .      .  ..    ....  ...   ..       . .         . . .       .  .       .
..  .       ..  .. .  . .    ..      .       .   .. . .. ..        .. .    ..  .      .   .   ....  .     ..  .           . .   ..    ..         . ..
..   .    .    ...  .   .     .  ...   .  ..   .        ..    . ..    .       .   .        ..  .  . . ..  .  .. .   . . .   .  ..      ....  .      .
. .   ..       .. .  .     .    ..    .   ..   .    . ..  .     . . ..    .  .   ..       . .. .           .         .        .            .       ..
.  ..     . ..      . .  .  .    ..    .  .   .. . .       .  . ....  .   . . .      ...... .. .  .      ..    . .     .  . .    . .... .  ...    . .
... .     .      .  .                     .   . . .... .       .   . .    .           .        . .      . .          ...         .    .   ..     ....
......   . . . .    .  ..   ..    . .     .     . .    ...   .  .         ..  ..  .         ..          .  .... .        . .    . .     .. . .      .
.. .  .   .    ...     .   ...       .  ..   .  . .. . . .      .  . . .  .       . .   .    .. ... .  . . .    .    ...   ..   . .   ..   .    .  ..
. ......  . .  .      . .    . .     .. .....  ....    .. .... .        .      ..  . . ..  .   .. . .  .       .              .    .    .        .. .
.  ..    ..        .  ....  .  . . ..    .      .     .  .       ..   .  .    .. .    .. .. ..  . .            .    .  .  .. ...  ..          ..  . .
.....................................................................................................................................................
