..............
. ... .      .
.  .   .  .  .
..  . .  .   .
..  . . . .  .
.       X    .
.    . .  r ..
.. .  . . ....
..     .     .
.       .  . .
...    .     .
..     . ..  .
...  .. .  . .
..............
