......................................................................................................................................................
.         ...  .  . . ..  ....    .      ..          .    .       ... ..   ..    . ..    . .     ....            .      . .        .....  .         ..
.   .      .. .  .   .  .        .   .. .                 .     ..  .    . . . ..   .       .  .    .           ...  ..  ..   . .  . .    .   . .  . .
.   . .     ..  ... .  ..  .  .    . . ...   . ....   .        .   ..   .   ..  . .    ... ..           .  .  .  . .  .  .   .       ..      . ..   ..
..  . ... .   ..            . .. .   . .. .. .    .      .    .  ..   ..      . .  . .   .. .     . ...    ..      ..     .    . .     ..  .       . .
. .. .     .     .. ... ..  ..     . ..   .     . .    ..   . .. .   .     ..   ... . .     . .   . ..  ..   .       .  ....     ..    . .   .   .  ..
.   ....  ..  .. ......    .       . .  ..         ..  ..     .     .     .    . ...   .  . .   .....   .  .     .  .. .   .   .           .  ..   . .
. ...    .    . ..        ..    .      . .  .   . ..     . .      .  . .       .   .    ..  ....   ..  ..  .   ...      . .        .            ..  ..
.       .  .                  . .              .   .   .   .        . ..                . .     .. .       . .    ..  . .. .. ..   .  . ..     .    ..
. . .        . .  .  .. .. . ..   ...          .  .     . .. ..    .             ..    .           .     .      .  .   ... .   .       ...    .. .   .
. .     .       .                . ...  ..   . .    . .             .  .            ....    .  .  .  .. ..          .  ..  .            .  .. .    ...
.  . .   .  .. ..  .   .    .  . .. .  ...      .     . . .    . ..        .       ..     .  ..         . .  .. .  .       ..   .        . .    . .  .
.  ..    . .     ...   .      . .. .  .  ..    .     .  ....     .      .   .      ...             ..  ..    .  .    ..    ...    ..   . .  . ... .  .
. .   .      ....    .     . .....    .   .  .      . .                          ..   .       .  .      . . ..         .   ..    .     .    .        .
.   .   .  .. . ..  .                .    ...   .  .    . ..  .. .        . .          .       ....      ..   .    .  .           .   .     ..  .. . .
.  ... .   . .  .  . ... .   ..  ..      .. . .         ..  ....   . .    .     ...     ..  . .. .... .   .   .  .       .. . .   ......   .   .   . .
. . . .  .      . .   .        .   ..   .. ..   .    .          .   .   .     . ..  . .    ..  ...  .      ...    ..     ..   ..  . .    .  ...    . .
.    .         . . .  .. ..    ..    . .   . .    .       .     . .     . .    .     . .. . . . .   . . .      ...  .    . .    .  .  ..  .       ....
.          .    ........     .  . .    .  .  .       ..    ... ..   . . .      .       . ..            .    .     ...   . ..  . .   .  ...   . .     .
.  .     ..  .  .   ..    .     . .. ..  .  ...     .  ..       .      ..   .      .      .      .   ... .   .  .   ..             .      . .    .   .
.   ..   .   . .  .  .    ..      .   .    . .      ......  .     .... .    .                 .     ....     ..        . .  .     .  . .     . ..    .
.. .              ..  .      . .. . . . .   .  . . . .     ...   .   . .   . .. .   ...   .  ..  .   ...    . ... .  .  .  .   .   . .    ...    .. ..
.. ... .  . ..  .  ..   . .     .  . .   .   . ..   . .. . .         .   .    .  .       .....     .    ..   .           ..   . ..  . . .  . .       .
. .  . .  .  . . .  . .  .   .....          .  ..  .         ..  . ...  . . .  ..  . ...    .   .  .   . .. .  .. .. .     .    .          .. . . .. .
.    ..   .   .    ....  .    ..   . . ..  . .  .         .   . .  .. .         .   ...      .     ..             .         .      .. . .     .  .   .
...    . . .     .. .   . .   . . ..           .   . .       .       .       ..         . .   .  .  . .   .   .  .   .  ... .  ..  . . . .     ..    .
.      ... ... . .    . .     ...         ...      .   .. .       .  .... .       . ..  .          . ...  .   ....   .  .    . . .   .   .   .      ..
..    . .....  .....    .      .....       .... .     .... .  .    ..      .   .    ..       ..  .  .   . . .. .  .   .      . .  ..      ..      .  .
.         . .     .   ...      ..           .         .   .  ..  . ..  .  . .   . .  . .      ..     .     . .   .  .  .    .   .   .. . .    .      .
.     ..    . ...            .    ..    .    .    .   .    .   .         . .    .  ..     .  . ...  .   ..      ..   . .  ....       .    .  .  .    .
.          .       .  .        .  .   .   .     .  .   . ..  ...          .   .   .   . ...   . .  .    ...   .            ..  .    . . .            .
.     ..   .           .   .  ..    .       .     .  .  .. ..     ..   .  .    . .        .      .     .....  . . .  .       .  . .           .  .   .
. . ..  .      .    .     ...  .  .   .. .      .     . .     ..   .  . .    . .       . ... ..  . .    .   ..     .. . .  ..      . .    . .    .   .
. .       .. ... . .             .   ..            . .   ..          ..   . .  .     ..   . . .. ..   .   . .  ..  ...    ..   .. .         .   .. ...
.   .  . .       ..   ..  ..  .    .  .   .  .. . .  .              .  .  . ...  .     ..   .. ..  .  . ..   ..     ..    . .  .     . .    ..       .
.   .. ...  ... ...  . ....  .. .  ..    . .....    .. .     ..  .. .  .  . .      . .  ..   ...  ..          .... .  .  . ... .  .  .   ..          .
.  .    .        ..  .    .   . .        .     .   . . .   .  . .     ..  ..    . ..       .  ..         .      .   .. . .. .. .   .     .      . .. .
.. .  ...      .....   ....  .   .   ... .     .  .    .    ..  .     .          .  .      .. ..        ... .   ..  .   ...    ...    .   .     .    .
.   .... ..           . ..         .   ..   .      .... ..      ..  .      .  .. ... .  . ..           .        . .  ..  .                ... ..     .
.    .   ...     .    .    .   .. .       .           . . .   .. . ...  ...  .      ...     .     .   .  .       .  .      .        .    .  ..   . ...
.      .  .           ..  .   .  .  .  .    .    .  ..  ... . ... .   ..        .  . .  . .        .    . .. .   ..  .       . . .    . . .          .
..  ..... ..       .     .  .... . . ..  .. ..       .  .  . .     . ..    . .   ....   . .    .   .. .    .      .            .  .     .       .    .
.. .    .  .. .     .  .    . ...      . . .   ..  .     .      .   .   . ..   .          ...            .         ..    . ..   .          .      .. .
.    ...    ..               .     .      .  . .  .  .. .    .   .     .           . . .   .    . ... .      .     .   .  .... .        .  .. . .    .
...       .  . . .. .... .        .    .   .. . . .. ...      ....  . .    .  . .   .  .   .   . . .  ..   .  ..    ..     ..  .      .     .  .  .. .
.  ..  .  .             .           .   .     ..    ..        ..             ..   ..   . . .   .   .  .  . .    .   .  .. .   . .     .     . . .  . .
.   . .   ...       .    .     .   .      . . . .. .     . . .  . . ..  . . .  . .. ..        . .          .   .  .  . ... .      . ..       . . .  ..
. ...  .. . . .         .          ...   . . .     . .. .   .     .   . .    .    . .   . ..   .      .    .. ..            .   .  ......            .
.       . .   .   .. ..     .     .  ...             ...    .  .   . .      . .  .      ..  .    .  ... .       .    ....  .    . .       .      .   .
. .....    .. .. .     ..    . .   .        .   .    . .  ...     .        .  . .     ..  .   ..    . . .             .        . ..  .        ..   . .
..      ...   .  .  .   ...      .    .         .... . . .  . . ...  . .   .....  . .....  .      ..     .     ..    .     ..    ... .   .... .   ....
.   .   .       . . .. . ...   .   ...  .   .    .  .  .                .    .        . . .  .  .   ..    .  .  .         .       ... .        .  .  .
..   ...   . . .    . . .     . . .   . . ... .   .       ...  .    ..      ...    .     . ... . . .. .   ...         .     . . . . ..    .    .. .  .
.  .  . .  ..     .     ..  .     .       .    .   .      .          .  .  .  .     .    . .      .  .    .      ..  . .        ..         . .     . .
.... .  ......  .  .  .   .  . ..     .  .   .. .      .  .....    .... .  ..  .   . .   .   .....  . . .     . .    .  . .    ... .  .      .       .
.  .      .  ..   . ..     .    ..      .     .  ..       .   ...  .  .. ..   .    . .  ..  .    .    . . ..   .    .    . ..  ...   ..   .    ..   ..
.   .  .  .       . ..     .           .   .    ..        .   .      . .       .  .        ..             .  .  .    . .   ..     ..  .      .  .    .
. .     .  .. .    .  ..  . .    .. . . ..     .  ...    .    .   .  .   .  .          . . .          ..   . .      . .  . .     .       .  . .      .
.   ..    . .    .     .    .     ..   .  .    ...    .....  ...            .    .   .. ..        .. .  . . ...        .           .    ..  . .    . .
. .  .  .       .   ..  ...  .  .  . .   ..    .  .   .. .   . . .  .   . .           ...     ...   .. ..  .     ..  .  .       .  . ..       . .    .
..   ..    ... . .   ..    .    .  .     ...  ... ..   .  .     ..   .. .  . . .        .    ..    ..  .       .. .     . .  ..           ..      ....
.   . .     .               .. .  .   .  ..       .   .   ...    .   . ....     . .        . .    ..   ..   .. ..  .      ..  .  .. . .  .           .
. .   .      . ...     . . .  .    .  .  . .   ..    .. ..  ..    ...   . .  .    .... . . .   .  . . . ..     . ..  .. ..  .  .     ..     . ..    ..
.. ..  .  ..    .          .. .      .    ..  . ..  . .  . .   .   . .   ..              .         .. ..     ..  ..  .     .      .  . .   . .. .  . .
.        ..  ..    . ..    ... ..  . ..            .   . . ..      .. .     .        .              .  .            . ..   . .    .   .         ...  .
. .    .   .     .  ...  .  .       .  ..   .  .      .     ..... . .  .    .  ...  . ..       .  .  . .   .   .. .  . . .         .       .. ..... ..
...       . .  .   ...  .  .   ...   ... .    .      ...   .. . .. .  ..       . . ..     .  . .      .     .           ..  ..   .   .. .   .    .   .
.    . .  ...  .                .      ....    ....        ..     .   . .. .  ..    .    .    .     ..   .                .      ..  ..  .  .   . .  .
.     ..     .. ..       .    . .. .     .  .     .      .   . .. . .  .  .    . . ......       .          .      .   .. . .      .  .   .  .  .     .
..   .  .        ..      .    ...  .     . ..  .                       .    .. .  .   ..... ..  .        ..... .   .. . ..       ..    .. .      . . .
.          .     .            .      .. .             .   .           .   .             ...    .. . ..       ..     .        . .    .    . . .      ..
.    .      ..  .      .     . .     . . . X   .  .. . .      .    .     .   ...         ..      . .  ...  . ..        . .    .   .     .    ...   . .
. .  ..  . . .  . . . .        ..   .            .  .        ...  ..  .   .. . .. . .     . . .          .   ..       ..  .. .    .   .     .        .
..        .    .    .   .     .   .        .. .   .        ...               .      .   .. .    .. . . ..     ...    ... .  . . . .      .  ...  .   .
..     . ... .     ..    .  ..   .. ..   .  . ..   .  . . .        . .     .      .          .       .     . .    .  .      .    .  .    . ..       ..
..       ...    .              .  .   .       .   .      .           ..    .  ...       . .    .. ..   ..  ..    .    .    ...  .  ..       .        .
.   .   . .  .      . ....   . .. .  .        ...  .   .     .    .     .          .  ..    .   .   .        .    .      .     ...   . .        .  . .
.    .   ..   .       .  .    . . .   .  .   .     .     . ..  ..  . .          . .         ...      . .     .  ..   .       .  . .      .   .  . .. .
. . ..      .  .  .  .  ...     . .  .   ..  .  . .  . . .  . .   .  . .    ..  . ..    ......    . ..          .   .  .    ..        .    . .  . .. .
. . . .  ...  .     .    .      .  .  .       .          . ... .      ...      .   .. .     ....             ..    .  .  .       ..         .     . ..
.    . . . .         . .  .  . .  .     .. .     .. .  ...     ..      ..      . .      .    .    .  .. .       .  . ..    ....  . . ..   .    ..   ..
.. .. .     . .  .  .          . .  ... . .      .  ... .    .    .    .  .   .. ...       ..  .   ...   . ..  ...  . .   ....     ..  .           . .
.  .   . .     .. . .  ..   .. ..... .   .               ..           .   .   ..   .   ..    .    ..        .  . ..   ..    .     ..   . .   .     . .
.  . .      .  . .  .  .    .. .   .   .    .  ....    ..  .     .   . .          ...  .  .   .  .   . .....  .   .           . ...       .    .     .
....    ..  .     .   .      .  . .      . . .     .   ...   ...  ..             .  .   . . .   .    .....     . .      .   ..  .. ..         .  . ...
.  .  .  .  .   .     .            .  .    ...    .    .     . .  ....  ...  . . ..  ..  . .  .  . .  . . .    .   .... . ..      .  .   . .     . . .
....       .. ..  .  . .    ..  ... . ..     . .   .. .    .  .    . .     .  .....       . ..   .    .      .  .    .        .    .   .. .  ..      .
.     ..  .  .  .  ...     .     . . .  .  . ..     .     .        .         . .       ..       .             .  .. ...    .       . ..  . .   ...  ..
. ..    .     . . . .   .       . .    .   ... .      .        .       .    .   .  ..    .   .     ..  . .       ..            .  .  . . .    . .  . .
. ..   .        .    ..  .   . .  ....     . .  .   .  ... . .  . ..   .     . .           . ... .    .   .    .... .   .. .   .      .  ..      .   .
. . .         .          ... .  .  . ...  ..    ..  .      ..              .     ...   .. ... ..  .   .  ..           . .   .. .      . ...    ..  . .
..  ..  .  ... .  ...     ...  .  . . .. ..    .       .   .     .      ....     .. .. . .. .     .  ..    .    . .   . . ...  .   .      . ..  .    .
. .     .  .. . .   . . .....   .      .  . .    . ..  .. ..  .  .   ...    .   ...    .. .. .    .   . ..     ..   .                 .  ..   .  .  ..
..       .   .    . .   .  .            .    . ..      .     ..    ..    .. . .    .  .  . .  ..    .  .     .       . ..    ..     .   .    ..   .. .
..   .    .   ..   . ..       .       . .   ...      . ..    .... . .    .       ..  ....   ..        .  .     ..     ... ..              .. . ..   ..
.    ..   . .. .     .  .     .       .       .   . . .  .  . .     . .. .  .     .   . .. .  ..   .  ..        . .       ..   .. .    ..   .    ... .
. ...    ..   .. . .    ...  . .  .       ..   .          .. .    .   ..    .    ...             .  . . .. . .    .. .  .  .. .   .       .. .. .    .
. .              .   .        .     .  .   . .  . ... .    .       ...  ..  .              .  .  . .  .     .  .  ...   ..  . ..    .   . . . .      .
. .       .. . .  .     .   . ...     .    .  ..    .  .  . . .      .  .              .  . .         .  ..  .. .         . ..    . .       .     .  .
.      .         .  . ..         .    .      ... . .. .        .   .. .    .  .      .          . ..       . ... .    .  . .   . .      . ..    .   ..
.    .    . . ..  .      .. .  .   .... .... .    .  .     .   ..  .... . .        .     .   .    .    ...  . .. .  .    .    ...   .. . ..   ..   ...
.       . .   .. .   .   ..    ...       .  .           .  .      .  ..    ...    .  . .      .          . . . .       . .   . .   .     . .       . .
.    .    ...  .      ... .   .        .         ...  ..         ... .  .. . .    .       ...  ..      .  . ..     ..   .   .  ...     . .       .   .
.       .   . .          ... . .  .    . .     ..   .. ..   .  ...    .. . .          ..   .   .  . . . .   ..   .       .     .   ..   .   ..   ..  .
.. . .    . . .   .  ..  .... .  .  .   .. .. .. .    .  .    .   . .  . .   .  ...  .       .      .         ..  ..        .    ..    ..   ..  ..   .
..      .    ..  . .   . ...   .     .       .    ..         . .        .   .       .     .         .   . .  .       .         . .          ..  ..  ..
.   .     .  .      .     .. .. .  .. ..   ..      .  . ..     .    .. . .     . ..    ..  .  .  .      .  .   .  .    . .  .. .  ..  .            . .
..   .        .      . ...                 .   . ...  .      . ...     ..   .     .   .          .     .  .  .  ..    .  .  . .   .. . . .     .... ..
. ..   ..   .. .  .. .   .  . ....    . .   .      .     ..  .    .   . .      .  ..      ..  .     .  ...    . .    .   ....  .. . . . .  .   . . . .
..      . .   ....    ....  .. ...  .    .   .      .        .  . . . . .  ...        .. .  .   . .  .      .       .  ..             . . . ..    .  .
..   .     . .        .. .....    ..   .    .. . .     ..   .   ..   . .             .    .  ...    ..      ....      ... ..  .    . .  ..    .    . .
.        .  .  . . .      ..     ..  . .  .. . .   ... ... ..  ..        . .. .  ..   . .  . ..   .   .  . .         ...       . . .   .   ...    .. .
..   .    ....   .. .  ..      . . .. . ...      . .  . ...  . . ...   ..  ...  .    ..   .   .   .    . . .     ..      . .    . . . ..      .  .   .
.. . .  . .   ...  .      .  .  . .     .                        . .  . .   . .             .    .. . . . ..      ...            .   .     .  .  .   .
.     .     . .  .     ..     . .    . .   ....  ...    . .  .  ....   .       .  ..     ..   . . . ..        .   .       .       . . .    . . . .   .
. .  ..    .  .  ..      .  ...  ...  ...          .  .  . . .    .        . . . .  ..            .         .. .. . ...   .  .   .  .   ..       ..  .
.   ..   .. ..   .       . . . . .. .. ....  .  .  . . ..           . .   .    .     .. ..   . ..     .           .. .     . .. . .      .  .   .    .
. .  ..    .     .   .     .  .  .     ..       .          ...    .    .        .        .  ..      .  .   .  .   .    .  ..  ..      .     .  ....  .
..    .  . . .   .  .          .. . .  . .. .   .  .           . ..     . .  ..    .   . .  . ...   .  .. .      ..       .  ..    .      .     .  . .
. . . .    .    .  . .  .  . ..         .  . .   .  .   ..  . .   .  ... .            .    . ....   .    .. .           .. .... . .   .. .   .       .
.     .   .  .          .  .   .       .. ..     . .  . .. . .  . .  ...  .   ..  .  ..  .  . . ..   ..  .  ..       .  ..   .     .  .   .      .   .
.    ..  .         .       ..        .  ...        .  .   .          .. .  .  .   . .            .       . . .  .  ...  .      .  ..   .     .  .    .
. . ..  . .     ...  . ..   . .  ..   ....        . ..  .. ...  ..   . .  . .    .     .     ..  .       ..   . ..     ....   . .       .      .     .
.         ... ..   . . .        . . ..   . .   .            .   ..  . . .   . .    .. .     ..    .  ...   .  ..  . .    ..          ..       . .  . .
.    . . .    .  .  ..     . .. .. . .  .     ..   .  . .  .       . .  . .  .   ...  . .      . . .    .  ..   ..    .  . ..     ..     .   . .   . .
..  . . .  . ..     ..      .....  .   . ..  ... .        .   ...      ..     .  ..   .         .     . ..     ..    .            . .           .  ...
.   .      ... . .  .. . ..  .        . .   .   . ..    ..     . .  .  . .   .  . .      .              .   .  . ... ..   . .  ...          . .      .
...   ..      .. .. . .    .        .    .      .. .      .  . .. .. .       .  ...      .   .   .   .   . . .  .  .      .  .  .  ....      .   .   .
.  ..  .   .    ......        .. ..   ..  . .      ..      ..            .    .     ..  .   .       .  .   .   ..        ..     . .          ..      .
.  ...       .   .. ....  ..   . .  ... .     .  .     .     .    ...      .   .             . . . . .           . ... ..    ..  .   .   ..    ..   ..
....       .  .. . ..   .     .. . ..     .  ..  ... .           ..    .    .  .   .       .   .       ..  . .  .  . .. ..   .  . .     . .      ... .
... .  . . ..   . .      ..    ...  .  .      ... .       ...    ...  ...      . ..    . ...   .      .  .  .  ...   .    .     . .   .     .   .   ..
...  .    ...  ..   .       . ...  .. ..  .  .  .    .   ..  .      .   . . .    . .       ..  . ..   .    . ..            .   .    .  .     .  .    .
..    .        .     .. . ..   .       .. .    . ..     .     ..  .  . .   . .  ... .    ... .... .    . .   .     .  .  ..     ..     .  .   . .   ..
.....  .  .   . .   ..     . . .   .            . .     . .   ..   .. .   . .  . .    .      .. .. .       ..        .    . .     . ...  ..   .  ..  .
.       .      . .          . .     ..  .. .           .           .   .  .. ..        ..  .    ..   ..  . .    ..      .   .. .  ...  .     ....  . .
. .     .    .        . ..  .  . .      .       .  ..   .   .  .. . .   .       .    .   .        .         . ...      .      .   .       .         ..
.       . ..  .....  .  ..   ..    .. . .. .. . ...  .   .                    . .   ..       ..   .   .    . . .            . .. .... .   .  .  .    .
..  .   .. .    . .   .  .  .   ..        .      . .. .  .    ..    .   .. ..   . . . .   . .   ..    .        .    ..      ...  .         .....   . .
. . .         .            .  ..  .   .     ..     ..  .  .... ...        .  ..  .      . ..  .   .     .  . . .  . .  .   . . ..  ....  .  .   .  ...
.         .....      r     . . .         .  . . .. .. .      .    .   ..      .     .     .   . .        .....  .   ..  .   .              ..    .....
..     .  .    .    ..      .   ..     .    . ...  . . .  . .   .                        . .       . ...       ..   ....     .        ..      .  . . .
.    .  . .    .   .    .                ..   .  .   ..     . . ......   . . .      .      .    ..   . . .      .. .   ..      .         .  .. . . . .
.              .  .    ...  . .... .     . .   .     . ..  . .   ..           .  ..   .    .         .. ..     . . .     .     .  .  .  ..  ..    .  .
. .   .  ..     ... . . .  ..   ...    ..         .      .          . .    . . .     .... . ...  .. .     .     .    .  .  .  .   . .          . . . .
.    .   .. .   .   .  .       . ..  .    ...    .      . . .             .... ..  ....   . ..   .  . .            . ..    . .        .. .   .. . . ..
...   . . . ...           ..   .   .  .. . .    ....   . .  ..     .      .   . ..   .  . .  .  .      .      . .       .... .         . .. .   ......
.  .  . .. ..       .      .  .            ..      .        .  . .   ..   .   ...       ..  ..   .   . .  .  .      .  .    ..       .     ... .   ...
.    ..    .  .. . .  . .       ..      . .     . . .     . ...   . . . . ....  ..       .        .  . .     . .   .....     .       ..  .. .   ...  .
......................................................................................................................................................
