.......................................................................................................................................................
.     ...   .      .    .    ...    ..  . .. ..  . . .. .. . .             .   .     . .    . . .        .  ....          .                . ..      ..
..   .. .      .     .  .      .   ..      .   . ..     .     .    .. .     .     .   .      . ....   .  .. .     .             .  .. . .  .  .  .  . .
... ..    .  . ... .    ..   .          .. ..   . . .     .   . .        .        ..  .      . .     .   .  .          .     .. .    . .            . .
.   ..    .    .         .  ..     .            ..     ..    .     .... .   ...  .. .  .     .   .. ..   .  . .   .      . ..   .     ..  .        . ..
. . .   .   .  .       .   . .     .   .            .. .       ... ..    ..   .                       .. . .            .    .     . .   ..        . ..
. ..      .    ..  .   .  . ..        .    .    ....     . . ..      .  . .      ..         .  .      . .     . .              . ...      ..  . .   . .
..  .. .  .   . ..   . .    ...    . .          .  .    . .....  . .    ..       ..    .  ..  . . .. .   .. .   ..     . . . .            ...       . .
. .     .  ..       ..  .    ..   . . .    . .   ..      .      .  .    ..   ..  .        .   .  .       .      . .. .  .  .  .. . .  .  ..   .  .  ...
. .               .  .  .... ....       . .  ...         .      .    .  . .  . .   ..    ..  .   ..  ..      ..    .    ..   .    .  .      .         .
.   . . .        . .  .         ..   . ...... .     . . .       .   . ...    ..     ... . . .   .  .    .    . . ..     .......     ...  .  .  . .    .
. .  ..    .. .. .   .   ... ..  .  .  .   . . .    .   ... . .  . . . .  .   ..  .     ..          .  ... . . .. ..    .  .   . .   .     . ...   .  .
.  ...   . .  .   . .    . ... . ..  .      . .     .  .        .   . ..     .. . .    ..              ..  .  .     ......       .  ... .     .   .. ..
. . .    ....  ...   ... .     . .       .   ... . ..  ...   . ..                  . ..      . .  ..      . ... .   .  .   ...  .     .  . .  . .. .  .
.    .    .      ....                    .. . . . .         ...  . . .     .   .  . . ..    .      ...    ..    .  .  .        . ...    . ...  .  .   .
..     . . .     ..      ...    ..  .      .   ..       .   .         . .. .      ..           .  .     .    ..             . .  .. .         .   . . .
. .  ..   ..  .       . . .     .         ..   .     .  .    ..   .  . . ...... .. .         .     . .                     .. .              .    ..  .
...   .   ..   . . ...         .  .   . ....         . .  .    . .    .  . .........     ..      .       . .  . . . . . .             .         ... . .
.       . .  .              .  . .   .. . .. ..  .       .  ... . .   .   . .    .    . ..  .     .. .    .    .    .    ...  ...  . .     . . .  ... .
.    . .   . .  . .   . .  ..  ..      ... . .      ..   ..   . .. . .   .. .    . . . .    .   ..    .     .. .          ..    .   .   ..... .    ....
. . ..     . . .     .    .  .  .        .   .  . ...        .  .    .    .  .  .  .  .  .  .  ..    .. ..  .   . .  .. . .....        . .. .       . .
.      . ..   ...      ... .      .. . ..        ... .          .  .   .  . . .  .        .   ...   . .   .   .    ..  .. . .     ..   .     ..      ..
.        . .. .  .. .    . .  .   .    . .  .. .   ..  ..  .. . ...  .    ..    ...  .   .          .    ..     .    ..    .     . .    ..      .     .
.  ..  . .  ..  .   .          . ...    .    ..   .           .   .  ..    .  .   ... .     .     .                     ..    . ..  .     .  .        .
.    . .... .. .. ... . ..... .  .   .  .  .        ..  ..    .       . ..    .   . ... . .      .    . . .  ..  .      ..  .     ..  .   .    .   ....
. .   . .         .  .   ..   .       .  .      ..     .  ..  .  ..     .       .  .  .   .    .. ..  .        .. .     . .. .  .  .  .       . . .   .
.    . ...    .  . .         ....  ..    .    ..    .  .. .   .   . .. ..   . .  ..   . .          . .   .   ..     ..          .  . .    .     .     .
.    .  ..   .   .      .. ..     . .        .  ..   . .   .    ..   .    . . . ..    . . . . . .    .  .        .         .     ...     . .  .. .    .
.  .  .  .   ..  ..     .  ..   .  ..     . ..  ....    .  .   .   .              .            .      .      ...   ...       .   .  ..        .. . .  .
.    .      ... .   . .... .   . .   ..     ....  .      .    .. ...  .   .  . ...     .   .       .. . ..  .      . .   .     .  .  .         .  .   .
. ..       . ...         .    .  .    .        ..      .. ..   .  .      .     .... .  ..    . .  .   .   .. .      .      ...  ..     . .      ..    .
...   .     ..      . .  ..       .. .    ..  . .     .    .   .    .     .  .  .. . .   ..    ..   ..     .  . .  ..    ..  .. .  . .     .  ...     .
.   .     .  . .          .   .. .    ..  .    .      .  .    .   . . .   .    .  .... .  .. .  .  ..  . ....    .     .   .  . ..    .. . .  .     ...
.. .   .  .             ....       .   .. ........  .. . .     .          .  .. ...   . .  ..  ..   .        .  .               ..          .... .    .
.. .. .  . .  .   .       .   .  .  .  . .  .    .....        . .      .. .  .... .. .  .  .       .  .   . .. . ..   .  .     ..  . . .  . .  ..  .  .
.    ..    ..   .. ...   . . ...          ..      .. .  ..  ..   ..        ...     ... ...  . .. . .  .     . .   . . . .       .   .       .    . . ..
.. .  ..   .       .         .  .    .  .  ..   .  .   . .   ..         ..  ..     . .     ...       . . .         . ..  ...     .         .          .
... . .     .   ..      .  .   ..  .              .      .  .   .. .  .. .  .... ... ..    .    .. ..   .   ..    .. ..       . .   . ..   .   . . .. .
.      . ..    .   .    .      .                .    .  .  . .     .    .. .     .            . . ...  .                ...     .  .. .  .    . .     .
.             .  .     . .   .  .  . . .   ..        .    .  ..  .  ..          .     .     .  .  .  ..        . . .    . .     .  .. .  .  .     .  ..
.    . .  .  .  .  .   .   .  .  .   .   .... ....  .    ..    .      . . . . ... ..  .  ..  .    .   . ...     .                ...   .   .  .    .  .
.     .   .   ... .  .   ..  .          ..           ..    . .          .       .   . .   .   . .          .   ..  . ..      .  ...    ..        .. . .
.    ..    .  ..   . .  .     . .  ...                    ..   .. .    ..      . .  .      . . .   .  .         . . .   .  .  .  .    .  ..    .   .  .
....  ..    .    .     .    . . ..... . ...    .    .  .....     .  . .     ... .           ...       .   . .  .           .. . . ..       .  ...   . .
.     .    .    ..    .. ..             . ..    .      . ..       ..   .        . .       . .  ... .  . ..  .  .   ..   .     .  .  .        ..     ...
.    .. ...  . ..       . ..     .   ..      .. .  . .   ..       . .     .  . .  .. .      .     . . .   .      .      .          .    . .        ....
.  . .   .      .     .. . .     .       .  . .  . . .    . .      ....    .  ..      .   . .         .     .  .   ...  . . .. .  . ..   ...  .    .  .
..        .  .. .. ..   .      ..           . .       . ..   . ..   . .    ..  .   .                .   .... . .      .  . ...   . ..         .      ..
.   .      . . .  .  . . . ..  .   .  .. . .   .  ... .  ....    . ...  .. .  ..  .  .. .. .               .  . ..            . .. .        .. ..     .
.       ..   .  . ...   . .    .    .   .  .          .  ..      .  . .   .   ..     . .     ..           .   . .    . .. ..  . .. .      .        . ..
.  ..  ..  ... .   .  . ...           .        .  . .       ..  .    .         ... .. .   .   .  . .  .       .  .      .         .. .    ... . .  ....
...  .. ...   .    .   .   . ..     . . .     .   . .   .    .  . .  .    .     .. ..  .        ..   . .    .       . .  ....        ..  ..  . ....  ..
..   .       .       .. ...   ..   ...   ...... ..                  .   .  ..  .        .  . ..  .        .    .   ..    . ..              .   .   .  .
.   .     .. .       . .      . ..     ....    . . ..    . .  . ..  ..     .. .      .....  .     . ..  . . ..        .    .     .. ..      .  .      .
. .    .. .. ..  .    .     . .   ..    .  ..   . .    .    .. .  .      .      ...  .   .    . .   ...  .  .     . .. . .. ...   .   ...  .    ..    .
.    .. .    ...  .   .       .    .  .         ..  .   . ..        . ..    ..      ..   .....     ...  .  ..     . .   .   .. ..   . .   .       .....
.        .        .   .   .  .    .     ...         . . ..                 ..  .   .  .    . ...        .. ...   ..           . .. .    .        .  . .
.    ..    . . .  .  .      ..    ..    .   . .       ..   .  .   .   .  ....   .   ..  .  .  .    . .   .. .     .   .   .  .     .    ... .   .     .
. .    .. ..        . .  .   ..        ...   .     ..   .  .  ..   .   .         . . ... .  .     .  ..   .  .. .    .  .. . ... ..     ...          ..
..     .  .   .. .        .  .     ..   .  .  ..    .. .        ..       ..  .. .  .    .. ..  ...     .   . .. ......    . .       .   .      . .    .
.  .       . .  .   .     ..            .  .    .   . . . .         .      ....  .     ..   .        . .. .       .        ...  . .  . . . . .  ... . .
..   .     ... .    ..  .   ...   . . ...    .     . . .  .   . . .. .  .        ..   .... .            .     . ....  . .         . .      .      .   .
. .     ..   .             .         .. .. ... . .   ..        .    .       .   .   .       .    ... .  . ....     .   .     .  .          .     . .  .
.. .  .     ..  ....       .          ..      .    .  .  ...      . .  . .   ..  ....   . .  .        . .    . .     ...    . ...     .   .... .  .  ..
.  ..        ..    . ..        . .        . .. .    .     .     ...     .  .. .        .... ..   .  .. ...  ...  .        ..... .  ..       . ...     .
.   .....   ...    ..              .  .     . .   ..               ..   . .              .     .  .     ..    ...          .  . .  .     ..       .  ..
.      .  .  ..   .  .  .         .  .   .   .   .. . .       . . .  .    .            . .  .   . .   .  ..  . .      ..   ..          ...    .     ...
.  . . . ....         .. .  .  . ...   . ..   . ...  ..   .     ..  .   ..      .    .  .      . .     .  . .   .....   ...   .              .      . .
..               .        . . .    .    .     . . ....    ..      .       . ..        .  .     . ....  .     .   ...    . .     .   .. ..  .   .  .   .
.  .  .       ..  .              . .                     . .  .    .. .   .   .  .   .. .. .  .       . . . ...   . .   .   .   ... .  .  ..   .     ..
.    ..  ....      .  ..  .        .    ...    .  . . ...     ....  ..        . ....       .  . .. .. .    . ..  . .    .     ... .   .  .   . .  .....
...   . .  ...   .    ..  .    .    ..    ...          .   . .. ...    . .. .  .. .  . .  . .    .    . . .. .   .  . ... .  .    ...  .  ..   .      .
.. .   .     . .   ...     .  . . . . .   .   . .       ... ..  .     . . .    .   .  .       ... ..    .          .     . .   .    .   .  ..      .  .
..     ...  .. .  .   .. .     ... .    .   . .       . ... ... . .. . . ..   ..  .  .               .  .   .   . . . .. .  .  .. .  .  ..  .  ...... .
.      .  .      .. ..       .      ..             ...            .  ...  .. .  ..... ..         .       .  .  .               .   .      . .  .      .
.  .. .     .. .  .       . .  .    . ..     ...  .. .. . .   . . .         ..   ..  ... .. .  . .  ..          . . .  . . ..    . ..  . .  .  .     ..
.. .          ...... . .     . . .     .  .    . .     . ..    ...         .    . ..  .        . .   ..    .            ..  .  ..   .   .   . . .   ...
.      ...  ...      .      .           . ..  ..   ..  .  .. ..   .  . .  .   . .   ..     . .  .  .   . ..    .      . .       .. . .   .   ..   ... .
.    .   . . .  .  ...     . .   .           . .   .  .     .     .      ..   .  . .  ....  ..  .... .. .      .   .     .   .. .                  .. .
.  .  r      .    ..   ..  .    ..     .     ...  .    .            .  .   ..   . ..            .   ....   ..     . . ...  .    . ..  . .     .       .
.      . ..  .          . .   . . .  .   .       .  .. .   .  .   .    .       ..    .  .  .       ..    ..  . .. . .. ....       .   .  .    . . ..  .
.....       .   .          . . .   . .    .    .. .     . ... . ..         . ...     .   .         .  .         .   ..         ..  .. ..  .    .    . .
..   .         .   .   ..  .   . ......  .         ..    .  .     ...  .       .       ..       . .   .    ..      ..      . . .. ..   .          . ...
..   .  .   . ...           ..  .. ..  ..  .    .     .     . .. .    .      .. ..   ..    .  .. .         . ..  ..  .     . .   .    .      . ..    ..
.           .   .  ..  .  ..      .       .  .. .  .  .      ..       .. . .   .    .    .. ..     .  ....   ...     . .  .. ...  .        .  .  .    .
.   .            .. . ..  .     .  .     .. .    .   .  . . .      .   . .. .        .     . .    . ... .  .  .    ..  ..  ..  . .        .   ..  .  ..
.     .     ..     .    . .         .   ...   ..  .                 .    . .    . ....  .    .      . .      .           .     .  .. .  .     ...  . ..
..       .       . . .  .                .     ...   .        .     .       .              .    .  . .       .  ..    . . .      . .   ...     .      .
.    ..  . .  ..    . .     .   . ....   .      ..     ..      ..    .. .. .   . .  .  .    .. . .. . .             .       .  .     . .   ..         .
.   ..    .  .   .      ..   .     .. ..       .    .       . .. ..         ..            .  . . .     .   .....    .   ..   ..  .  .    ..  .        .
.   . . . .   .  ..  ..   .     .  .. .   .   .  .   . ...   . .         .   . ..  ..   . .   ....  ..     .   .. .  .    .  .   .   ..  ..  ..  .  . .
. ...      . .   .   .           .     .        . .          .  .... .          .  .      .       .   .   ..   ...   .. .   .    ...     .     . .  . .
..  .. ....   .  ...     .  .    ..  ..    .     .  .  . . .  .  .            . .             ..   . .    .    ..   .       .         . .      .      .
.  ...        .  .            .  .   .  .   .  .    .   .   .   . ..  .    .           ..        . .. .     ..         .    ..    .     ...  . ...   ..
.   ..  ..   ....     .      .  ..         . ...       .  . .. .    .. .         . ..      . .  .   .   .    .    .  .  ..            .  .       . .. .
. .  . .. .    .. .      .  ..           .. .     . . .    .    .. . .    .    .          .        .  ... .  .   . .     ..  ..  .     .   .   ..  .. .
. . . .  .  ..        ..    .   .   .. ..  .     .  .    ..         . .   .      ..  ..          .   . .. ..   .      .  .    ..   .          .  . .  .
.   ..   ..      .     .    ..       .   . ... .. .    .    .       ... . .  .  . .   . .   ..     .    ..  .   ..   .  .  ..   .   .       ..  .  .  .
..   .    . .   ..   .   .  .  .      .    .       . ..   .    . ...    .       ..    .        ..    . .  ..    ...       .    .  .    . .    . .     .
.  . ..  ..   .       .    . . .       .   . .      . ..      . .... .. . ..    .  .... .   . . . .      .  ..    ...   .. .    .        ..     .    ..
.   ... .  .... .  ... ..  .     . .      ... .             ..   .    . .         .   ... ..   .       .                .   .      ...   .  .     .   .
.           .  . . .    . ..  .  .       .. .          .  ..  .  . .   . ..     . . .  .  . . .     .. .           .      . .     ...   . .  .   ...  .
. .  .   .     .  .    . .  . ..    .  .  .       ..  ....                ..    .       .          .. .  .  .  .  .  ..      . .    . .      .. .  .  .
.    .    ..      .    .  .     .  ..        ....    ... ...    .. .  . ..   .  ..    . .    .  .  .    .  ..  ... .. . .    .   . .. .  .  . ..   .  .
.....   .      ..      ...       . . .    .    .   .  .  . .. .  ..    ..     .. ...     ..   . .      . .        ..   . ..      . .   .         . .  .
... .   .   .   ...   . .   . .     ...     .. .    . .     .   .     .       .  ..        .   ..   .    .  .. . .  ..              . .       .   .   .
.    .. . . .  ..  . . .  .         .   .. . .. .  . ..      . .       .    . .         .. .   .    .. .....  .  . ..  .       ..     .  . .. . . .   .
.    .    .  .         .    . . .    . .    .   .    ..       .            .           . .... .     .    .            .      .   ..  .         .  .   .
. . .   .  .  ...      . .         ..  .      .    .  .       .      . .  . ..  .  . . ..    . .      .    .       ..           .   . ..    ...  .    .
.        .    .   .     .    .    . . ..         .  .  .  . .        .         . .  . ..    .   . .... . .    ..       . ...   .     .. ..    .   .  ..
.              ..  .    .  .     .     ..   ..  .       ...  .  ..   .   .    . . . .  . .  .  ..    .    . .       .. . .   .       .    ..... .  .  .
...  ..          .. .    .           .     . .    .     .   .        .     .    .    .        .     .        .            .    ..         .  .   .   ..
.    . . .          .          ..     .         .     . . .    ..   . ...     . ...         ...   .  ..      ... .   .    .   .    .                . .
...... . ...     . ..  ...  .      .    .          . .  .          .  ..   . .  ..        ...     .      . .. .  . ..  .. ...  ....   .      ..   .. ..
...   ... . . .     .. ..     .   .  .   .   .. .   .  .. ..      .      . ....    . . .  .      . .  .... .            .   . .. .  .      . .      . .
.  . . .         ..  .  . .    ...   .. ...     .  .   . .  .  .  .      . .    .                     .    .  ..    . ...       .  ..    .       .  . .
.. .    .  .       ..       . ..   .. ..      ..  .    . .. ..    . .  .. .    . .     . .           .           ..          . . ... ...       . .. . .
. ..         ..  . .    .       .  . .... .   .   .     .  .  .    ..      . .      .   ..    .. .      .. ..   . .    .  .          .. .  .   .....  .
..  . .  .       .    .   ..   ..                   .   ..   .    .     ..  . .    .     ..     ... ...  .  .. .   .  .. ..                       .   .
.    . .     .   ....  .    .      ..   . .  .    .     .  .   .   ..   .    .  .    . .        ..   .  .  . . ..      ..  .      ..       ..      . ..
. .     .  ...    .       . .          .   ... .    . .    .  ... ...    . ..    .           ..      .....    .  .. .. ... .    .  . .      . .   . . .
...  .        . .  ..  .   .  .           .       ...  . ..     .     .     .. . ...  .      .  .    .   .  .. ..   .  ..   ..   . ..   ...      .    .
.  . .. .  ..     .   .          .   ...   .      .. .     .   .  .    . .    .   ....   . . . . .. .       .      .  .....   ..        . .     ...   .
.      .    . . .  . .  .     . .. .  .  ..   .   ..    .       .  .   ..       .  ..     ...  ..         .  .     . ..  .       .. .  . .  .  . .  ...
.   ..   . .        .   .. . .  ..       ..    .  .        .. .   .   .. ..       .    ..  . .   .   .     .      .  ..    . .  . ... .  X . ...  .   .
..  ..... ...  .  .    .  .. .  .          .. . . ...    . ..     ..    .    . ...  .. .  .     .  . . .. . .. .  .      ... . .   . .    .   ..      .
.. .   ...        .  ..  ... . .  .   . .    .   ..  .  ..    .   .    . .    .   .  .          ....     .    .  ..               . . ...  .    .   ...
.    ..         .  .. .         .. .. ...    .. .. .     . .   ...   .       .           .. .  ..  .        .    .    .  .         . . ..          .  .
.    . . . .  .. .          ..        .            ...   .  .. .           .      .  . .. .          ..    ....  . .       .  .     .    .. .   . .   .
.  ..  ...    . . .            .    ..    ...    .  .   .     . ... ... .        ..     .   .       . ...      ...  . . .   .   . . .   .    .    .. ..
.   .  .    . .  .   ...             .         .   .  .     ..   . ....   .     .      .  ..     .   .         . .     . .. ..    .. ..    .       . ..
. .  .  .   .    .. ...        .          .   .   ..    ....  . .  .  .    . . .   .. ..        .    .   ..  .        ..  . . .. .  ...  .            .
. .        .   .                   . .    ..   .             .   .... ..  .  .      .     .     ..   .  . .       .  ....  . .      .      ..  . . .. .
.      .  .   . .          .  .  .      .  ..   ... .  .    ..       ..  .   .... ...    .. .        .    . . .  ....   .  .. . .  .. .       .   .   .
.       .   .  .  .            .         ..  . .   .    ..   ..    .       .      . .     . . .     ..       . .   .       . ..     ..      . .       .
.  . .    .  .     .   .  .  .   .  ...   ..   .   .      . ...  .     .. .   . .   .    .       ...  ....    .          .  .    .     . ..         . .
. .     . . .     .  .       .   . . . .  .  ...  .  .. ..        . .  . .    .    ..    .         .   .....    ..   . .   .    ..         .. .  ..   .
.  . .        .   .  . .   . ... .     . . ..   .. ...    . .   . ... .   . .   ..    .   . ..    . ...     .   .  . . . .  .     .. .     ..     .   .
..  ... ...   . . .  ..        . .           . .   ...      . .       .  .....   .. .. . .   . ..   .   ..  ...  .   .   .     . .       ...  ..   .  .
.       . . .  .          .    ...   ..            .    ..   .  .      . . .. .  . .  .... .        .       . ..   ..  .   .....  ..   .      .   ..  .
. ..   ..  .. . ... . .. .      .. .       .      .  .. .  .. . .           .  .   . ....   .... ..  .   ..  ..  .   .       ..   .   . .    .  .  .  .
.. . .  ....  .. .    .   .  .  .. . .  .     .  . . .. ...      .      .  .  . .   ..        .      .  .  .   ..  . ...        .  .         .  ... ...
. ...  .. .   ..   . . .    .. .. ..  .      .      . .  .  . . .   .            ..  .  .     .  .        ..  .. ..   .  ...     .  ....     .        .
.     . .  .    . ..       .....      .     .. . .         . .   .  ..  . .  .  . . .    .            . .          .  .     .  .  .. .   .      .   . .
. ..  ..     ...    .     ..  .       ..     . . ..   . ..    .. .   .     ..  .  . ..   ... .     ....      .. .   .   ..           . . .  . .    . ..
..   . ..    .    . .  .      ...  .  .    ..  .      .      .   ...    .  .  . . .     .     ..  . .   . . ...           . . .   .. .  . . ...  ...  .
..   ..   . .    . .             .  .  .  .  .  . .   . . ..  .   ..         .  .  . .      .      .       .  .         .  ..  .   .. .  ..... . . .. .
..  ...    .... . ..             .   .   ..  . .....     .   .   .   ..    .  .   .    .. .              ..    . .      ..    ..    .     ..   ...    .
.    .  .  .      .  .      . . ..  .    .  . ..   .   .  .  . ..    .    . ..        .   .  . .... .   . . .  . ..   ..       . ..   .    .   . . .. .
.   . ...       .. ..    .     .  .   ..           .. . ..    ..  ..  ....  .  . . .         .   ..        .        .        . .  .  . .     . .      .
.......................................................................................................................................................
