........................................................................................................................................................
. .. .   .   .    .. .    .. ..   ... .   .   . .  ..  . .   .  . . ... .           .   .          . .. .. .  . ..  .  ...    . . . .       . .. .     .
.   . .  .    . ..      . .          ..   .     .  .. . ....  ..  ..    .. ..  .  .  ..         . ..   .        .. .. ..  .   . .    .  ... .....     ..
.   . . .   .   .     . .   .       .   ... ..                 .. ..   .  . ..  ..   ..     . .    .   .   .        ..  .             .    .  .   . .. .
. ....        ..  ...    .    .  ..      . .     . .  .   .  .  ...   .      ...   .       .    .        .  . ...   .    .  ..          .    ..        .
..            . .. .   .            .     ... .  .. .        .      .   ..   .   ..   .   .  .    .       .     .  .     .     . .   . .      .   ..   .
. . ... .  ... ....      . .. .         .    . ..     . . ...  .    .       ..    .           .    . .      .    .      . ..  .  .. .     . ..         .
. . ..              ..     ..      ..   .... ..    .  .  ..  .  .   .      .  .. .             .      .       .         . .    .  .  .          .      .
. .    . .    ...  . .     ..  ..           . .  .  .    .     ....  . ..  .  . .    ..    .. ..    ..  .     .   . .     . .    . .  .  . . .     ..  .
. .   . .  .        ...   . .        .      .    .. .    .   .. .  . .   ..  . ..   .           .  ..    ..         .. . . .  .  ..     .  .      ..  ..
.   .  ...     . .              . .  . .   . . . .        .. .. .      .    . .  . .    .     .       . . .      ...    .  .    .. .   . .. .      .  ..
.. . . ..             ..  .  ...  .. .    ..   .                 . .   . . . .    .    .       .. . . .       .  .    .  ... . . .. ..          .      .
.  ... .              .      .. ..  .   .  ..      .      . .   .        ..          .  .  . . .        .   .      .. ..  ....  .        .    ..    .  .
. ..   . ...    .      ...     ..   ... .    .  ..     .         . .     .        . .... .      .      .          .  .    .. .    .  .. .  ..    . ..  .
. . . .  . ....   .  .        . . .  .          ..    .. .. ..     .   .  .     .. .         .   .. .    ..    . ....      .  .       .  .  ... .    . .
..   ...    .   .  .   .  ..... .   .  .    .  ..  .    .   . .. ...  .  .       .     .   .  .. . .    .  ...    . . .    .. . ..      . .   . .  .   .
. . .      . .. .      .    . .   .  ....  . .  .   .  .  .   . ..   ..         .     ..  ..  ...  .     .    ..  .    ..         .     . ...  .  . .. .
.    . ..  .  . .     .  .   .  ..          .  .. . .    . .           . .       . . ..    .   .    .             ..        .     .     .   . . .. ..  .
.  .    . .       ..  .  . .  ..  .   . . . .  ..   ..   ...  .   .            ...      . .     .    . .   .  . .   .. ..    . .   ..   .     .   .    .
.  .    ..          .... ... .  .        ....   .    .  ...  ... . .            .    .    .      . .  ...  .  . . .    .          ...   .  . .   .  .  .
. ..  .   . . ..  .  . .         .         .       .  ..    ..    .. .    ...           .    .    ..  . ..      . .           . . .              .  .  .
. .  ..          .               .          .  .   ..  .       .      . .                  .  ...   . .      .. . .. . .    ..  ..    ..  .    .       .
..   ..     .  .      . .    . .   ..  .      .  .   .   .    ...   .      .   ...     .  . .     .      . ..    .     ......      .  .. ..  ..      . .
...        . ..   .      .. .      ... . ..  .   .     .      .   .  .. ... .    .  . .   .. .               .. ...  .   ...  .    . .  ..  .  .     . .
.   ..  .     .       .        . ... ..   .  .. .   .     . ..     . . . .    .   .     .   .     .  .        ....   .  .   .      .    .    .         .
. .   . .       .    .... .... .         .          ..   .    . .            . ... .    . .  .....     .   ..  ..     ... .    .        .      . .  . ..
.    .     ..     . .  ..       ..   .. .            .    .  .   .  .  .  .    .        .   .    .....          ...  .   ...   .  . .     .   ..  .    .
. .      .       ..   r    . ...  . ...     ..        .       .             .    .  ..         .             .     . . . .    . .   . .... . . .  .   ..
..  .        .  ...         ..   .           .    .          .       .           .    .          .      . .   .     . . . ..     .  .    ... .  . .... .
. ...   .   . .     .   .   . .   . . .         .  .       .  .  . . ...     . . . . . .     .   . .    . ..  .   .  .   .....  ...   ..    . .      ...
.     .  . .  . .        .   . .  .    .  .     .   .  . ......   .  .  . .       .   ..       .  .     .   ..   .     .      . .           ....    . ..
.     . . .     ....  .   .  ..  . . .   .  .    ..  . ....        ..  ..       .   .  .      ...  .         ..  .  .. . .  . . ....     . . .  . .  . .
.    ..    .     . ..  .   . .  . ..  . .     . ...     .     .  .      .  . ..   ..       .      .     ..   .                     . .. .   .   . .. . .
. . ..  .  .   .    . ..    ..   .          .     .    ..    .  .   ..    .. .          .... . .....    ...   .    . .. ...      ..    . . ...    .    .
.    . .   .         . . . .       ....  ..  .    .    . .  . ..       ..      . .                .    . .       ..   .   .. .  ....  .   .. .     .....
..           .    .   ..    ..  .   .           . ..  . . ...  . .  . . .     .  ...  ..  . .    .  .   .   .   .    ..         ...  ...  ..  . .     ..
.       .. . .    . ..   ..   ..  . ..   .    ...           .     ..   . .   .  ..     ... . .    .  .  . ..   ..  ..         ....   .   . .     ..   ..
. .  ...  . . . .      .    .  .   .  ...  ..     . .  .  ...         .  .  . ..     .   .. ...   ..    ...  .         .    .  . .       . .    . ...  .
.  .     ... . . . .     .          .   .     .   .  ..   ..    .    .  .   .    ...   .  . . .  . . .  .   .    .    .  .  .   .    .     ...     ..  .
.   .  .  ...     ... ...  ..    .  .. .               . .    .  .    .       .  ... .  . .   .. ..   ..    .  . .    . ..     ...     .  ... ...   .  .
.  . .  . .      .     .    .  .    .   ...       .    . . . .       .  .   .     .  .   . .. .   .. .    ..  .   . .. . ..     ...    ..  . .  .   .  .
.    .      .  .. .. .. .    . .    ..        .     . .        ..   .     .  . ..    .. .   .            .  .  .  .  .        .    ... ..  .       ..  .
.    . .              . .  .  .     ..   . .    .  .   . ... .     .    ....      .   .    ...    ..  ...     .   .  .       .   .. . ...    ..  ..    .
... . . ..     . ...   ..  .. .    ..      ..   . . .   .         ...      . ..     ..     .    .    ....   .    ....  .    .   .        .... . .  .   .
. .. .  .    .        ..     ..  .  .   ..      .  .        ..       ..   .      .  . .     . .    ..   .     .  .   . .  .     .  .      .     . .    .
...    .  ...      .    ..  .    . .    . ..        .   . .        .    .      .        . ..     ..          .  .  .    . .   . . .      .      .  .  ..
.  .     .   . .     .  .        .    . ..   ..  ...     .   .   . . . . . .    .          ..... ...    .  .   .  . .  .  . . .... ..  .   .         ...
.. .   .       ..    ..  .. .   ...    ... .      . . .   . . .  ..  .   . .    .        .         . ..       .     . .   ...  .  .        ...  ..     .
. . .  .    .        ..      ...    .... .      ..  .    .  .   . ... .  .    .    .. . . ... .         .  .  .    . .   . . . .. . .         .        .
..   . ...  . . .  .      .  .    .    ... . ..   .   .. .  .     . . .    .            . . .    .. ..  .           .    .  .  .   .  .    .   .  .  ...
.   ..    .    .   .  . . . .     .  .    ....  ..              .  . .         . ...  .    . .   .    ..        .      .  .     .    .          . .    .
.    .         ....       .   ..    ..  ..       .       . .   .   .   .           .     ..   .  .       ..        . .  ... .          .         .     .
. . .        . .         .           .    .   .  . ....  .. .  .     ..    .   ..  .   .  .    .      .   . .     .. .      .  .. .   .  .  .       .. .
..   .. .      . .    . ...  .     .      .... . .   .      . ...       .    ...   .  ...  ..     .  .  .    ..   ..    .   .. . .   .   .. . .  ..    .
. . . ...       .  .. . .     . .      .                  .. .     . .     .       .           ..  .    . .   .. .. ... .     .        .    ..     .   .
. .  ..      .. .      .     . .  ...    .        .        .               ..     . .         . .          . .  .  .     .  .    .   .   . .. .  .  ....
..   . .  ...   .       . .    .   ..   .  . ..       . .  .     .       .  . ..    .             .  .   .   .  ..  . ....     .   .     .    .  . .   .
. .     .      . ..... .  .. .  .          ..   .      .  .    .      .       .  .     .  . . .  .              ..  .  .  .   . .      .  . ..    .   ..
.  .  .      ...   .   ...    .. . .   .     .  .. . . .  . ..      ...    ..   ..                 ..         ..       ..    ..     .  .    . .  ..  . .
...   ...       .  .      . .  ..  . ..     . .  ..       .     .  . . .  . .....    .   . .   .  .        ..    . ..  . . .  .     . .  .. .  ...     .
.    .  .  ..       .     .    . ... ..  . . ..   . . . . ...   ... ..  .   . . ..   . ..     .....   .    .  .   ..      . . . .  .  .. .. .     .  . .
... .   . ..  .       ..    . ..  . .   .      .        ..  .  .  .  .    .. ..         ..  ..     ...   .        .   .  . .       .  ......   .  ..   .
.     . . .  .  .  .   ..       .  .  . .       .  .    .   .....     ..    .          .. ...  .   ..    .   ..  . ..   .     . .. . .      .  .  .   ..
. . .       . .  . .  ..        .   .      .....      ..     .  ...   . .               . ....  .     .  .. . .  .        . ..       .. ...   . . .    .
.      .  ..    .  .    .  .  ..   . .      . .     . . ..           . .   .   ..    .     .   ... .   ..     . ... .   .     .  . .   . ..    . .     .
..      . .    .     .  . .  ..  ..  .. . .  . .            ..... .      ..     . . . ..  ...  . ...     . .  ..          ..      .  .  .. .           .
.   .        ....   ...    .   .   .  .   ..     . ..    . .       .  .    .   .      .    .          .       .  .     . ..   . .         . .     .  ...
.  .. .   .   .    .  . . .  . . .. ..     . .      ...   .  ..    ...       ..   ..    ..     .      ... ..    .  ...   . .      . . .  .    .  .     .
..  ....       .      .. ..   .  ..   . .  . ... .          ...        .    . . .  .   .  .. .   . ..   ...  . .    . .. .  . . ..  . . . .  . .   .  ..
.    . .  .      .   . .   ... ...   . .    ...           ..   .    .. ..  ....  .      .    .  .. .. .  ...    ...   .     .       .     .    .   . . .
.. ..        ..  .  .. .   ..  .     . .   .  . .. ...      .    .   .  .               .  . .  ... .... .   .  ..  .  .            . . .   ..    ...  .
..      . .      . . ...   .   .  . ..          .        .  ..  ...  ..    .. .            .  .. .     .  .  . .. .    . . . ..    .       ..     ..  ..
..     .... ..        .          ..   .     .   .    . ...  ..    . .. ..   .. .        ..       ..   . . .          ..  .      .    .      .  .     . .
.      . . .    . ..       .... . ..  .      .      .   ..     .. ..   .  .       .  .     . ... .. .   . ... . .    .  ..    . ..     ..   .  . .  . ..
. .  ..        .    .     .       .. .  ..   . ..       .    .   .  . .. .     .   ..     .  .  . . .        ..    .   .   .    .   .   .. .   .  ......
.  .      . . .  .     .  ..  . . .   ..            .          ...  . . .  .  ..         .   .    . ..         ..     .    .  . .     ..     ..  . .   .
....  ......  .. .   ..   . .     .  .    ..   .           .             ..  .   .  . .  .    .. .    .. .   . ..     .      ..   .   .. .  . ..     . .
.    .     .   . ...         .  ..        .    ..   . .  .   . .      . ..   .....  .     ..   ..... .. .  .   .  . .    .  .     . .    ...    .  ... .
.      ..   .  .       . .       .   .        .    . .       .    .  . .        .. .     .. . .     .      .. .      . ..      .  .  . . .      . . .  .
.  .  ..        .  .    .     . .  ...   .. .. ...       .   . .. . .    .. .  . . .. .   . .        .    .    .   . .... .  .      .   .   ...  .  . ..
.   .    .                ..    .    . ..   . . ... . ..    . .    ..   ..       .. . .  .  ..   ..        ...      .         ..      ..              ..
. ..   .        .        ..               .   .  ..   .  .      .   . .. . .  .   .      .   . ..... .   .      . ... .. . . .   .  .   .   .      . . .
....    . . .   ..     ..    .        ..  .. ..  .  . .  .   .       .       . ..  . .          ...           .        .      .  ... . .  ..     .    ..
. .  .   .   .    .  .  ....      .      .     . .   .      . .      ...   .  . .   .       . .      .      ..     . ...... ..  .  .  .   .  .  . .  . .
.     .  .        . .  .       .  .  ..  . ...    . .   .. . .      .   .. . . . .... .     .    . . .  .       . .. ..  .  ..       ..  ...   .      ..
... .   .. .. .  .    . .        .  .. .. .   ..   .        .     ...        . .. .     .  ...     .. ...   .       ...                ...   ..  .  . ..
..  .    ..     ..  . .   .     ... .. . .       .  .       .  ..   .      ..   . .     .   . .    .   ...   .  ..     .   .   .   .  . .  . .  . . .. .
.. . .      .   .     .   . .    .    . .     .   .  ...          .  .      . . .  ..  ...     .. ...   .    ..   . .     . .  ..    .  .    ...  .   ..
.   .  . .          . .   .     .            .. .  .     . .     ... .   ...   .                 . ..  .  . ..   .   ..  ..  .  ..    ...       .  . . .
.     .. ..  .  .  .      .     . .         ..    ... .   . ...     .           . ..        .   .  .   .      .    .  ...   ...     . . ..     ...    ..
...          . .  .  .   .. .      .  .  .  .   .    . ....         ..   .     ....  .  ..          . .     .    . .      ..  ... .   . .    ..  . .   .
.       .    ..   ... ..    .     ..   . ...    .        .  .  .  . .. ..  .       .   .    .   .        . .   .  ....   . ..      .   .           .   .
. .    .    . .  .    ..  ..    ..  .  .    .. ..  .  .   . . .   .            . ..  .             ..   .     .      .     .  . .  . ..       . . . . ..
.        . . .           . ..     ...        .          .     .   .    .          .  .. ...   ..      .         .     . .  ..  . ..         ..      .. .
.   .        .   .     .. . .    . .  . ..      .  ..  .  . .. .. .         .. .  .       . .          .     ...      ..      ...    ...  . .   .     ..
. .           .    .     .     .   . . . .    . .    . ..  .        .      . ..  .   .         ...     ..    .. .  .    . ..         .     .  .. .   . .
. ..      ..      . .    . . .....    .    .  .. ..     .  .    .  .. .  ..       .   ..    .  ..     .... .  . .    .   ..    ...     ... ..    .   . .
.    . ..       ..  . .  ...  .        .    . .  ... .  .      .    ...     .  ..    . .    .  .. .    .    .. ..         . .    . . .      .   . . . ..
.   .. . .  .     .          .  .   .. .  . .  ...    ...    ..       .  .  .     ..     .     . .. .    .  . .  .. .    .       .  .  .  .   .        .
.  . ... .  .      .  ...   ..      .   . .   .. .  .  .      . ..   . .    ..      .  . .   .  ..        ..     .   . .        . .     .  .    .   ....
.   ... .   ..   .            . .    .  ..  ... .. .  .  . ..   .    ..     ..     . .....   ..    . .  . . . . .      .   .. . .  . ..  .   ... . . . .
.     ..   .   . .   .   . .  .  .       .   .  .. ...        .     .    .. ..    .     .   .  .   ....         ..    .        .         ..    ..      .
.  .   . .  .   ... .  .      .   .     .  . .  . .   . .. . . .  .    . ...   .          ..   . .   ..    .       .  . .   ..   .       ... ..    .  ..
.. . . .   .             .   . . . . . . ..    .   .. .   .  ..   .  .  .  .   ...   .    .  . ....  . ..       . ....    .    .         . .   .   .   .
.     .  .   .    . ...  .  .              .  .  ..  ..       . .   . . . .   .    ..  ..          ..   .    .   .   . .  .    . .  ..  .. ..   . .  . .
.  . .     .      ..    .  ..       .     .  .    .        .    .   . .  ..   .  .      .   .   ..    . .  ..  .. . ..  .    ..      .. ... .   ..  .. .
.    .. ...         . . .. ... .  ....     .   ...      . ..         ..     . .... ..   ..  ..  ..    .    .  . . ..  . .            ...         .    ..
..  .             .   .  .   .   ..     ...   .  .    ..   ..   ...  .  ..  .   .  .     .        ..   .    .    .       ..    .   ..  .   . .    .  . .
.. .. .    .. .   ..   .      .  .    .         ...   ...    .  .  ..  .. ..      ...    ..   . .. .   .  .. .. .    ..        .   .      .   . . ...  .
.  .   .... .     .  .  .     ...... .. .  ..    .  .  ..   ..   .  . .     ..       .  ..      ..     .....   .        .. .  .    ....  .           . .
.  . . . . .    .   .. . . .         .   . ....  . .   .  .   .    ..  .            ..  .. ..  ...  . .. .         .  ..          ..      . .   .  .. ..
..  . . .     .    .  . .  .   .     .     .   ...      .           . .    . .    . .   .   .  .  .. . .    .  .  . .. .    .       .       ..     .  ..
.    .    .    ..          .  .  .    ..    .     . .. .  .  .   . .  .    .. .   . ..  .     . . .  .    . . .  .      .. ..        . .       . .     .
. .                   ..   .   .....  . .   ..   .    .   .       . . .   ...    .      . ..  X   ..  .    . . .     .  . .   .     . .  .   . .  .    .
. .   .    . .     .   .     .    . .  .      .   . .  . ..   . .         .  ..  .  .    . .. . . .  ..    . ...  .  . .         .. .      .  .    .. ..
. .. .    .    .             .. . .    ...   .   ..       ...  .  ..  .  ..   .    . . .          .  .      . . ..  .  .  ...        ..   .... .   ... .
.. .  .    .     .   .      .   .  .      .    . ..  .....  .      .       .       .   .          .                  .       . . ...   .  . . ...    . .
.             .       .  . . .  ..  .  ....     .    .       .  ..      ..    .  .   . . .  ...  ...     ...  . . ..  .  ..    ..      .    .          .
...   .  . ..  . .   .  .   .    .    .    .  . .    ...        . ..      . . . .   .    .     .. .  .    .    .  ..   .        . ...   . ...   . .    .
. .         ..   .      . . .  .  . ..   .. .  .          .       .  ..     .. ..   .     .. .     .       ... .             ....  ... ..    . . .  . ..
.. .       . .     . .     .   . ..             .    . .  .   .   ....   .. .  ..     ..     .  ....      .. .   .   .. .    .           .             .
.     .          . .       . ..   . .   ..   . .    .    .  .   .. .      . .   .  . . . .  ..  ..   .  ..         .. .   .  . .. .. .  ..          .  .
. . ... .        .  .         . ...      .  .       .    . .     . .   ..      .  .    .  . . . .    ..     .. . ..... .     .      ..     ..  ...   . .
...     ..   . .  .          .       .  ..   ....  ... .. .   .  .  .  .. .  .. . ..          .     .         . .     . ...     ..    .. ..            .
.     .  .   .   .     ...         .          .  ...   . .     .   .      .  ..             .    ..  .....         ..      .  ..        .  .       .   .
.... ..  . .  . .  ...  ..  .           . . .         . . . ..      .      ...    .  .   ..  .      .  . ..     ..          .   ..    ..   .   .  .   ..
.    ....  .    . . .. .         .   ..    . ..   . ... .     . . .   .    .. . . . .     ...     ...               . .... .  .    ..   .  .   .. .   ..
.    .        .  ..  .      ..     .   .. .  . .         ..     ..   .  .  . . .  . .    ..  . . . .. .   . .       ... .   .          ..              .
.    .  .   .             .      ... .     .. . . .. .  . .. ...            .   .           .    .        . .     .         ..       .       ... .. .. .
. .   . .  .        ...   .... . .      ..  .          ..   . .           .    .     .    .   . . ..            .   .   .      ...  . .    ...   . .   .
. .   .     ... ..             .  .     . ....     ..  .   .   .  .  . .   .   .        . ..  .  .  ........      . . .       .  ..  . . .   ...       .
.       ..  .   ....  .     .  ..... .    .  . ..  .  . .   ..  .  . ..     .   .   ..   .  .   . .    .   .  .  ..      ..            .  .   .  .  .  .
.  . .   . .    .  .     .     .      .  .  .. .         . .. ...        .   .    .. .    .   .   . .  .    .               ...       ...  . .    ... ..
.       .   ...   .          ..       .    ...  ..         .   .    .     . ..      . .         .  ..  .    . .  .  .   .      .  .. . . .     ..   .. .
.  .. .   .  .   ..    .   . ......  .. .     .        .   .   ..     .       ..       .. .    . .   . .  ....                     .  ..   .  ...  .  ..
. .       . ..  . .  .      .    .   . .. ..      . .         . .     ....  ..... .  . .        .    .  . . .  .  .  ..  .      .    .      .         ..
..    .     .  ..   .         .  .   . .          .       . ...    . . . . .  ..   . .  ..    .. . .  .. ...      . .   ..     .       ...  ..         .
.. .        ..... . .    . ....    .       .    .  .       .   .   .     .     ..     ..  .. .   . . .    .. .. .  .. .  .. .     ..    .  .. .  .    ..
.  .       .      .  .  ..     ... .. .   . . ...     . . . . .. ..   .       . .  .  . .   ..   .    .    ..     .    .  .          .        ..  ... ..
.. .  .   .      .   .          .  .  .        .. ...      .      ...  .      .. .   . .... .                ..   .          .    .  .... ..    .   .  .
. .  ..       .    .. . .   ....  . .    .. .. ..   .   .. .   .  ..            . .       . .  . .      .       . .  .   . .   .   .      . ..   .    ..
.. . .    . .      .  .   ..   .     .... .  .        .            .      .    .       ..  .   ..     . .  . ...  .   .  .    . .  .  .    ...   . ..  .
. .  . .          .     . .               .  .    ..   .. .      .  .  .           ...    .   ..  . ..   .   .            . .   .    . .. . ..   . . ...
.  .. . .  .   . .     .    .. .   ...  .      .  .    ..         ..           . .. . .       . ....    ....  . .      .    .    .      .        ....  .
. .   . .      .   .  .        ..   .     .    .. .      .   .     .  .    . . .  .      .   .  ..   ... .  .     . ...    ..  .  . .  .  .  .  .. .. ..
...      .    . .   .  . .      .     .   . . .           .     .      ..... .        .  .     ..        .  .  .       .     .    .       ..     .     .
..  .   .     . . .  . . ..  . .. .   .     ..   ..  . .       .        .  .  .  .     ..  .. ..  .     . .   ..    .   .  ..      ...  ..   .. ..     .
.   . . .... .   .   .   . .  .   .     ..      .. ..     . . .  . .  ....     ..  .  . . ..    .   .     .         . .   . .   .        ....  ...     .
.         .  .  .. ....    .. .   .       ..        .. .  . .   ...           .... . .  . ...     .           .  ..  ..   .   .         ... .  .   .   .
...     .  . .    .     ..   . ..        .  .    ..        ..     .... .      ..      ..    .. .    . . ....  .  . .  .   .    .     .  .   .    .    ..
..       .      ...      .  ..    .      . . .  .   .      ..  ..  . ..   .   . . ..    .  .   ..     ..   .   .   .  .  ... .              .  ...  .  .
........................................................................................................................................................
