.........................................................................................................................................................
.         ...  .. .  .       ..  . ..    .    .  .  .     . ...      .       . .  . .  . ... ..  ..  ...  . .  .     . .... .. .       .. .. .    ... ...
.  .       . . .     .  .         .         ..      .       ..   ..   . .         ..   . .... . .      ...           .  . .  .      ...   ..      .. .  .
. . ..  . . .     ...           .        ..  . .     .        . .  . . ..     .. .      .. ....   .  .      . . .   .  . . . .    . .  .       .. .. .  .
.   .. .     ..      ...    . .     .  .   . .. ...                      . ... .  .  .   .  .    .   .    ......  ....    .    .       ..     ..  .  ....
.. .   ..  .    ..        ..   .        .  . .  . .  .    .... .. .. .      .    .     .          ..       .   ...     . .... .     .    .. .         . .
.  .   . .     . .         .   .. .. .    .. . . . .  .. ..  . .        .. .   .        .. ..      .  .. . ..     .     .  .     .   .. .     .. .  . . .
.. . .   ......   .  .   .     . .   . .    .       .   ...     .  . .     . .  .      .  .. .  . .  . ..  ... .   .. .  ..   ..   .    . ....  .       .
.             .     .   .. ... .    .            .  .    .  . .  ..    .  .  .  .     . .. .  .  .     ..     . .        .   ..     .   ...  .. .      ..
.  . ..     .. . .  .. .. .    . .       .                . . ... .     . .     .. .  . ..   .    . ..  .  ..   . . . .. .    . ..  . . ..    .         .
..       ..    ..      .   . . . .  .       .....                    ..  .  .   ..     . .   .       . .. . .         .   .. .  . .        ... .    .   .
.   .  .  .  .          .  .... . .. .  ..  ...   .  ..   .. . . .. ..          . ..        . .  ...      ... .    ..    . .     .   ..       ... ...   .
. .            .    .        .... .. .    . ..             ..  .   .  . ....    ...   .    .  ... .  .    ..  .   .  .    .           .    ..  ... .    .
.   . . .       .... ......     .          .  ..       .    .   .. .              .    . .   .  ...  .    .  .   ...      .          .    .   ... ...   .
.   . . .  .   ..         .. ..     .     .   .        . ...    .  .  .   .   . .    . .       ...  ..   .  .    .  . .   .  .    .   ..               ..
.   ....  .  .     .      .  ..     ...  .   .            . .  .    .  .     . ..   ..  .. .     .    ..    .   ..   .    ..   .          .     .   .  ..
.     .   .  .    .  ..    ..   .       ..      .. .    ..     ...   .     .               .   .  .  ...             .   .   .      ..    .    .  ..  ...
..... .    .     .. . ...     .   .       .... ..    .    .     . .          ..  ..        ..   . ..  ..     .  .     .    .     .         .      .  . ..
. .   .  .   . .    .   .   .      .        .....      ..  .    . . . .. ..  .  .  .   .  .    ..     ..  .  .. .      .    ... .  .    .     .   .. ....
. . .     .  .  .  .     .   ...     . . .. .  . ..    .. .  .      . .    . . .     ...  .    .. ...  .       ...        .       .  ..  ..   .....   . .
.     .       .. .     .   . .  ...        ..    .. .      .       ..  ...    .        ...   .     ..   . .. .        .. .    ..    ...    .  .. . . .  .
..       ..   ...           ..   .  ..  .   .. .    .      .       .       ..  .      ..        .       . .. . . .      .       .   .   .  .    .  . .  .
. ..   . .. .  . .        .   .    ... . . .     ..    ...    .  . . . .    .          .. .   . .. ..     .        .. .        .  .   ...   .  .    .   .
. .  ....         .  .  ..       .  .  . . .   . .   .  .   .   ..    .       ... ... ..     .  .  . .. ..    .     .      . .   ..     . . .     . . . .
..      .  .... ..       ... .. ..    ..   . .   ..    ..    .   ..  ..      .. ...     .   . .  .. .  .     .       .   .  .   .        . ....  .  .  ..
.       .   .     .      .     ..   .  .   .   .     .    ..    . .   ..       .     .. .  ..  . .  . . .     . .  . .. .      .  .  ..               . .
..  .     ..  .. . .   ..      .  .            ...   .      ...  ... .   .   ..         .   . .     .  .   . .         .        .  .    .. .       ..   .
. .    ..  ....          .          .   ..    .  .  .               .    .    ..       ..   . .. .   ...  . ..    ... . .. . .      ....  . . .      . ..
.      .         .   .  .   .    . .    .    .    .    .  .    .    .  . .. .  ..    . .         . .           . . .  ..   . ..   .     .   .... ..  .. .
..    .. .    .  .  ..          . . . . ..    .      .        .    .. . .  . ..  . .  .             ... ..     .      ..  ... ..    .  ..   .   .. . .. .
. .     .  .     .  .     ...        .  .. .           . ..               ..   . .      .  . . .         ..   .      .   . .  .. ..   .   .    .    .   .
...  ..    ..       .  ..      .  .          .  .   .. .  ..  ..          .   .    ..     .      .          .    .    .    .  .... .  .  .    .   .. .  .
.   . .  .  . .         . .  .   . . ..   .. ...  .      . .     .   .. . . . .  .  . .    . .     ..            .               .            ...  ..   .
. .   ... .  .            .    .   ..      .    ...      .      .       ..          .     .. .        .  .    .. ..          .. . ..  .   . ..   .      .
.. .. .      .. ...      .         .     . .  .    .        .   .        .   . .  ..  ..   .   . .   .       .  .    . .    ......   . ..  .      .    ..
..     .  .   .   .   .  . . .. .    ..        .      .. .   .  .     . .    ..  . .  .     .  .    .  . ......    .   .......  . . .. ....  .     .   ..
....   ..     .    .  .  ..       .  ...      ..     . .  .  ..   . ..      ..      ... .   .    .. .  .   .        .   .. .  . . .     ..        .     .
. .        ..  ..   .. .   .  .  ..  .   .     .   .      ... .  . . .      .       .   .  .   . .   .     . .   .  . .. ..  .  .     .   .  ..   .  .  .
.      .       . .    .  ...    .    .  .   ..  ...  . ..   ..    ..          . ...     .     ..   ....       .      . .   .  . .         .   .   .  . ..
.    ...    ...  ..  .      ...   .     .. .          ..   .       .       . . .    .       .. .. .         .  . . .   .     ..        .. ..    . . .   .
.         .     .  .  .    .      .  . .  ... .      .  ..     .  ..   .  .... .  .         ....  ..  . .  . . . .. . ..       ...   . ....  .    ..   ..
..     . .      .      .   .  .   .   .        .       .  . ..   . .  ....           . .    . ..    .    .   r   .  ..  .    . . . .....          ..    .
. .             ...  .  ..  . .  . .      ....                     .          .             ....      .  ..  . ...        ..  . .     .  . .  .  .. .   .
..         ..   .    ..     .      .   ..      . .   .     . ..  .     .  . ..        . . . .     .      .. .         .     . .    .  .  . . .  .       .
...   .  ...      .  .    . .... . . ... . .   ..    .    .     .      .       .  . .  . . .  .. .   .     . .  .  .... .    .. .    ..   ...  .. .    ..
.        . .  . .   .   .    .  .  .   .       .   . . ..  .  . .      .   .     .        ..     .    ..  .  . . ..               .   ... .       .     .
..   .  .   .    ...        .. .          ..      .          .    . . ..  .  ..       ...     ....   . .  ..  . . . .   .      .  ...      .           ..
.     ..  .       ....  . ....         ... . .. ..  .   .       ... .  ..  . .   ... .  ..    .   ... ..   .   .    . .   ..    ..  ..   .. ..   ..     .
.  .   .     .    .   . .    ..  . .  .. .      . ... .     . . . .  .           ..    .   .  ..     . .   . . .   ..      . . .        ..  . ..     .. .
. .   ..      .         . .       ..          ..  .    ...  ...   ..    .    .   .   .  . . ..   .  ..        .          . .   . .. . ..   .          . .
. . .. .      .   ..     .  . . .  .  ... . .  ..     .   .   .      . .      .       ... .  .   ..... .  .   .  .   ...            .   .. ..    .  .. ..
.  .        .  .    ..    .  ..                   .           ...  .. . .  . ..   .          . ..    .   ...   ..   .    ... .   ..        .    ...  .. .
.   . .     .    . .. .. ..   .    . .     .. . . ..        .  .   ..      . .      .    ... .    .    ..  .   ..   .    .                   .    .     .
..  .         . .     .   .   . .   ...     . ....      .  . ..    . . .. ..  .  .  . .   . . .       . .  .   . .  .. .               . .  .          ..
. .  ..  .   .   .   ... .. .    ....   ..      .  .  . . .  .  .  .    ... .     .   .           .   .   . .         .            .  .          . .  . .
.  . ..    .. .    ..   ..     .        . .   ..  .  .      .                             . .  . .   . . . .           . . .        .   .  . ..      .  .
.   ... ..       .    . . .  .  .          .      .  .  .    . .   . .  ...  . .. .  ...   ..    . .        .       ....   ..      .       ...    .     .
. .    .      ..   .              . . .    .. ...        .  . . .      .   ..   .. . .   .  .  .     . .  ..           .     .   .      .     .  .     ..
. . ...  .   .. .   . .  .  .     .     .  .   .   .........  . .   .. .  .   . ..   ...         ..    .. .. .  .. .      .    .      .    .            .
.    . .     . .  .    ..    .....   ..     .  .   .     .     .   .    .        . .    .    .  ...     . .   ..       ...     .. .. .   .  .  . . .    .
. .  ...      . ..      . ..   .    .   .       ...  .       . .      ... .... .   .. .     . .      .   .  .    .  .     . .      .    ...    . .   .  .
..  . .  . .  .    . .     . ...  ..  .  .    .. .    .      . .           .     ... .           . .    ..        . ..     .    . ..           .    ... .
...      .   . ..   . . ...  . ..        .. .          .....   ..  . .   ..   . ..     .    .. .   .  .               ..  ..     . .           ... . .  .
.. .  .  ..      .     .   ..       ..   ..  .  .    .   .     .       .           .      .  ..       .       .       .     .         ..  . .  . .  . . .
.           ....      .  .   .     .. .      . .        . . . . . . ..  .    .             .   ..     .  .  .   .  .     ..   .  .  .  ..      . .  .   .
.  .       .  .     ..  .   .    . .    .   .  ..     . .. . .     .    . .          .. .      .  .  ...      .  .     .. ..    ..   ..  ...  .    .  . .
.      .    ..  ..    .   ..      ..  ...   .  . .  . .      .         .  ....      . .        .             .         .  .   .  . .       .   .   .  ...
.   .    .     .  .   .    . . ...    .        ..  .    .    .       . . .             .  .    .   . .      ..          .  .      .     . .   .         .
.  .    .          .  . .    .        . .      .  . .      .  .. .... .  . .  .   .....     . . .  .  ... ..     .          .  .    ....    ..   .      .
.              . . .   .  .  ...   ..   ...  .    .  .  .       ..          .  ..  ....       .  ..   . . . . . ... .    .   .   .    .  .     ...   . ..
...  . ..   .   ..       .... . .    . .. ....   .    .     .   .    ..   ..  . .   .  .   .      .    .       ..  ..     .   .  .        . .     .   . .
.. . ...          .. .    ..  .             .. .  . . . .   ...   .      . .  .   ..     .   ..    .                .. .    . .  .. ..  .   .. ...      .
.     .   ..  .  ..    .          .  ..     .     .. ..       .    ..     .        .  ..    ..  .. .    .   ..  ..     . .       ..  .   .. . .  ..    ..
. .       ... . . .  . .. ....        .     .   .  . ..   . .    . .   .             .  .   . .    .  .. ... . .....   .     .  ....      .  . .  .   . .
.  . ..   . .    ..    . ...   .   .     ... .        ..      .    . . ..   ... . . .     . . .    .. ..    . ... .           .. .  ..  . .    . . .    .
...     ..  .  . .    .        .   .      . ..             .   .....       .           .       .. . . .   ...    .  .   .      .  .    .    ....    . ...
.      ..  ..  .  ...  .  .     . ..  . . . .  . .   .. . . .   ...            .  .  .. .    .    . .. ...  .      .        .   .     .  ...    . ..    .
.. .    . ..  .       ...  . .. . . .      .   .   .  . ..      ..  ....   . .    .     .    .   .  ...  . ..  . .. .. .   .  .. . .        ..        . .
. .  .   .  .    ....   .     . .  .       ..   .     ..   ... .   . ..  .  .            .  .          .    .  .    .          .      .  ..        ..   .
.  .    .. ...... .      . .     ...  ... . .         .     . .       ...   . .  .   .       . .. ..           . . .   ..    .      ..  .       .  .   ..
. .. ..  .   .   . .     .      .. ...      .      .   . .  . ..   .. ....    ..  .        . .. ..        .  .  .  .. ...     ..     ..   .       ..  . .
.      ..    .         .    .               .       .    .     .     .   .      .  . ....   . .. .    .       ..    . ..   .     ...   .. .. ... .    . .
.   ... .  . .    .      ..    ....  .    ..    ..     ..          ..  .   . . ..  ..      .  .    .    . .  .....   .  ..  .  . . .   ... .  ..    .   .
.. ..  .  .   ...       .  ..  .   . ... ... . .    . . .              .     .  .  . ..  ...   . .   ..  ..  ..  .   ...   ..     . .    .   .  .   .  ..
.  . . .    .  .    .  ..  .  .. . .    . ..   . .   ..  .  .              . .  .  .    ..   .                 . .. .     ..      . .   .       . .  .  .
.    .. .      .    ..  .  .    .    ..  .    ..  .   .     . .         ..    .  . ..    .. ...       ..      .  .  .       . .....        .         .  .
.  .. ..   ..   .   ..     . ... .    ...   .     ..   .     .      .   ....     . . .  .   .          .         . .    .   ...     .    . .    .  .. ...
....   ..    . .. . .   .  ......  . .. . . .   .    ..       . . ..  .  . .   ..   .      .  ...     ...     . . .  . .      ..  ..    . . ...  . .  ...
.    .  .  .  ..    . .    .    .  ..     . ..  ... .     .  .      ..  .  ..     ...      .    ..    .        .   ..  .  .       ...    ..      .     ..
. .  .     .   . .   . ..  .  .    ....       .   .      ...   . .     .  .  . ....   .       . ..       . .... .     . . . .       . . .       . . .   .
.   .. .   ..         .            ..    .  .  ...  . . .  .   . ..    .. .. .    .. .  . ..       .      .    .   ..  .     .  .. . ..   .. . ..   . . .
.  ...      .. .        .       .  .   .   .  .    ..          .  .   .. .   .       .    .. .   ....           .      .   .  .  .    . . .  .  .   . . .
... .  .  . .    . . ..  .       .....  ..   ..   ..  .. . ... . . ..         .. .     .     . . .      ..  .       . .    . ..       . .     .   .   . .
.           .    ..      .  .   . .     . ..       ...   .    .. .       .  .   ..   .   .  .          . .   .   .  .. ..     .     . .   .   . .. .    .
. . .. .        ..      . .   . ....   .. ..   .   ...   . . . .         . .. . ... .  . .    ..    .            ...  .    .   . . . . .  .    .    .  ..
. . . . ..  .. .          .     ...         .  .     .     . ..   .    . .   .   .  .     . ... ... . .   .    . .    ..    ..    .  .... .. ..  ...  . .
.. ..        .  ..   . . . .   ..  .  ..   .  .     .    . .. .       ..   .   .  . .       .. ... ..   ...   .    .  .    .    . ..    .. ..      .    .
.  .   ...  ..     .        .   . . .   .   ..     ..... . .     .     .     .   .       ...         .        ..  . . .   .  ....            .      .  ..
.  .      .     . ..     ...   .    .... .  .    . .      .    .. . ...   ..    ..  .   ...                                . .     ...    ..  . .       .
. .    . .  ..  . ..       . .  . .   .    .  ..    .          .    .. .    . .. .    .  . .   .  ..  .. .. .   .  .                    . .            ..
..  .   .     .     .   . ...     . ..  .  ..    .  .   .. .    ..     ..      .   .. .     .   .            ....     .  ..              .. .         . .
... .     . .  . . .     ..   .    .   . ...     .   .. .. .    .   .  . .    . .     ... .       ... .    ...            .. .  .    ..  . .  .        ..
..   .     ..   .. . .       .    ...     . ..   ..    . .  .   .   .   ...  .    ..    .        .  . ...  . ....         .      ..     .  ..   .     . .
..   .      ...   ..       . .     .          . ..        ..  . . ..   ..    ...  .    .. .   .      .... .          . .  .  .... . . .      . . ...    .
.   .   ..   .  .            .       .          .     . .  .    .   .   ...    .    . .   .       ..    .. .   ... . .       .    . .. .   .   ..   . . .
.   ....  ..  .     . ..        ..   .    .    .... ..   ..   .  .   ..      . .  . ..   . .     .. .    .   ..     .    .        .   . . ..   .      . .
. ..      .. .. .   . .    ..  .    . .  . .  .     .   .    .      .. .  .   . .      ..      .    ..   .     .     ..    .   . . .   ...   .    .   . .
... . ..  .      . .. . .   .   ... .. .   .    ..  .  ....    ..          ..  .       ..   ...  ....   . ..  ..  . . ..   ..      .     ..  .    .     .
.   ..  ...             . ..   ... .    ...      ..  .. .      .    .  . ......  .. .       . . ..   .   ....      .   . . .  ..         ..        .  ...
..   . .   . .    .   ..  ...     ..   .    .  .  .  .       ..  .. .       ..     . . .      .  .         . . ..   .   .  .   ..    . . .     . ..  .  .
.    .   ... . .    .. ... ... . . .      ..  .       .. .       .. ..   ..    ...           ...      .     .  . . ..     ..    .. .    .       .     . .
. ..  . ... .. . .   .      .      .     ..     .. ..      .           .      .    .     .  .     .... .  . ..   .  ... . .. .  ..           .     .  . .
..   ...     ..    .   .  ....   .           .  .  .    . .  .   .    .      .    .  .   .        .   ...  ..    ..  . .    .  ..    ..               . .
.   .       .. . .    .   . .   .  . .     . ..  .   . .. .  .   .   .  . .     .   . .. .    .  ..    .   .  ..  .  ..    ..  .  .  .   ... .  .  .    .
.  .    .  ... .. . .. .    .       . . .. ..    .   . ... .     . ..  . ..   ..    .. .       ..       .        .   .     ..   ..  . ...   . .  . .    .
..   .. ...    . .        .        .   .   .           .   ..    .         .  .    .       .... ...    ..  .        ....    .   .   . .    .    ..      .
.     .. ..  . .  . .      . .  .     .   ..        .   .. ..    ... .....  . ...          .  ..  .      .. .. ..   .   ...    . .   . .         .  .   .
.               .... .  .   . ..  .           .   .  . .  .  .  ..        .        .      ...  ...   .   ..    .   ..     .    . .              .    .. .
..   .... ...  . . .  .    . . ..... .. .   .          . ..  .  .    ..       ..         .    .  .     .  .  . . ..       .  .        .       ..      . .
. ...   .  ..    . . . .        ..    .     ..  .  .    . ..   ..    . ...  .    .         ...   .           .      .  .         .  .       .     .   ...
.    .     .          .. ..  . .   .  .      .    .    ..       ....      . ... ..  .   .   .       ....    . .       . .   .    .     .  ..  . .   .   .
. .. . . ...  .  . .  . .  . . ..   .     . ...    . .       .     ..       . .     .    .  ..  .         .  .  .  . .   . . .           .    . .. .. . .
. .... .. .   .    . .  ..      .    . .      .  ...   . .             ...  .. . .  .              .       .      ..   .  . . . . .. .  .     .  .      .
...   .   . .     ...     .            ..     . .        ..  ..       ..      .  .    ..      ..     . ...  .   .  .   .        ..       .   ..  ..  . ..
.   .. .        .  . . .. .. . .. ....    .  ..  ..    .   .   ..    ...    .   ..   ..      .   ..  . . ..                   ....   . .   ..  .   . .  .
..  .. ..  .   .   .  ...  ..... ..   .  . .  .   .... ..    ...    .   . . .  .   .    .    .   . .           ..... .   . ..         .  . .  .  .  . ...
.. .      . .  ....          . .    . ..    ..    .   . ..   .       X        .   .. . .      .. .        .. . .           .   .  .. .  . .  .  . .  .  .
....    .      .    .   . .     ..   ..  ..    .. . .      ...  .  ... .      .       .    .....      ...   .  ..       .    . .      ..     .. .    .. .
.     . .   . .            . .      .      ...    .       .    .     .    . . .   .   .   .    .  ..      ..           .       ..             ....  .   .
.      ..                ....  .   ..  .  . .  .. .       .       . .   .. . .  . .  .  .. ..    ..       ..   ..  .   .. ..   .       .    .      ...  .
..  .   ... .  ..   . .  .  .     .    .         .  .  .   .. .   .       ..      .      .  .    .  ....         . . .   .           ...  ...        .. .
. . .. . .            .  .  .  ..  ... .  .        .           .  .  . .     .    ..   .     . . ..   .  ..  .             .  .  ..    . . ..     ...   .
..    . .. .   ..     . .. .      ......   .  .   .  .  . .    . ...   . .   .           .  .. . .  . .     .     .  ..        . .. .   .  ..  ..       .
.   ..           ... . . .  .    . .... .     . .  .     ....     .      .... .     . .. . .. .  .  .    .               . .  .    . .    ...   ... .   .
...       ..  .  ....  . . ..     .   . .      .     .. .      . . .  .     .       .  .  .  ...           . .     .   .  ...      .              .    ..
...   . .    .     . .    ... ..      .  .         .      .  .       .         .     . ...  .    ..    .         .        .  .         .  . .   .       .
. .    . ...   .     ....  .   ....  .. .      ...         .   .   .. .    .    ..   ..  .      .   .   . .   .       . .      .           .     .   .  .
. . .. . .    .      .   ..     ...            .   .    . .        . .  . .        ...      .. ...   .             ..    .   .. .   ..        .     . . .
.    .       .  ..       . .   .   . . .. .    .. .     .. .    .         ...   ..       . .     .  ..  . .  . .  . .  .    .    .  . ..   . .     . .. .
..   .. .  .      ...   .    . .. . .  .    .    .     .      .  ..       .       .  .    .  .   .     . . .       ..   . .  ..  .      .. . .   .   . ..
..   . ..     ..       .   .. ..   .     .. ..    .     ....    .. .  .        .    .  ... .       ..  ..          . .   .          ...          ...    .
..   . .    ..   .  .    .     .  .  .... .     .   .     .   .   . .               ..   .   ....    .  .  ..... .          .       .  .. .   .      .  .
..   .    . .   ...  .  . ....  ..  .      . ..      .  .. .    .. . .    ..  . . . . .     .   .   .  .            . .       .     .           ..  .   .
..              . ..  .. . . .   .   .     ..           .         .  . .  .        .   .    .. . .   .. ..   .  ....  .        ..   .  .  ..    . ...   .
...  .  .   .     ... .  . .    .....   .  .          . .   . .  .     .      .     ..       ..     .      . . .      ..   .      ..  .   .         . . .
. .   .. .         . .    . .. .     .      .    . . .      . .    . . ... .    ..   .. .  .  .. .  ..          .   ..       ..    ..             . .   .
.  . ..        .  . .     . .. ..  .. .. .   .  .            .        .                .. .. .        ..    ...    .  .    .   . .            .     .   .
.                .   .   .     ..      .   .  .        . ... .     .           .   ..         ... .          ...... ..  .    .           . . .    .  .  .
.  .... .  .   . .    .     .  .             .  .  ..    .    ....  ..  .  .    .    . ..         .    . ..        .    .. ..  . . . . ..     .  .   . ..
.       .   .     ... ..  ..         .    .     . .. . .  . . . .    ... .. ..    . .  . . ... .   .   .    .    .    .     .  ..          .  .    .    .
.  . .      .  .  .   ...    ..    .  .  ..    ..  . .    .      .   .  .     ..      .     .    .   .     .  .. . .  . .  ..   .  .  ...   .    ..  .. .
.  .   . . .. . ..   ..   .     .          ...    .  ..     ....  .       . .....     ... .  ..  . ..... ..    .     .       ..   .  .  .    . . ..   ...
.........................................................................................................................................................
