..........................................................................................................................................................
.         ..    . .      .      ..   .   ..        .   .   ...  ..   .. .... . .   ..     ..      . . . .. .  ..      .   . .  . .      ..    ..      .  .
. ..   .. ...      . .   .        . .  .     .    .       .   .  ..... .   . .   ...  ... .  . .  ....             . .         .    ..   .               .
.       .    . ...       .. .   .      .. .       .         ..  .    .       . . ...    .. .    .      .    .... .      ..    ... .  .....    .     .    .
.   .  .    .    .    .     .    .   . .  .  . .   ..      .     .  . . ... . .             .    .   . .    . ....   .     ..      .       .. .  .       .
.           .   . ..         . . .    .. .. . ...  .   .  ..      . .     .    .    .   .   .    .. ...          ..       .   . .   .   . ....  .. . .   .
.     .. .    .. ..        ... .. .  ..   . ..        ..   .. ....       . . . . ...  . .      .  .        .        .  .. .    .  ...  ..   .. .  .....  .
.         .   ..   .       . .    ...    .      .       .                       .  .    .   . ..   .    .           .   .   ..         .      . .     . ..
. .   .  .  .    ..  . ..     .  . .       .. .. . .     .            ..  .    .  . . .    .          .    . .  .        .  ..   . .  . .         .    . .
. . . .         .. .  .   .    ....         . .        ...  . .      .  .  ..      .     . . ..      ..    . . . . .  ..           .     .       . .     .
.     .     .       ..   .     .   ...  . ..         .              .    ..     .       .             .       ..     .         .    . .    ..    . .    ..
.    . ..  . .  .    .. .       .     .  . .      ..             . .                . ..           . ...           .      .       ..    .       ..     . .
.    .. .   .  .  ...       ...  .    .    . .  .  ..        .. .. . .  .  .. . .       .           ..  .    .  .    ...  .   .     .        . .  . .   ..
.     ..   . ..   . . .  .  .. .  .          .    .  ..        .  .    .. .....  .  .    .  .     . . .   .    .  ..  .   .   . .           .     .      .
....  . . .         .     .... . .   ..     .. .     . ...         ...   . .     .. ..          .        .  ..  .  ..                  .. . .  . .      ..
..        . ..     ..   .  . .         . . . .     .  ..         ..  . ...     ..  .         ..    ..  ..  ..  .   .  .  . .   .  .  ....       . .   .  .
.   . ..   . ......   .  ... .     .. .. .   ..  ...    . .   .  .      .   . .   .  .  ..     ..   ..     .      .. . . .   .        .   ..      .      .
.   ....    ..         .    .. . .      .  ..    . . . ..   ..   .   . .   .   .   ..  .  ....       .        .            .         .     ..  . . .   . .
.   .    .  .       ..  ..  ...   .         .   .  . .    ..        .  .  .    ....   .     ...   .   ...   .    . .        .. . .  .. . .  .  ...      ..
..  . .  .    . .      .. .  .. .      .       .. . .      .  . .   .  . ..     .  .    . .      .     ..  .   ..         . .        .   .. ..   .   .....
.    . ....      .  .   .    . .. .           . ..   .       .. . . .      ...      . .  .  .  .   .   ..  .  ..  .      . ..     ...  ..   .            .
.         .  .. .  ..   . .    ..      .      . .     ...     .            .    ..     ..    ..     ... ..            .. ..  .   ... .      ..   . .. . ..
.. .. .  .. .     ...  .    .   . .     .  .  ..   .       .       . ....     .         .      .  ..   ...    ..    .  .  .  .    .    .      ..  . .   ..
.   .  .     ..   ..     .   .  ..  .  ..    .    ..        ..   .. . . .  ...       . .     .     .     ... . .    .   .    .     .   ..  ..  ..    .  ..
..  .         ..          .. ..  ...  ..   ..   .    .  .. .   .       .. .  .  ...  .   .    .   ..      .      ...    .    . ..    ..... .. .        . .
.. .       .. ..     ..     .  .      ..  . ..     ..    . .. ...    .   .... ..    .  .  . .     .  ... .     .    ..     .     . .       .         . ...
.                         .  . .   .    . .. .  .   .           .. .      . .        .  .  .        .  .    ..     .   .   .   ...        .  .. . .  .   .
.                ..   . .    . .    .            .    ...    .. .    .   .  .   .. ..    .   .  . ..           .   .      .    .    . . . . .  .     ..  .
...   ..   .   .   .      .     .  .. .    . .    ...   ...    . ...    .        ...  .   .  . . .    .    .     .   .  .. ..  . ... .        .   ...... .
.... .  . .       ..      .     . ....     ..                .  . .    .  .           .   ..      .      .  .  .    . .    .       .       . .... .      .
. .      .   .  .        ..                    . .              ..   .......   . .      . ..      ..  . .   .. .          .       .    ..    .. ..      ..
.  .   .        . . . . .    .          .  .. .  ... .    .  .   ..  . ...    . . . .  .       .      . . .   .. .. .  .. .    .  .    .      ..  ..     .
.   . .      .  ...     ..    .        ... .              ..          ..  ..  . .           .. . .    ..     ...  .   .    .      .  . .  ..   ...  ......
.     . .. ..... . .   .    .   .   ....    . ...  .   .   .  .   .... .  .  .. . .      .. .     .  .  .   .  .    .     .  ....  . .   ..   .     ..   .
.. ..         ..   .               .     . .   .. .    . . .   ....     .       .     . ...   ...   .  ..  .  .  . ..   . .     ..     . . .  .          .
...     ..     ..     ..     .   .  .        .. .      ..    .. .   .  .  .  ..  .      ..   .     . ..  .   .    ..  ..         . .. .      ..  .  . ....
.   .  .    .         ..     .         . . . .      ...  .    .   . . .  .   .   ..  . .. ..    . . ...         . .          .  .      .     . .  . ... ..
..   .   .    .       ....  . ..     .  .  .   .        ...   . . ...   . . . .        .   .  ...       .     .  ..  . . ...   .   .   . . .   ..     .  .
.. .        .  .   .. .     .     .   . .. .       .  .  .  .     .          .   . ...        .  .    . .  .   . .    ...     ... .        .  ..   ..  ...
. ..  .  .    .     .    ..   .     ....   .  .      .  .  ..      . ..  ..  .  .  .   .  .    .     ..    .  .. .  .   ... .  . .. . . .   . . .  .     .
. . .  .. . .      . .... . .    . . . .  . .  ..   .     . .   . .     .   .       .         . ..   .. .  .    .   . .     . ..  .    .   ..  .. .  .   .
.                    .  .   . .. .       . .  .       . . .  ..  . .       .     . ..    ..   ...        .   ..       .  .     ...  ...     .   .. .     .
.. .  .. ..   .   .. ..        .  ...     ..        .... .    . .. .  .  .       .     . .. .    .   .  .         .                   .  . .           ...
..    .        .     . .   .   .          .  ......   ..     .  . .  .  ...   . . ..X  .. ....     .   ...      .      . . .     .      .                .
.      . ..     .  .      .    . .   .              . .          .   . . . .  . .  ..    .  .  . . . .  ... ..       .  ..     .        .      .  . .   ..
..     . .      . .  ..   . .   .  ..    . .. .....     .   .  .      ..  .     .   . .    .     ...  ... ..        .   . .               .  .  .   . .  .
.    . .    ..  .      .   . . .   . . . .   .               .  .      ..       .   . . .    .    .      . ... . .       .. .  . . .      .  .   .   .....
.. .   ...  .    . .    . .     . ..   .  ..  .  .... .  . .      .  . ..    . .     . . . .  . .  .      .   .  .       .     .      .     ..  .        .
..    .   .    .    .          ...  . .    .  . .  .           .  .     .  . .               .   .  ..  . .. ..    ...  .   ..     .   .   ..    ..    ...
..   .   ..   ...   . .   ... ..    .. .     .     .  .. ..        .   . ..  .  ....  ..  .   ..   .         .     ..         . .         ..  .  ..      .
.. .  .   ..    . .  .  ..    . .  ... .     ..   .        . .   ..... .      .    .     .. ..      . ..   .         .   .    .  .. ..     .  . ... . .  .
..    ...    .  .   . ..    .  .    ..  ..   ..     .     . ..  .   . ..    . ....  .       .    .  . .  ..   .   ..  .         .   .    .     .    .. ...
.   .  ..   .     .  .    .  .  .   .    .     .  .    .. .      .. .  ..  . .    . .   .       .    .    . ..   .. ...  .   . .   .  .. . .     .. .    .
.             .     . .      .. .      ...  .  ...        ..    .          .  . .          . .. .         ..     . ..   . .. ....   ..  ..     ..  . .....
.          . .    .....     .         . . ...     . .  .      .     ..  .    .  ..   .  .. ...  ..   .     .  ..     .  ..   ..      . . . .  .. . .   . .
.  .   ..     ..  . .   ..  ..  ..     .   .    . ..  .  ... . .         .           ..  . .  . .     . . . ..  .   ....  .    . .    ...  ...      .   ..
.        .            . ...  . . . . .       .     . ... .   .  . .  ..  .. ...  ... ....   ..       . .       .   .  . .     .       ...    .   ..   ....
.    ..  .  .  .      .        .       . ..        . .  .   ..     .  .      .   .    . . .    .    ...  ..       .  ..  . .   ...     .  .     .   ..   .
.  .   ... .  .. .    .  .   ..     ...   .  .    .  .. .   .   .    . ..     ...        .   .          .   .    ...  . ..  .  .. .   . . ..    .      . .
.       ..       .  ..    .      .. .    ...    .  .  .        .. .  .             . .. .    . .  .    .      ..     .  . ..    . .  . .    .   .. .  . ..
.    . ...   .  ..     .  . ..  .  .. . .       ..    ... ..    .  . .  ..      ..          .      .  .  .. .   .   .  ... .  .    .   .        ..       .
.... .    .   .  ..  .  .    .   .   .      ...   .       .    .     .   . . ..                . ..   .  .   . .  . ..      .    .   ..   .   .  . .. ....
..   .          ..       .   . .  .   .    .   .      ....        .  .  ..  .    .. .     .  . . ..    .               .  ..  ..      .. .          ...  .
..  .   .  ...     .     .        ...  .   .     . ..       ..  ..  .   ..    .  .   .    .  .    ..       .   . . .     .        . ...        .  .   .. .
..         . ...    .     ..  .   .    .. ..         .  .      ... .    .  .  .   ..   .      .         ..   . .   .     ...   . ..     .. ...    ..     .
. ..         .   . .  . . ..         .    . ...   .   .    .       ..      ..   .. .     ... ... .   ...         .  .     ...  . .  .        .  ..       .
. ..   . .  . ...    ..     .   .  ....    .    .    .     . .      ..  .               .. .     ... .   .. .  ... . .... .    .  .   ....   . .. .      .
.  .  .  .   ..  .      .     .       ...  .... .   ..        . .    . . ...       .     .  ..    .         . .   .    .    ..      .   .  .     .   . . .
..      .    . .  .         . ..    .      ...    . ..     .  .     .       .  ... .     ..          .    .    .     .        ..     .    . ...      .  ..
.  .     . .         ...  .    .  .. . .. .    .. . . .         ... .. .   . .  .  . .       ...  . ..    . ..    . .  .  .  .. . ..  ..      .. ..  .   .
....       .   .   ..         .    .  . ..   . .. ..  . . .  .. . .     ...    .  .      ..   ...  . ..  ....  .      ..      .  ..  .  ..    ... .    ...
..... .  . .          .  .    ...  .     ..  ... .     . . .        ... .    .   ..    .     .  ..  . .       . . .      ..  ..           .   . .   .   ..
.     ... . .  . .. .    ..   .   .           .   ... . .   .       ..    .     .   .       . ..     . .   . ..     ..  ..  .   . ..   .       .     ..  .
. .   ....   .  . .    .. . .  .   ... .. .    .. .         . .     . .    .      .          . ..     .         .   . .     .    .     ...  ..       .   .
.. ..   . .    .    .         . .     ..     .        . . . ..  .    .    .     .  . . .. ..    .. ..  .     ..  .  ...  .          ....       .. . ..   .
.  .. . .. . . . . .. . . . .. .     ...          ... .   .      .. ..    .    . .      .   . . .   .. . ....  . .  .  ... ...     .    .          .    ..
..     . ..   . .    . . ..     . .   .   . .. .   .  . .         .  .     ..               .. .        ..  .  .   .     ......  .       .  .. .. . .. . .
.      . .. .   .. ...    . ...        . .  . .      .         .    .  .     ..... . ... . .       .       .  .   .  ..    .   ..  ..  .   .. .  ..     ..
.   .. ..  . . . .       .      ..    .    . ..    .    .  .    .        .  .        .     ..  ...         . . . ..    ..     . .   .    .    .      ... .
. .  .      .      .    .    . . .  . .   ... ..    .... .       . .     .    .   ...   . . ..    . . .     .        ...  ... .   .      ..  . .       ...
... ..   .        .  .     .. ..   .  .   ....   .       ...   ..    .  .    .. . .   .  . . .          .. ..         . .    .           .  .        .   .
. .         .        .  .       .      . .    .   ..  .. .  ..  .     .. .    .  . .      .    .  .  .  .   . ....    ....          . .     .   .  .    ..
...        .    .      .    .    .. . ..  . .   .   . . .     .  .  . . .    ..   ..     .   .. .                     ..   . ..... .  . .. .  .....     ..
. .    .       .   .        . .  . . . ..     ..    ..  . .    . .  ... .   ..  . .    .   . . .. .   .  .  .  .     .  .   .       ....           ..  . .
...            ..  .  . .   .. .       . . .. .  ..   ..          ..    .     .  .    . .     . . .   .. ... . . ..   .    . .  .. .   . . ...    .     ..
.    .  .  .  ..  ..    .     ......   .         .   ... .     .  ..      .  .        .. .   .   ..      .   ..     ... .   ..      .  .      ...      . .
. . ..        ..   ..  ..         ...    .    ..    .   ...     .  ..    .      . .      .   . .            .  .  .  ...   ..  .   .  .   . . .  .   .  ..
.     . .. .  . ....    .   . .   .  .      . .  ..       . ..     ..     .    .      ..  ..     .   ..    .           . ...  ....         .    .  . . . .
.          .   ...             .  ...                .  ..   .     ...    . ..   .  .   .      .  .   . ...   .   .          . .  . .     .         .   ..
.. . .      ..      ..... .          .   .        . ..     ..  .      .. . ... .  .          .  . ..      .  .  . .  . .  . .        .. .          .  .  .
.. .    . .  .  .  .     .  ...   .. ...... . ..   .. .   ..     . .  .    .     . ..  .  ..    . .   .      ...       .  .. .          ...        ....  .
.   ..    .        .  ..  .           .     .    . ..  .. .  .. ..  .    .  ..        ..   .  . ...  ....     .  .. .  .         .  .. .    .     ....  ..
.   ...  ..  .     . .  .     . ..  . .    .  .. ...        .. ....     .  .  .    ..     ...  .   ..  ..   .               .. .  .    . .              ..
. .          . .    .     ...             . . . ..   .... .   ...   ..    .      .  .  . ..     .     .           .     .    .     .   ...             . .
.. .    .   .  .              .    ...    . . .....       .    . .  .  . ...     .     ..  .  .  .   .       . . ... . ..  .     .    .    .      . .  ...
.   .    .   . ... .   .  .    ..  ..  . ..          . . .   .    .  ..  ..           . .  .   .. .  . .     .  . .       ...   . .   . ..       .   .  ..
. . ...    ..     ..         ..         ...                . .    ..       .   .   .   .  .  ..    . . .  .  ..    .   .    . . .. ... ..  . .         ...
.    .. . .  .  .. . ..          . .  .  . .    . .  ..        . ... .   . .        ..   .  ..        ..     ..   .  . . .  . .      . .. .    .  .      .
..        .  .        .. .      .  .. ..            . . .       .   .               ....  .... . .  ... .     .    .      .     .. .   .          .   .  .
.. .        .  . ..      ...   .   .  .            ....    .  .    . .   .   .  . ..  .               .    .. .. ..     .  . ..         .  .  ..    . . ..
.      ...        . . ..  .  . . .... ..  .   ..         ..  .  .    .. .       .   . .. .   .   . .  .  ..     .... . .r   ..  .  ...        ...     .. .
. .    .     . .   . . . . .  ..  .  .   .  .           .. .. .. .   ..  .. .    . .     ...  .          .. .  .       ..  . . .  .  . .      .  . . .   .
.. .  ..      .           .. ..  .   .. .  ... . .  ..   . .. .   . . .    .         . ..       .       . ...    .  .   .   ..   . .  ... .  .     . .   .
..   .  .. .. .    . .        .  . .         .  .             ..    . ....  . .  .. . ..   .  ...  . . .  .  .. . . .  ..     .   .  .  .... . .      .  .
. .  .    ... ..  .            ..     . ..    .    . .. .    .   .  .      . .  . .    .      .         .      .               . .    . ...  .   . ..  ...
.    . .. ..     .  . .     .  .     ..      .   . .    .   . ..       .   .     .  .. . . .         . .  ..     .. . . . . .. .   .  .. .    .  ..   .  .
.     . .. ..            .  .       .  .. ..  .       . ..      .  . . .          .      . .   .     ..           .  .   . .   .  .      .  .  .  .    . .
.. .  .. .. .. ..  . .  . ...   .      .      . . .. .  ..  .  .    . .        .. .   .  . . . ..             ..  . ..  .  .  ...  .  . .  . .    .    . .
..   .. .    .       .  .  .  . .  .      . .  .. .   ...   . .    . .  . . .. ..   .   .. . .. ..       . . ..      .        ... . .. ..        .  .    .
.  .  . ..   .       ..    .   .  ...              . ..   .  .. .. .  .   . .    ..       .. .  ..    ..  ..   . .  .       ..     . . .  .  .      .   ..
..    .   .  . . ...  ..  .           .  ... .  .. .   .          .. .   ..    .  .         ..    ..     .  .  . . . ..  . .    .  ...   .     .     .   .
.       ..      ..  .. . .   .    . .    .                ..  .    .     .    ... .    .      .     ..     .. . .  . .    ..  .    . .    .  .    .  .   .
.   .  .     .    .    .       .    ........    .     .. .        .   .      .        .  .   . .  . ..     ...      .     . .   .  .      ..  ...      ...
.. . ..    ..    .    . .   ..    . .   .       .  ...     . .  .   .. .  .    .  ..    .. .  .     .    . .. .     .   ...    .  .. ..       ..      .  .
. .  . .....    .. .      ...  . .  ..           .    .    ..   .   . ..  .   . .  .             ..   .  ....      .   . ..  . .   . .  .  .  .  ...   . .
.. ..  .   .    .          .        ...      .          ..      ..    .    .      .. .     ...       .     . .    .. .  .. . .    .   ..  ..    .      . .
..    ..       .    ..    .    .   . . .   .      .  ...    .    ..  ... .... . ..    .  .          . .     . .. .    .    .  ...     ..   .... ..  .   ..
.         .        ..  .              .. .         . .. ..    .  . ..   .  .    .     .      ..   .   ... ..     . .          .        .  .  .  . .      .
...  . ...        ....  .  .   .    .     ..     .    . ..    .         .  ..... ...              . .   . ..    .   .   ...         . .   .  .. .      ...
.   .  .   ...  .   ..     .   .     . .   . .  .   . .    .  .                . ..        .... . .   ..  . .. ..        .. .. . .. . .  .  .  . .. ..   .
. ..                     .    . .    .....              .    ...     ..    .  . ..    .....       .. ..         .             .   . . .  ..     ..  .    .
.  .     .   . ..     .     .   ...     . .  . .  . .      . . .       .    ..   . .  .  . . .    .        ..      .   .          .   .. . ..  .....  .. .
. .      ..   .     . .     .      . ..      ......   .   .  ....  .        .     .           .  .      .   .     ..  ...  .  .  .  .  .        .  .. .. .
.   . .    .  .     ..  .       .  ..          .  .   .      .   . ..  .  ..    . .   .. .  .      .   .  .  .  . .    .          .. .  .   ..  .   .  . .
.    .   ... . .  .  ...  . ..     .           . ..  .        .     . .  . .. .  .     . .   .    .    ..   .   ..     ...  .    ......        .   ..    .
.    .  .         .  .  .   .      .  ..     ...   ..        ...    ...     .    .   ..   .    . .        . . .   .  ...         ...  ...    . .  .      .
.  .     . .       .  ..        .. .. .  .   .  . . .. . ... . .               .   .   ... .   .   ...      . .                     .      ...  .       ..
. .   .    .. .   . .  .         .  ....   .    ..  .  .    . .  . . .      ..          . . .   .     .       ...  .  .         .   . .            .    ..
.   . . . . .   ...      .  .          .. . .  . ..  ..   .  .       .   ..          . .  .       ..  ..   . .    . ..    ..             . . .      ..  ..
.            ...   . ..             ..  . .   ..        ..    .   . .   .   .     ..    .      .  . . . .    .  . .. .. .   . .  . .  ..          . ..   .
.    ... .     ....     . .      ...  . .    .   . .       .     .  ..      .    . .            . ..     . .  .    .    .    .. . ..        ... . .    ...
..    .  . .  . .       ...           . .  . ..  .          .   ..            .... . . .. .   .     . ...  ...  . . . .        .      .       .  . .     .
. . .....       .. .  . ..     .  ....  ...     . .       . . ..     .    . ...       .. .    .      ..         ..   . ...    .  .  .        ..      .  ..
..   ...      .    .   . . ... .  .  .    .     . .    ...  . .  ... . . ...  ..        ..    ...             .   .. ...   .  . .   .  ... .      . .  ...
.   .  .     . . ..        .         .. ..   .   . ..   . .     ..    ... .  .   . .. ....  .  .  . .    ..       . ..       .       . .           .  .  .
.   .           .   .. .   .             .         .    .  .   ... .  .....      ...     .  . .  .   .  .. ..   . .      .  .. .    .   .  ... .  .   .. .
. .  ...     .   . .  .         . .. .            . .      .        ..   .    .......   .   . . .  .      .   .  .   ..       .             .     .      .
.          .   ...        . . .  . .     .     ..    .   .....   ... .     .  ..          .        . .      ..       .   ...   .  .  .      ..   .  . .  .
.. ...  .       .     .   .  ... ..       .         .  ...    .     .   .  ..      .    .    . .  .     . ....   .     .      . .     .  .               .
..                ..  .   .     .    .  . .  ...            .   ... .   ..  . .     ..   .      .  .  .   .     .    .      . ...  .         .       ..  .
.        ..   .   .. .        ...    .   .   ..       . ..   .    .           . .. .   .    . . .   .   .  ..               ..  .  .  .     . ..      . ..
...  . . .     .     ..  .  ..  .   . ..         . .   . .. . .      ..  .    .  ....       . .  . ....      .      . . .       ..  ..  ...     . ... .. .
.. ...  . . . . .  ... ..... .  .   .  .      .. ...   . .. .  . .    .  ..  ..   .    ..             . .     ...    .   ..  ... .  .     . .   .  .     .
.           ..   .  .  .          . .     .      ....   .  .    . ..  .  .  .. ..  ...... .      . . ....  .. .    .  .  .    . . . .    . .    .   .    .
. .  .    .       . .     . ...            .  .        .  ...  ..    ..  .        .   .          .   .    .           ...  .. .   .   ..  .  .    .      .
.    . .     ...         ..   . ..  . ..    .        .     . ..    ...    .... .      ...  .         .      ..  .. ... .  .   ....           .      .   ..
. .         .. . ... ..     .   . ... .. ..  .    . .   .   ..  .   .. .   .      . .    . .       . .           ... .   . .  .. .  .  .  ...   ..  ..  ..
.   .  .    .. . .         ..    ..  . .. . .  .  .  . . .  .  .    .           ..    .       ..   ..        .. .  .   .   . . . . .  . .     .   .  .  ..
.   .  ..    . . .              ...   .    .  .  .       .   ..             .  .      . .  .   .    .                  .      .         .    .. . .   .. .
.   . ..  ..   ..   ..  .     .     ..   ....... .  . .. . ..  . .  .   . ..   .     .   ...  . .    . ..  .   .                   .   .       .. . . .. .
..   .       ..   . ...     .       ..  ... ... .   ..     .   ..    .  .... . ..  . ..  .   .    .. .. ..    . ..  .        .     .     .  .  . .    .. .
.    . .   ..    .  .. .    .. .        . .        .       .   . .    ..  . .       ..  .  .....     .  . .  . ..    . .        ... . ...  .. ..   .  . ..
.. .  .           ..  .. .   .       ..      ..  .       .    . .    .. .. .  .  .  ...     . .      . .        ..   ....       .   . .   .. .   . .. .  .
..........................................................................................................................................................
