...........................................................................................................................................................
. . .      ..       .  ....      .    ..   ..        ..    . . .       . .  .    ..   .   .. ..     .   .      . .  . .   ...   .    .    ..  .. . .      .
....      .. ..   .     ... .  .        ..  .         ..  . .   ..      .    .   . .            .    . .  ...            ...     .    . .       . .    .  .
.         .   . . .       ...  ...  .   .               .   .  .   .    .     .   ..    ..     .           .   . .   .. ..   . . . ...   ..          .. ...
.    ..   .  . .. ..     ..   .              . .  .    ....  . ...  .. .      .   .    ....     ... .      .     .    .     . ..         .   ..  ...      .
. .          .   .     . .    ..  .              ..     .     ...  .           ..   .  .         . ... . .  .        ... ..   . .  ..      .  .  .   ..   .
...    .   .    . .. .  .    .    . .         . .  .   .. .   .    .    .   .   .  .      ..  ..   .          . .  .. ..   ..            ..         .   ...
.     .   . . ..  .    .   .    . ..  .    ..        .     .          .  .   . . .    . ..  . .    ..   .       ...    ..        .   ..   ..   .      . . .
.   .        .       .  .. .   . .. ..  .  . .....  ..  . . .    .   .     .      .    ..     .   . . .   .   .   .  .   .  .. .   .  . .     .   .  ..   .
.  ... ..  ..  . . ...    .    ..       ...... .        .       . .    ..  .  ..  .    . . .      .         .   ..   . .. .. .. .     .    .    .  .  . ...
. .    . ..    .    .   . .       .          .            ..       .          ..    . .   .        ..    .  ..       . .. .      ....    ..   ..  . .  .  .
.        .  . .      .  . ..  . .   . .       .  ...   ..   . .     ....       ... .        .   .  . .      ..     .           .  .  . .        ..  . .. ..
...  ..  .. .  . .  .   . ..     .. .     . . ... . ..             . .  .... . .     ..       ..   .   .   .    .  .    ...  .      .   ...   ...    . .  .
. .      .  . .. .. .   ..               .  ...      ..  ..        .        ...  . ....    .. .        . .  .. .    ....  .. ..     ..       .       .  . .
..          .  . . .   .. .   . .    .  .. .. ..  . .    .     .   ..   .  ..    .   . ....  ..   ..             .     ..  ..      . .   .            .   .
..   .        .  ..    .   .  .. ...       .   . ..     .    . .  . .  .    .   .   .   . ..    . .              .. . .   .         ..         . ..   .  ..
. .     .    .     ..     .           . ... .   .. .. .  .. .           .    . . . . . . .   . . .  ...   ..   .   .  . . .       ..        ..       .  ...
..    .        . ..   .   .  .... ....     .     . .  ...   ...     .  ...    . .       ..   .    . ..  ...  ..    . . ..         .    . .     .   .   .. .
. ...     ..... .   .     .. .   .. .  .  . .   . .       . .   . .. .. .   ..  ......    .. . ..       ...    .  .  . ..  ....  . .... ..  . .   .   . . .
.     .   ..    ..   .    .     ..    ..       ...   .    ...        ...      . .   .  .      . .. .    . ..   ..   . .   .  .   .  ...  . ... . .    .   .
.  .       .  ...     .  ..   ..           .....       . .       .    .        ..  . ..  . .  .     .    .    .   . ..     ...         .    ... ..  .  . ..
.       .   .  .  .       ......   . . .     ..  ..  .    .       . .            .  ... .         ..   .....  ..       .  . .  .. .      . ..      .   .  .
. . .     .. .  .   .    . . ....    .    .   .    ..     . ...   .   .  .   .       ...  ..   .    ..        .  . .          ..      .                   .
. .   .  .       ... .    .. .. . .  .   ..    . .. .   . .  .       .   ....  . .         . . . . .   .     ... ..  .   . .        .  . ..  .     .  .   .
...  r      .. .  .              .. .   . ..   .  ..  ..    ..  .. .  ..   .  .    .    .  . .   . . .  . . .     . .     . .   ..  ..           ... . .  .
. .  . ..  .      .   . .  ... .    .   ... .     . .      .           .  ..     ..   .   ..   . ...   .    .      .. ... .     .    .  . .     ..      ...
. .      ... . .        . .. .    ...     .   . . .      .  . . .  .  .      . .  .          . .   .  ...    .       .. ..    . .. .   .    .    .  .  .  .
.  ..   .    .     .    ..   .    .  ..    .   ..   .  .   .    .     . . ..  ..  . ... .     . .  .  .                  .   .        .  ..  . .         ..
. .      .  .  ..     .  .  ..  .   . ..       .    .    .        .  ..  .     .  .  . .        .       .           .    . ...... .    .     .    ... . . .
.   ..    .     .  ..  . . .           .  .       .    .  .           .       ..  .  . .         ..     .        ..    . .  .      .     .              . .
.     .   .  .   . ... .    . .. .       ..   .  .     ....  .     .. .    . ...        . .       . .. .    . ..      . .       .. ..    .      .     .   .
.  ....  . .  .   . .      . ... .   .   . . .   .     .  ....   .                 ..   .      ..    .   . .. . ..  .  .  .  ..    .        . .. .       ..
. .       ..  .    .  ..  .  . . .    .   .  ...     .. .   .    . .  .   ..    .     ..  .  .       . .  .       ..  .     .            .  .      ..     .
.          .  .  ...     .         .         ...  .. .    .. .      . .               .  .  . ..     ..    . .. .     .      . . .  . .. . . .   .        .
.  .      .    .    .  .          .   . . .    . .        .... . .   .  ..      ..   ..  ......  ..     . . ..   ..   .  .       .. ...    .    . .      ..
..        . ..  .     .   . . . ..   .      . . .  ..    . .   .   . .       .      .  .  . .            .   ... . .  ..  .       . ..               .  ...
.  . . ..     .  .         .  .    .   .  .. . . ..  .  .    .    .        . .      ..   .. . ...        .  .... .  ..  . ..    . . ...  .  .     ..      .
.       ......       . .  .                   .   . . ...   .     ....      .      . .   .    ..    ..  . .. ..  ..       .          ..   .  .  .  .      .
. ..      ..       ..   .  .    .         .  .  . . . .    ..  . ..    ..    .. . ..  .       .     .    ..        .... ...  .           . . ...          .
.....   .. .      .  ....   .      . ..      ..    .   .        .. . .   .      . .         ....   .    . .  .  .  .  ..   .   .   .          .    .   .. .
.   .     .  .. .  ..     . .   . . ..     . .       .   ...  .  .     ..    . .         .  .   ... .. ..    ..     .  . ..   .   . .  .       .. .  . . ..
. ...            .    .  .    . ..  . . .    .   .     .  .       .    .     .     .      ..  ..    ..  ...     ..   .    ...   ...    . .     .          .
.     . . .    . .  .  ...   .  .  . .    .  . ...   . ...  ..    . . . .   ...           ...      .. .        .   .   . .    ..    .  .    . .    ...  . .
. .    .  .  ..  .  .                 .    .              .   .   .     .  . .. ....   .... . . ..   .  .    .    ..  . .    .....     ...    .    .  ... .
.   .   . . .      .  .  .     ..   ...   .    .  ..  ....  .       .    . .          .....  .. . .       .  ..     .     . .. .  ....        .   .  .  . .
...          . .. ...        . ..      .   .   . . . .  ..       .      . . . .     . .       . ..   .      . .     . .. .  . .  .  . ..  ..          .  ..
.    . ..   .  ... .    . . . .  ..   .     ..  .  .   .... .  .       ......       .  .    .   .  . .  .  .   .            . .      ...    . .  . . .    .
. .          .    .      .. .    .   .   ...  .   ..    ..  . .  . . ..   . . ..       . ..   .    ..  ..   .    . . . .          ..          ... .  . .  .
. .   .   .. .         . .                . ... ..  .    .     .    .           .    ..   ..  .  .         .          .   .  . .. . . ..          .       .
.  ..  ..      ..  . .       .. ..   .        ..      . .     ..          . . ... . .   .     .      .  . .       . .....     . .        ..  . . . . .  ...
..    .       . . .     . ..   .     .  .  ....      ....  . ....      .   ...    .     ..    . .. .      .  ...   . . .     . .   .  ..       .   .      .
. .. .  ..   .    . .      .      . ... .  . . ..   ..      .        .  . .      ...      .      ..... ..    .. ...   ..  .          . .    . . .  ..  .  .
.. . .          . ..      .   . ... .        ...  .  .. ...         ..    .         .  .  .   . . .      .  . .      . .    .. . . .   .          ..   .. .
..    .    .   .   ..   ..  ..        .  . ..... .   .  . .         .   . .   .. ..  .  .  .  .       . . .  . .    . .. .    .  .    ..  . ..        .. ..
. ..         .    .    .  . . .           .   .      ... .        . ...  .    . ..   . ..   .     .  ....    ..     .   .  .   .  .  . .. .. . .      ..  .
..     .    . ...   .       . .     ...     .    .. .   . . . .     .  .. ...         .  .  .      .     .             ... .  .....      ..   .        .. .
...   .     ..    .  ...  ..    ..    .   .. . .  ..  .. ... . .      . .  .  ..     .   .  .. ...... . . .  . .     . .....       ..   .. .  . . .   . . .
.       ..         .. .. .  .. . .  . .   .   .   ..   .. .  .  .  .. ..             .  .           ..      . ..      . ..    . ...   .   ..  . .    .  . .
.       .  .   .   .  .         .. ..  .  ..  .   ... ...          . . .   . .   .    .   . .   ..    . ...   ..   .            .       ..    . .. ..    ..
.           .  .      .    . ..    .   .     .        .        . . .         .     ..   . .     .        .   .   . ...  .. .   .      ...       .       ...
.. . .. .       ... .   .    ...  .. .. .  .    . . . . .  .  . .    ..  .    ..          .          .     ..         .  .         .      ..  . ..       ..
.      .  .. .     .. .     ..        ..         .   . .   ..      .  .     .   .   .        . .   .  ..     .. .     ...  ..  .    .       ..        ..  .
. .  .    .  . . .        .     . ..        .      . .  ...   . . .....   . .     ..    .            ..       .  . .  ..   .. .   .   .   .      .    .  ..
.       .   .   .       .   .. .  . .  ..       .  . .     . .        .. .  . .. ...  ..  . .  ..    . . .    .    .. .  .   .   .   .   . .           ....
.  ..... .    .    .     . .   .    ..    ...    . .. .     . .      ... ..   . .   .           .. .     . ..    . .    .        .        .   . .     .   .
..  .    . .      ... ..       .  ..  .  . .. ..     ..    . .. .         .     .     .. .    ....       ... . ....      .        .    ..       . . ..  . .
..  .  .   .. . .    .   ..        .  . .  .  .  ..   .      ..  . ..            ..         .  . . ...   .   .  .  .    .  . ...  .   .. .....   ...    ...
..     ..   .  .   .    ...... .         .  ...  .. .  .    ... .  .   .. .    .   .. . .    . .   .  .  ..  .  . .  . .   .   ...   .... .  .        .. ..
..    .      .    .  .    .   .  .   .    .     . .  .   .   . ..  ..              . .    ...    ..   . .   .. .    .      .. .   .      ..   .    .     ..
..         .   .   .    . .    .              .  .   .     ..  .. .. .... ..       .    .  . .. .. .. .   ..   .        .   ..  .. .. .. .  . .   .   . . .
...      . .      .  . .  . .             . . ..   .    .   .. .   .  ..      ...   .        .... .  .      . . .    .  ..         .  ..      .   .       .
. ...              . .     ... .  .  ..       . .      .. .  . ..      .   ..    .  .  .   .  .      . .    . .   .        .         ..    ..    .   . . ..
.      .  .   . . . . ....   .    .      ....      .    .     .  .  .   . ..     . .. .   .      . . .         .. . . ... . . .  .    .  . . ..   .   .  ..
.    . ..  .  .. .     .   . ...         ..    . ..  . ..    . .  .             ...       ..       .    . ..   . . .  .   ..   .    ...            ... .  .
..         . . ..      .        ..    .        .   . ...  .   . ..  .      . .       . . .. .. .  ...   ..     .  .  .      ..  . .  .        . ..    . ...
.. ..           .   .  .        .   ... . .. .  . .     .. ....     .         ..   .. .        ...    .    .      .     .    .  .     . .  . .    ..  .  ..
..  .  .            ..  .   . .  .. .     .         . .  .    . ..                .. .      .....   .   ...   .     .    .  .            .                .
....  ..       ..   . .         .        ..   .    .  . ..  .  .  ..  .      .     .    . ... ...  . ..  .       X.      .     . . .   ..   .    .  ..   ..
. ..       .  . ...  ..... .. . .   ..    ...    ... .     .  .       ..     ..  ...        .. .          .   . . .     .    ..  .       ...      .   . ...
.  .   .   ...  ..      . .   . .  .    .   ...   .   . . ...     .... .      .    .      .    ... .         .. .. ..               . .....       ..  .  ..
.           ..  .  .. .   .   .    .   .   .   .. .  . .     .    ... .         .   ..        .. . .. . .    .  .    . .  ...   .  .. ..  .. . .       .  .
. ...      ..      .     .   .     .     .. .    ..  . ..         .   ..     .   . . .  ...  .     .  ... .. . .   .    . ...   . .     . .  ...   .      .
.  ...  .   .  .  . . .               .     ..  . .  .  . .   ....  ...         ..    . .     .  .  . ...       . . .         .. .  .     . ...  . .      .
..   .    .              .. . . ..    ...  . .  .   . .  .      ..     .         .        .       ..   .           ..  .  .    .     .     .  .     . .   .
...  . . .       . .  .     . . .    . .  .         .. . ..        ..        . .      .    .        . ..    ..    . ..        .    . .       .. . .. . . ..
.. .         . .      .      .   ...       . . ..  . . .    ..  . . .  ..      .  . . .  .  . . ..   .        ..   ..  ..          ..    ..  .  ..        .
...        .. ... .  . .      .   .         .        .     . ...             .   . .     . ..   . . . . .   .  ..    . .        .  . .  . .     .  .. . . .
. . .       .     . .  ..  .    . .  ...   .      ..                 .  .  ..  .   .   ..       . ..   .   .  ..     ..   . .    ...         ...   .      .
.  ...      .  ..       ......  . ..         .   ..  ..  ..  .  ...     . .    . ... .      . .  .   . .   ....   .         . .  .                    .   .
.      . .  .    . . .          .    . .     .    . ...   .. .  .       ..  .  ..     .         .  ..          . .  .    . .    .     .     .        .  . .
. .   .  . .             .   .  . . .    .   .  .          ....          . .    .    . .   .     .  .  .    . .. . .      . .       .  . . .       . .    .
..  .... ...   ...     .    ..    .  .  . .    .      ..             .         .     .    . ...         ...   .       .    .   .  .  .      .       .    ..
.  .. ...      .     . .     ..        ..   .  .. .  . . .. .    .    ..    .  . .   . . ..      . .  .  .   ..   .  .   .. .  .   .   .    .          . ..
.  .  .      . . ...  .   .   . .  . ..   .        ... .  . .        . .. .    .   ..  .  .  .. . .. .. . .           .    ... . ..   .......     . .   ...
. ..  . . ...    ...  ....       .     ..  ...   .  .           .  .       .     .   .      .       .     .  .          . .    ..    .          .  .      .
..  .       .... .      . .     ... .... .  . .    ..   .   . . . .   .  .       .     ...        .   ... . .. .  .   . . .... . .     . ..  . ......     .
.....   .    . .. ... .   .. .   .          . .   ..  . . ...   .     .  ..      . .  ...    .   . ...          . .     . .  .. .                       ...
. .   .  .        . . .      ..   ..      .. .      ..   .   .   . .... .  .. .. .  .  ..   .    ..    ..   ...  .    .    .         . ...         .      .
..  .  ..      . . .   ..           ..  .  .     . .     .. ... .  ..  . .  .    .     .. .  ..  ...  .       . .     . ..    .. .  . .   .. .   . ..  .  .
.   . ..      .  . .  .   .. .          .   .        ..        ..    .  ..  ..   .  .   .     .  .  ..    .. .      .  ...   . ..  .  .. .. .       ..    .
.     .. .    ..  .   . . ... ..  .      .  .. .   ..     . ...   .        ..           ..          ..  ...         ..   .   .   .  .       ...    .  . ...
.  .  ...      . .                   .  .      .  .      ..       ..    .        . . . ..  .       .  ..  . . . ...     . .     . .  . .  ..     .    .   .
..  ...        ..        .    .. ..  ..          .   .  .       . . . .           .  . ..  ..   . . .   .    .       .     .     . . .    ..  . .   . . . .
... .        ..    ..  ...    .   ..    .   . .. .    .     .  .   . .  .    .  .. .     .. .  ..   .      .     .      . . .    .. .             .      ..
...  .....    .    .. .      . .  . .  .   ...    . . .  .    .       .      . .  . ...  .        . ..  ..   .  .      ...  .   ..      . . ... .  .  .. ..
. .    . ....   ...     . .           ...   .  .  .      .    .  ..  .           .    ..  ..  ..    .    .    .       ..    .  .  . ...  . .    .    ...  .
.  .   .     .        .    . .   . .   ..  ..       ..       .... ....  ....  .. .. .  .  ..       .  ...               .     ... .  .           ..    .  .
.....  . .           .  ..  .     . ..              .    . .   .       .      . . .. .    . .     . .         .. ..  .   . . ..  ..    .     ..           .
.   .   .  .    .        . ...                .     .  . .  .  . .                ..     . .     .   .     . .         .  .  .... .   ..   .  .   ..  . ...
.  .    ..              .     .  .   . ..  ..   .      ...    .     .  . ..           .        .    .  . .     .  .     .  .   . .. ...           ..      .
.  ..  . ..            .   . .  . .      . .  ..  .    .     . .     . ..  .   .  ..    . . . . .   .   .   .    . . .      .    ..   . .. ....      .    .
.          .  ..    ..  .   . .   . .     .           .   .. .        ..   .                     ..    .  . .   ..  .    ..      .   ..  .. .  ..  ..  .  .
. .  . .. . .. ..  .   .  . .. .  . . ..  .. . . .. ..         .       . ......     . . .       . .       .  . .  .      .   . .     .. .. .. .      .  ...
.   . ..        . .          .       .         . .      .  . ..      .    .      .  ..        .  .                 .         .   . .       .  ..    .     .
.    . .. . .    .  .    .  ..   .    ..   ..    . .. . . . .        .  .. . .  .     ...   .   .   .. .      .  .  .  .      . ...  .    .              ..
. .  .      .        ... ..        ..  .  .    .    ..           ... ..  .              ..     ..  .. ..                 ...     .      ..   ..  .   ..  ..
...  ....   . . .  .. .   .  .    ..   .      .     ..  .  . ..   ..    ..  . ..... . .     .     .   .      .    .    .  .     . .              ...     ..
.  .       . . ...    . .          ..       . ..        .  .     . . . ... ..      ..  .             .  .         .       . .      ...  .       .     ..  .
.   .    ..       .    .    .      .     .   . . .   . ...  .   .. . . . . ..           .    .  . . .     . .    . .   . . .  ..  ..    ..  . .        .  .
. . . .  ..     . .       ..  .. .        . ..... .     .    ...  ..      .   .      .  .    .   . ..  ..  ..           .   ...             ..       . .. .
...         ... .   .  .   ..  .     .    . .     ..          . . .   ..      .. .    .     .  .      .  .   .  ...    .    . ..        ... .       ....  .
.  ..   . .....   . . ..   .       .    .  ..     . . .        .         .  .  . ... . .    ..          .  ..     .      ..  .      .       . .   . ...   .
.      .    . .        ..  .  .   ..  .      ..   ......    ..     . . .   ..   ...    ..  .         .  . ....  ..... . ..      . ...      . ..         . .
.. .    .   . ..     .  ...    .     . .   .  .             . .  .    .   . .    .   ....  . . .  .     .       . . ...    . .   .   ..   .. .       .    .
...... .. .   .   .    . ..  . .. .  . .  .  .  .  .            .  . .   . . ..  .      .        .  ....   .  ...    .. . .  .             .           ....
.    ..     ..     .    . . .. .          ...     . .. ..      . . ... ..    ...      ..      .    .  . .    ...     .  .  .  .   ..  ...   . ..     .    .
...    .     . ..  ...  .       .  . .    . .  ..   ..     .    . ..        .  ...   .        .  .   .... .           .   . .  . ... ..     .    . . . .  .
..         .. ..   .      .... .    .   ..  .  .   ....      ..   .  ..     ...    . .   . .         .   .  .  . .     .  .. . .           .   .          .
...   . .     .     ..  .  .. .  .     . ..  .. .   .     .      .  ..  .  ..   .    .     ..  . ..  .. .       . . .       ..  . .   ... .   .    .    . .
. .  . ..         ..      .   . .. . ...      .   ..   ...  . ..  .     .. .  .     . .    .  .      .   . .                 .  ..   .   ...      .. . ....
..             . .   ..      . .   .               .    .   ..    .       . .   . ..     .   .   .    ...  . ..  .    ...  .  .. .      ...     .. .  .   .
.  .. ..      . .....     ..  . .  .  .    .      .   .  .   .   .     .. .  . .    .   .       .    .       . .   .  .   ... .   . ..   .       . .  . ...
.          . .  . . .          .  .          .     ..    .     . . ..   . . .  ..         ..   ....   . .         ..      .  ..    .  .  .    . .        ..
.. .    ...     .  .   .    .  . .  .              . .  .     .  .  .     ..       ...  . . .        .              .       .       ..    .  .         ....
.    .  ....   .    .   .....  .     .          .  .   .  . ..   .. . .  ..  .. .     ...      ..  .  . .   ..     .      .    . ...   .      ..   . ......
.     .. . ..  . .        . .  ... .      ... . .     .  .      .   .     . .   ... .    .  ..     ...    ..              .   .  . . . ...  .    ... . .  .
. . .  .      .         .       ..  .   . .           ..   . .. . .      .       .. .     .. . .  . ..       ..   .  .   ..  . . ..    .   .           .  .
.    . .. .           .    .          .      .. .      . .   .      .... ...  .    . ..  .   ..  . .  .   .. .. .   . .      ...   ... . .   .. . . .    ..
.  .      .. . .         . .   ...         .     .   .    .  ...  ..  .   .    ...            .  .      .  .      ..   .  ..  .        .  ..  ....   .   ..
.  .    .    .     .   .   .    ..      .      ..      ...  .     ..  ... . . . .       .               .         ..    .   . .  ..     .   .             .
.  . ..   .      .       .                 .  ..   . .   ...   ... .. ...  ..   .  .. .   ... .      .  ..   .. .... . . .    .. ...  .   ..    .. ..  .  .
. .           ..      . ..   .  .     . . .    .  .         .  .. ..       ..       .       . ....  . .   ... ......       .      ..  ..     ..     ...   .
.      .  . .          .. .. .    .       .     . ..  ....  .  .   ......          .       . . ... .       .      .  .  .    ..      .  .         ..  . . .
...  . ..     .  . .....    ..    .. . .  .            .     .  ...  .   .  .     . .. .... .       .    .  .   ..     . .     . ..    .   .     .        .
. .   ...     .    .    ..   ...    .  ..  ....   ... .  . . . . .    .   .   .   . .   ....  . .  .            .   . .   ...     ..   ..      ..... .  . .
...       .   .           . . .. .  .    .. ..     .    . .    . . .    .     .   .  .  .  .      .  .      .  .. .    ..  .  . . ..     .    .  . . .  . .
. ..        . . .  . .  .. .  .    . .            .     .    ..            .    .    . ... ... .  . .   . . .      .      .   ..      . ..      .         .
.   .    . ..  .... .  . ..      .    .. .  .    .  .   . . ..    ..      .  .. .....   . . .  .. ..       .      .        ..         .     .    . .  .   .
.. .  .  .. .    . .. .      . .   .     .. .  .  .        ..     ..   ..        .. . .. .     . ..    .     .        .  .   .  . .    .   .   .       .  .
.      .         . . .  .   .  . .. . ..    .  .    ..   .     . .  .. . . .      .  .        .. .   .    .       .  ..   . .    .     ..  . ..    ...   ..
..   .       .       .  .  .   . ...    ..  .           .   ..     .   . . .        .  .         .   ... .       ...   . . .  . .  .  ..  ...  .    ..    .
..   .     .   .  .     ...   ..       ..            .  ...       .  .  . .  . . ..   .  .  .    . . .  .  .      .    ..   ..   . ... .  ..  .  . .   .  .
.     .     .  ..  ..    .. .  .     ...             ...   ...        ...       . ...  .   ..    ..   .    . ...  .. . ...  .         .      ... .   .    .
.            . . .   ..  ...  .. .     ..  .. ..        .           .   ...     .   .     .  . ..  .... .       .  .. .  .  .  . . .   ....  .     . .  . .
...........................................................................................................................................................
