............................................................................................................................................................
..   ....  .      .    . .  .   .  .  ..  ...   .     ..   .  . .            .  .     .    ..    .   .  ..  . .  .  .     .. .    .     .. .   . .  .      .
.          .    ..    .   . .   .   ..    .  .    ..           . . .  .  .   .     . . . .  .  . .           .     .. .  ......    . ..  .   .         ..  .
. . .    . .      . .  .        .  . . .          .  .   .  .   ..      .. .   .    .  .. ...   .   . .   .   .     ..          ...  .  .  .   ....   . . ..
.  .  .  .      ... .   ..        .        . .   ..   .     .       .        .  .            . . ..  .      .  .  .    .   .     .. .    .  ... .        ...
. . .        .     .       . ..   .       .         .  ..  .  ..       ..      .    .     . .  ..  .      ..  .        ..  ...  .          .  .            .
.      .  .. .   ..    .   ... ...     .      .  .  .  . .  .     .   .    . .  .  .  .  .. .        ..    .    .  ... ..   ..  ..  ...  .         ..      .
. .    .... ...  ..    .. . .      . ..  .    . ..          .   . .    ..  .    .  .  .    .  .     .   .   .  .    ..    .  .    .. .  .  .    ... .. .   .
.     .   .           .        . ..  .        ...   . .    . . .       .    .   . .. ..  .    . .  .     .  . .. .  ..  ..     .    ..  .. . .       .   . .
..   . .   .     .    .     ...  .    .. . .       .  .  ..  .    .. ... ..    .....  ..  . . ..   .  . ..     ...     .   .. ..        ..    .. ...   .   .
. .  ..   ..     ..  ..      .  .       ...    . .      .      .   .       ...    . .   .  .      .   .    ..  .  . ..       .       . ..   .    .     .   .
..   .. .  .  . . ...  .. .   .  . . ..       ..       .  .       .... ...     .   . ..  .     . . . ...   ...  ..  .  .  ...      .      .    .. .  . ... .
.   ...... .       . . .    . . . .. .  .   . .  .   ..   .      .           .    .  .       .    ...   .                     ..    .  . . .        .    . .
...  . .   . . ..  .... . .      .  . . .. . ..   ...  . ..  . .     . . .      .      .   . .    .     .  .  . . .  .  . .    ..        ..  ..  ..   .    .
. .     . .        ..      .   .    .     .. .       . .    ..    .   .  ... ..     ..  . .. .     . .   .. ...           .    ..    .    . ....    .  . ...
. . ..    .     ..    .    . .           ...         . ...  .     . .     .  .  .     .  . .  .. . . .             ..  . . ..  .     .  .   .   .    .     .
.   .     .   .        .  .. ... .    .   ...  .   .. ....  .     .. .     ..    . ...  ..   .    . .    .  .    .        .           ....         .   .   .
..         . . ..   .. ....    .   . .  . .  ...       .        ..         .  ..       ..   . ...  .  ...           ..  .. .  . . ..     ... ...   .. .    .
.  .. .           .    .. ..    .  .  . . .. . ...     ... .        .    .    . ... .       .         ..  .. ..  .  ..     ..   .. .      .       .   .    .
.  ..    .   .  .      .    . .       ..  .  ..      .  ...      .           ....  ... .  .    .     .. .  .  .   ...  ..  . .  .          .   . .. ..  .. .
.             .    .  .      .       .  . .       ...  .. ..  . .   .. .  . .     ..  ..  ....  . . ..    .. . .   . .  .. .   .    .      . .    ..  .    .
.....    ...    .    .  .  . . .  .  . ..  .    ...   . .  . .   .. . .   . .    .    .  ..  . . .  . .. . .      .  .   . .   ..   .  .         ...       .
. .     ..       .. .  . . ..  ...    .       .       .   .                .       .         .        .           .    .. . ...  ... . .     .  . . . .    .
.   . .   . .   .        ...             .      . ..   .  .     ..     .   .       ..   ..  ..   ...      ..  .  ..        . .    ...   .     . .   ..    ..
.. .....  ... .    . . ..    .... .    .            ..   .. . .  ..  .   .  ...     ... .            .  .  .  ..    . . ..  .   ..   ...    . .  ...    .  .
.          . . .  .           .. .   . .        .             . .        .         .. ..      .      .  . .       ....      .     .     .   .   .  .       .
.    .       ..  .                ..       .      . .    .  ...      .     .            . . .   .       .    . . . .. ....    .      .     . .  .    .  .. .
.     .       . ..     .  . ..   ... .   .      .      .   ....  .. . .        .      .           .       .    . ..          .       .   . .  ...   .      .
.     . ...  . ..  .      .    .     .      .  .  ...  ..   . .     ... ..  .    ...        .    . ..    .    . . ..   ..        ..       ..       .   .   .
.         .  . .       ...    ....      .         . . .  . ...  . ... .      .    .    ....  .   .  .      .         ..         .       .            .    ..
.  ..    .            .     .                 ... .       ..  .      .  . .       ... .  . .    .. .        .      .  . .. .    ... .         .      .  .  .
.   ..     .     .   . .    .     ......  .    ..    .   .   . . ... .      .   .  .. . .     ..     . .   . .  . ...      .    .    . .     .       . ..  .
.. .           ..        ..... . .      .     ..        . .   .      .. . ..   .    ...  .    .     . .  .  .. .  .  ...         .       .   ..    .   . . .
.  .   .    .. .. .....      .    ..        .  .      .      . .          .     .       .        .   .  .. .         . .      .. .. .  .  ... .   .   .    .
.  ..  .  .     .   . . .       . ..  ..  .        ...   .    .     ... ..   .       .  ..   .   .  ..    .   .   .     . . . ..  . .  .. .  .     . .     .
.  .         ..   ..   .  ...    .  .  .  .   . .    .  ..       ..    .   . .    .  .    ....       ..     .. .   ..        .  .   .   ..    .  .    .  . .
. ..    . . . . . .    .. .  .   ..... .  ..      .    .   .  .      .   .   .... . .  .     .         . .   .    .   . . .   . . . .   . ...  . .. .    . .
.     .   . . .  .   .       .. .         .. .   . .    .      .    .. .    .    .     . .  . .       .      .     .  . .    .      . ..         .         .
. .           ..    ..    . .  . .  . . .    .  .   .    ..     . ..  ...  ..  .  . .   ..    . ...   .    ..    .    .  ...    .      .   .      .        .
..       . ..   .     .. . . .   ..                     .      .   . .     .     ...   .      . .   .....     .  ... ..  . .   . . .  ...  .   . .  ..     .
. ... .   . .       .  .        .  .. . ...      .    .  .    ..    .     .  .       .    ...           ..  .     .       .   . .     .     . .. . ...     .
. . .    ...    ..   .         . .      .  .   ..      . .  . .          ...  .         .   ..   .      .  . .    ...      . ... .. ... . .   .       .  . .
.      ..  .... . .         . .     ..                    . . .  .  .. .  .  . .   .  .     .     .  .   ..  ..    .       .  .  ..    ....    .    . .  . .
.  .       .  ..... . ...   .     .     . .  .. . ...   .      ..  .      .     ..         ..           .           .  ..  ..      .       ... . . .  .. ...
...    ..    . . . .  . .   . ...      .   .  .  .  . . . .       . .  .       .                 ..   . .   .  .  ..      ..   .   .     .           .  .  .
... . . .    .  .   .   .  ....  .  . .    .           .   .        ... . . . .   .. ..       . . .       . .       .       ..      .           ..    .  ...
.       .   .. .          .      .  .  ..  . .     .  .  . .  .. ..   ..  ...  ..   ..  . .  . .....      .  .  .    .  ..   . ..  .    ... . .  . .  ......
..  .    ..   . .  .   . .      ..   ..   . ...    .     . .  ...  .               ..     ..   ..   . . . ..    ... .  .     .     . . .. .  . .    . . .. .
.     .  ..  .    ..  .. .. ... .   . .    .        .     .       . .    .  ..     .    .  .. .   ... .       .     . . ... . .. . .    .. .. .            .
..  .   .    . .   .     ...       . .          .     . .      .  ...    .    .     . ...      .  .    .....  .   . .  .  . ..      . . .    .    ... .  ...
. .  . .      . .  .            .   . .    ..      . . .. ..   ....       ..  .   ...  ..      . . . .   .    ..  . .     . . .   . .    ..     . ..    .  .
.    ..             . ..  .   . . ..     .    .. ...  ... .    .. . .  .  .      . . . .  .  .    . . . .. .   . ... .  .        .. ....    .       .      .
.   . . .. .  .  ..      .. ..   ..  .   ..   .  . ..   ..   .   .. .  ..      .   ...         .     . ...    ..  .        .            .  .   . . ... .  ..
..  . ..  .. ..             ..   .               ..   .    . .. .       ..       .  ..  ..     .  .       ..     ...   ..   .  ...  .               .   .. .
..   . . .          ...    .      . .        . . .   . .       . ..    .. ..  .  .              .    .             . ..     .    .   .    .  .  .  ..    . .
.   .   .  ...        . .   .     . .        .  .    . ..         ..     .. r....           .  .. .  .  ..       .  .      ..   .   .  .  .    ..      . . .
.   ..   . . . . .. ..  .      . .  . ....    .  .   ..     . . . .   .      .  ...        ....      .            .  .      .   .. .. . .   ... ..  .   .  .
.  .    . .... ..  ...        . .   ..       .      .   .         .     . ...           .   ..       ..     ..  . .. .    . ...  .            .   .    ... .
.    .   .... ... . .. .  ..      .  .    . ... .      . ..         .  .  .     .      . .   ....    .     .  .   .  .    . .   ...      . .  .  .   .    ..
. .       .          ..        ... .. .     ...  .     ..       . .      ..   .   .  .   .   .. .  . ..   ..          .   .        .  .   .    ...     . . .
.. ..        ..  .      . .      .       .     .              . .  ..  .  .   ... .            .    .  .  .          .      . .. . ..     . ...        . ...
.  .  . ...  .  .  ... . .    ... ..  ...   ..   .             ..... .    ..  . .  . .. .. . .       .   .   .. .     ..   .        .   .  ..    .    .    .
.    .    . .         ..   .   ..  .        ... .    .  . ... .       . ..  ..      ..  . .    .    .                 .  . .         .  .        .  .... . .
.    .   .  . ..       . ..  . . .      .    . ....   .    ...... .  .   .      .   .  ..      . .  .  ..      ..     .     .    ..   ...     .  .       . .
.           .  .   .   ..   ..     ..  ..   .    . ..  ..    ..   .... ..  .      .  ....   .  .. .   ..  .   ..   . .                       . .  ...    . .
. . ..    ..   .  . .    ... ...  .        . .  . .. . .    .    .    ...  .  . .     .       .   .         ..  ...  .   .     ..       .   .   .   .. .   .
.  .  .    .  ..        .. .    .    ..  . .   .. .  ... .   .  ..   .     .   .  .... .. .    .     .  .  .   .      .  ..      ..   . ...  .       .     .
..  .     ..    .    ...  . .  . .  .   .     .  ..   .               . ..          .   . . .      .   . . . .     .    ..   ..      .             .       .
.. .   .             .           .  ..    ..  .      .         .      .   .  .. . .  .      .  .    .    ..   ... .      .....  ...  .  .    ...           .
. .    ..  .    .  . .   . .          ..... . .         ..    ...   . ...  ....    .. .                   .      .   . .   .  ...  .. .. .. ... ..... .. . .
.. .. . . .  . .. . . ..  .     . ..   .. .           .              .....  . .. .    . ..   . ..  .   .    .. ... .      . .    ..     .  ....  ...    .  .
. .    . .      . . ..   ..    .        .         ...      . . .. .. .     .  .       .    .   .     ..      . .    .  ..  .       .    . .    .  .  .  . ..
..  .       .   .  ..  .  . .. .    ...    .  .  . . .   .       . .             ... ..   .  . .  .  ....   . .     ...... .  ...  .    ..   . . .  .  ..  .
.      . .      ..   . .    .... .. . ..     ..      .  ...        . .. .       .     . .     .. . .      ..   .     ....  ..  .   . .           .      .. .
.  . ..      .   .    .     .  . . . .      ..   . .. .   ..     ..  .    .. . ..  .. .             .       .. . .   .     ..  . . .  ...    . . .    ..   .
.  .    .     ..  . .  ..... . .    .        .  ...   .         ..   ... . .       . . .     .          .  . ..        .  ... .       .. . .    .    ..  . .
.   . ..       . .  ...  .  .       .   .     . .  . .    .  .  ... .  .     . .     ..   .    .        . ..     . ..   . . .  ..  .             ..  ..  . .
.    . . .          .. .  ..  . ..  ...        . .  .         .    .. .   . ....  .    . ...           .  .. . .. .  .  .       . . . ...  ..  ...   . .   .
.  .. .  ... ... .. .   . . ...       . . ..   ... ...  ..  .      .  ..   .. ...         ..    ..  .. . .   ...   . ..   .  ..  ...... .    . ... . . ... .
.  .     .    .   . . . ... .    . .. . .    .  .  .. . .   .  ..  . .. . . .        .  . .  .   ... .   . .  .     . .         ..     .    ..     .    . ..
.  .  .         .   .   .  .     . .  ..   ..  .. .  .  .  .    ..    ..  .  . .        . .  .   ... .   .  ..    ...     . ....  ... . ....  .   . .  . . .
.  .   .   .  . .    .     .  .   ..    .       .  .     .. . .   .. .    .  ..  .        . .   . . .      .. ... . .     .. .     . . . . . .   .  .      .
. ..  .         .   ... .          .   .       .   .  .      . .    .. . ...      .  ... .           .   ..       ..... . .     .  . . .   . .    . ..     .
.    . . .    .    ...   .                ..  .      . ..  .  ..  .       .    .     . .. . . .   . .    .   ..   .   . ..       ..    .    .       .  . . .
..... ..    .. . .       ....  .    .      .  .        . .    .     .   .  .   .....     ...   . .  .    .       .        . ....     .  ..      .   ..     .
.   .. . .  ..   .   .    .  . . .  ..    .  .   ..        .  .  .    . .  ..   ..            ..    .    ... ..   .      . .      . .      .  .    .. . .  .
.  . .  . ..  .    .... ..      ..  . .               ... ..  ... .  ..   .... ..  ... .      .      . . ..  .        .  .             .     ...  .       ..
..   .        .   . ... .    .       .. .    ..    .  .        .     ..  .     ..  ..     .    ..       .   . .....     .  . .     .        .    .  .   .  .
.. .  ..    .   .             .        . . ..    .. ..  .    .  .   ..    ..    ..                 .      ..   ..   .        . ....       .       ... .    .
.       .. .    .    . ..  ...      . .       ..    ..  . ..    . . ..            .    . . ....   ..           ..     .  .      .  ..    .    .. .    . .. .
. ..  . .. .  .  .   .       ...       .      . . .       . .. .        ...    . .   .  . .        ... ..    . ..        . .  .     .        .  .     .. . .
.  . .  .      . ..       .   . .   ... .   . .   . .         .   ..   . .    ..  .... .     ..   . .. . .   . .. . .. ..  .  . .         . .   .  . . . ...
.         .. .   . .     .  ..      .       . .   .. .   ..   ..     .   .  ..     . .  .  ..  .  .       .... .   .     .             ..  .   . .     .....
. .    ..     ..... . .        .      .   . .      ..  . ..           .  . ..    .   .   . . .     .  .   . . ... ....   . .  . . ..  . ..     .    ... . ..
. .  .  .     .   . . .     ..  .   .  ...  .    .      ..    .  .   . ....   .    . .       .  .  ..    ..     . .  ..        .               .  ..      ..
..    . .      . . .  .     . .    . .   .    ..       .   . .      ..  . ... ..   .   .   . .. .         .  . . .   . ...    ..... .   . .              ...
.     .     ..      .        ..  ..      .   .  . .   .    .  ..     .  ...   ..    . ...         ..     ..  ..    . ...        .    .  .    . .  .  .  .  .
.    .   ....   ..           .     .     .  .     .  .   .    .       .  .  .  . ..    .     . . . .  ..  . .   .  . .      .  .  .   ..         . .       .
..... . .   ....  .      . ..     .. .   .  . .   .     . .   .              .    . ..         .   . .   .  .     . .    .  .  .  . .    . ..       .    ...
..   ..     .     ... . .    .  ..        . . .  .  . ...  .   .         .  ...  ....           ...  ..       ..    .  . . ..     .. .   .                ..
.   . .  .     .  . ..  .    .    .    .       ...  .  .    .              .. . .     ..       ..  .                 .  .. .    ...               . .    ...
.   .  .   ..    . .  . . .  .   ...    .     .   ..       ..    .   ..   .   .. . .  .    . . .        .     . .     .        .  . .   .   .    .         .
.    . .    .     .  . .. .     .       .           . . .      . .   .   .  .. .         .    .     .  .    .          . .    . .   .. .  .          .  .. .
. ..  .    .        . ..      .  .   . . ..            .         .  .       .   .   . .  . .    .  ..   . .. . .  ..   .   .     . ... .     .      ..   . .
.        .    . .    .. ..        .    . ..          .   ..       .  ..           ...  ..           .. ..        .  . ..  ...  .   ...          .... . .. ..
.    ..  .     .. . . .   ..   .     .. ..  .  .    ..     . .    .. . ...    ..  .      .  .  .      .  .   ..  .  ..     . .     .       .   . .   .  . ..
.  .... .  . ..   .      ..         .    ..    .        . .     ..    .  . . .    .  .  .  ..     .. . ..      ..  .    .   .  ...  .. .. . ...         .  .
.  ......   .    .. .   .   . ..  .. .    .   .   ..    .    . .   .    ..   ....  .      .      ..   .            .....    .              . .      . .    .
. .  . ...   .  .  .  .      .       ..   .  ...    ..     ..  .     ..       .   .  ..  .    ....  ..   .  .        .. .    .    .    .. . .   . .      . .
. .     . ... . . .        .. . .    ..   ..   .    .    . .        .  .  .    ..  .     .   ...   .  ..   .       .  .  .....     .       .  .      .  ....
.  . .. ....     .  .    ..     .      ... . . .. .     .      .     ... . .   .. . .  .  .. ..         .    .  .     ..  .   .  ...    ..  ..  .    .     .
.. ..  . .  ..   ..       ..  .   .  . ..     .. .     .. .  . .              . . .     ..        .           . .  .    .   .       . .     .   . . .  .. ..
. .     .  ..  ..   .   ..   . .    .    . .     ..   . .  .      ...  ..     .  ...        ...    .. .   ...   . ...        .            .   .    .  ...  .
.       .  .   ..     .    . . .. .  .   .    . ..      .. .      .  .   ..    .            .. .....    .    ..   .  ..  .    ..  ...    .   ..     .. . ...
..     . .   .          .. . . . .  .. .    .. .   .   . . ..  ..  .. .   . . ...  . ....  .    ..    . .   .   .        ..   .       . . .   . .   ..  .  .
.    . .      .     .....  . ..             ..  .    .  ... .   .. . . .    . . .      .   ...  ... . .   . .  .... .         .    ..   .. .. . .          .
. .        .  . . ..  ...              .   ..          .      ... .     . .            . .   .   . ..  .    .  . .     ...            .     ..  ..       . .
.    .  .            . ... .   . ..    .    . .   .   ..  ..     . .   ..     .. .  .  .   .       ...      ... .     ..        ..  .  . .  .    .. .. .  ..
.           .    ..  .    .  .       ..    . .  . .   . . .    . ..   .   ..      .   .         .    ..     .     .    . .       . . .  . .         .     ..
. ..... .  . .     ..   .  ...      .. . .  ..   .    .         ..    ..           .   . .  .    ..          . . .. ..   .   ..     .   .  .    .  .  .  ...
. ..         . . .    . . . .. .  .   ..  . . .   ..  .   . .  ..  . .    .   .       .  ..      .      . .  ..    .. .  .      . ..   . ..   .   ..     . .
. .    . ..      .   .   .  ... . .      .   ..           .   .    .. .    . .        .  .. .  .           .   ..  .   . .     .   ..   ..            .    .
. .   .  .         . ..       .   .  . . .  .    ..  ..  .  X.  .   ....         .   . ..     . .     .     .  .  ... .     .         .  . . .    . .     ..
.  .     . ... ..     ..   .   .            .   .     . .     .    .  ... .   .   .   .    .   .    . .. .    .             .. .. .  .   .     ..       .  .
.    . . ..   .    .. .  .   . .     .    .        . ..       .   . .    .        .     ..    .       . .  ...   . . .  .     . ...  .   ...    . .       ..
..  .     .       .   .  .    . .  ... ..  .           .    ...      .          .   .   .    ..      . .       ..   .     .    . ...      . .. .       .  ..
.   .. .     ...   . .    . .   ..  . ..   . . .  . .  .  .   . .  . .           .  .      ...         . . . . .    .      ...    . ..      . . .          .
.   . .   . .       ..        .   ..  . . .   ...    ..       .  . .          ...   . .    .   ...      ...    ..          .  .   . .   .  .   .  .      ...
.    .. ..   .. .            .    ..        .       . . . ..   ... ...  ... ..  . ..  ... .  .    . ...  .   .       .     .  ..    ... ..        .       ..
.     .  .       .   . .   .       .. .       .            .         . .       .....    .  .     .  .    ..           .  .   . .  .  . .    ..      .. .   .
.   ..  . ..        ..    . .  ..   .  ..   .  .   ...     . .    .   .      . . .  . .    ..        ..        . .     .   . .         .  . . ..       ..  .
..  .       ..    .     .   .       .       .     .  .     ..  .  . .   ... ....    .           .       .      . .    .   .      ..  .    .. ..  .  .    ...
..  .     .     .         .   . .....    . .      . .         .   .         .           .     .      .      .   .  .       .                .. . . . .    ..
...   .  .  .  .   . .   .   .    .    .  .    .   . . ..    ... .  ..    .     ..        . ..    ..  .. ..  .   .. ...         ..    .  .. .     .  .   . .
..  .       ..       . .  ...      . .     .   .  ... .     ... . ..       .     ...   ..  .  .. ...   .  ..    ...    .     .   ..         . .   .        .
. .   .. ..  .          .    .   . .. .    ..  ...     .     . .  .      .  ..   .   . . .. .         .. .. . .     .     .  .. . .  .. . .           .   ..
. .    . .      . .    .   .  . .        .     ...   .  ..              .   .              .  .  . .  .     . .       .....   .      ..  .   ..  .         .
.   .    . .  .   .     .  .                     .  . ..   . ...  ..   .      .    .. .   .        .  ..        ...      .   ..  . .  . .      ... .  . .  .
..  .. .  . ..  .     .  .       . .... .  .       ..      .      .  .  .    .         .     ..... . . .  .  ...  . ...     ..   .  .   . ..        .      .
.    .      .      .      .   ..  ....     .   ...   . ...    .         ..      .. .          .  .       .   .       .  ..   ..    . .. .  .. .     .   . ..
..    .      ....   .   .. . . ..   .  .     ..  .   .  .    .    . .    . .  .. ......       ..      ...      .. .... .  . . .          .    ..   .       .
.    .  .     ... .  . .   . .  .       . .  .     ..   .    .   . .  ..  ..       ...     ...   .      .  ..  .    .. . .          .  .        . .    .   .
.  .  .     .     ..   . .         .. .  ..  .  . ...      .    . ...  . .. . . ..   .     . .     .       . ..   . . .   . .       .            .. ..  .. .
.   . .     . . .  . .   .     .        . .  . . .        ..        . ..    ..   .           .      .    . .  .   . .  ..   . ..   .  .  .    . .. ..  .  ..
. .   . .    .  ..    .    .. ..   . . . . ...    .    .               ... .      .  . . . ..       ...   .  .  .   .  .    .      . .   . .... . .. .  . ..
.  .   .   . .. . ...  ..       . .   . .     .          . ..   .    . ..  . ..  .    ...    .   .  .  . . .          . . .  .    ..    .    .   ..     .  .
.     .  .      . .   . .. ... .  .. .    .   .. .. . . .  .        . ...  .    . .      .   .  . ..   .   .  ..            .    ..  .  . .  .. .   ... . ..
..    ..    .     .    ..  ..   .. .  ...    .    . .       .      .   .     .    . ..     . ...  .    .          . ..  . .       .           . . .   ..  ..
. ..             . . .   ..  .   .   ..       .     . ..      .     . . .. .  .. .   .   .          .   ..   .      .  .         .     ..     . . .    .. ..
. ..  . .  . . . .. ......  .  .  . .      .     .   ..       .   .  . . . . . .    .      ..      .               ..  .     .    . .       ...  .      ....
.  .  .    .  .    .   .  ..        . . ... ..             . .  ..  .. ..            ..  . ..   .     .  .   . .     ....   ...    .            .. ... .   .
.  . .  . ..  . ..     .  .  . .  .           ...   ..    .  .    .    ..    ..          .       .    .   .  .. . .          . ..  .  .  . .       ..     ..
.  .. .   .        .. .      .. ...  .      ......  .  ...   .  ..    .. .   .       .       .      ..   ... .   .  .   ..     .    .. .   ..     ..  ... ..
.      .     . . . . ...   .   ...      ...     . .. . .   .        .   ..       .   .      .  ...  . . .     .  .   .    .  .   . .         .           . .
..      .   . .   ..  .. .. .. .. .   . .     . .. . . . ...   . ..  .        .        .   .          .  .  . .   .            .. . . .  ..  . .. ..  .  . .
............................................................................................................................................................
