.............................................................................................................................................................
.    . .      .  . .   ..      . .    .         ....      .   ...         ..            ..       .   .                .  ..     .     .    .            .   .
.       .    ...  ..        . .        ..     . .     . ..               .   .. .   .   ..     .  ..    ..     .  ..  .  .  . . .  . .    .  .. ..          .
.   ..       .   .   . .  . ..  .  .    .. .     . .    ..             .     .. . .   .     . .   . ...   .       .   .     ..    ...      . ..       ..   ..
.. ..      . . . .     ...    .      .  ..  ... ..  . .       ..  ..    . .  ..   . .  .         ..  .        .  .           ...   ... .. .       ....  . ...
.   .  .. .  . . .        ..  . .. .   .     ..    .       ..      .  .     .    .       .  .     .      ..  ..  .        .     .   ..      ... .    .      .
..   .        .. . . .     . .    .     .   .  .   .  .   .  . .   .      .   .  . . ...   ...          .. .           .     .     .  .  .     .      .     .
.  .... ..   .     . ...  .  .  ..     . . ...  ...       . ...  .  ..    .    . ..    .. ..  .   ..      . . . . .  . . .  .     .    .          . ... ..  .
.   ...        ..      ..  . .  .. ... .   .  . . . .           . ...  ...   .  ..      .     .. . . .  ....      . . .. .  .   .  .     ...         .  ... .
.   . . . . .        . . . .   . .   .   .   ..  .      .   .   ..  .   ...  .... ... . . .  .      .  ..  .   ..   ..  .. .              ..  ... .   ..  . .
.    ...            . ..  .     ..            .       .. ..   .       ..      ..           .  . ..       .     .. ... .   ..      .  . .           . ..   . .
.  ..    .  .  ....   .   .         .      . . ..    ..            ... .   ..  .     .   .  . .    ......         .  . .     .    .         . .        .  . .
...  ..           ... . .          .        .      . .     .  .  .      .. .     .      .   ..  .       .. .  . .    ... ...        .....   . . ...       ...
..  . .   . .  ..   .  .. . .... .  .  .          . .      . . .     .        . ... .    .  .  .   .     .       . . ..                    .   .    . .  .  .
.  .  ..      ..   ..         .  .... .        ..       .   .     . .      ...     .   ..          .             .  .        . ...        . ..  . ..   .   ..
. .. . .  .    .     .. .  .  .   .....   .   . .    ..  .     ..   .          .   .  ...  . .... .. .....     .   .  ..      . . . .    .  .  . ...     .  .
.    .            .. .    .  . . .    ..... . ..      ..  .  .  ..     .. .. .  .   . ... .. .. . ..  ..  ..  .     .  ..    . ..    . ...    .   . .       .
..    . .  .     . .     .   ..          ....    . .   . ..   .      .  ..  .        .    .....  ..    .. .  .         . ..   .  .         ..   .     .     .
.. . . ..   ..       ..  ..   .               .   .....  . ..   .. .  . .  .    .       .  .    .  . . ..    ..      ..  .   .   . .  ..    .     .   .     .
.  .           .   .   ..     .  . .   . .              ..     .         .. .. .            . .         .   .  . .  .  ..               .  .             .. .
..        .  .. .  .     .   .   .  ..      .   .   . .  .   .     .   .    . ..  ..   .   ..   .       . .. .    .   . .     . .         .   .    .   .  ...
.. ..   .. .. .        .  .     ...    .. ..  . . .         ..  .      .  ...     .  .      .  . . ..    ...   .. .. .. .    .  . .    . ... .         .    .
.          ..  .       ...   ..            .  ... . .    . ...      ..  .          .   .     . . .    ..        .  ..              .. ...   ..        .    ..
.. . .           .  .   .     .    ..   . ....       .     ...  .     . ... . .   . .  ..          .        .   .    .   . .  .   .    ..    .  .       .   .
.  .  .  ...  . ...  . . .. .   . ..   .       .  .   . . .  . . ..     .  .   .    .. ..    . ..  . .  .. . .   . .   .    .  .         . . . .. . .  .    .
..    . .       ..    . . .  ... .    . .. ..    . ...  ..     . .. .  ..     .   .     .    .       ....          . . .         ...   .   ...           . ..
. .    .    ..   .   .  ..  .  .    . .   ..   .   ..     . .. .  .          .   .   .. .  .  ..   .. . ...   ..       ..    .  ... .              ... ..   .
.       .    .  ..    .   . .... . .          .      ...     .  .       .. .  ...     . .  .  .  .     .     .     .. .  .        . .. .. .         .       .
..           .  .  .    .    .     .. ....  .   .. .  . . .  ..   .  . .  . .    ...   .   ..  . .  . .  . . .             ..  .     ...       . . .  ... . .
. .  . .       ..         .... .  . .   .          .  .  .   .... ..    .     .      ..                            .. .         .   ..   . ...    ...       .
..    .  .        .          .           .  .        . .  ..   . .       ..      .   ..      . ..   . ..    ..   . .   .. .  .. ..      .   .  ..  ...      .
.     ..    . ..  . .. .      .  .       . . . ..        ..       .. .. .  .  .    .   .....     ....    .     .  . ..        . .       ..          . . .....
. ... .       ..       . . .. ..... .       .. ...  .... .  ... .    .    . .  .   ..    ..    .    .       .   .        .... . ..       ..         .    .  .
. .   .... .  .   . .   . .   ..   . .  .  ..       ..     .    .    .   . ... .    .   . .. .. ....   .  .. .  .   . .    ...  .  ..     .  . .       .  ...
..    .   ... .       . .  . . .    .  . . ..     .    . . .. ..      .     .        .  ..       .  ...          .     .    .        .. .  ..    .     ...  .
..    . ... .. . .       .        ... ..  ..   ..      ..            ....   .    ..    ..    .   . .  .         .   .      . ..    . .  .       .      .    .
.        .. .   . .          .  .           ..    . ... .  .          . ..   .    .. .  .       ...       . .. ..    .        . ..  .     .      ..  . .... .
.   .   ..        .   .  . ..  . .  .      . .  .    .       ..   . .         .   . .  .. .   .       . ..   .         .                 ...         .      .
. .  . .   .  ...     .. ..    .  . . .    .   .     .      .    . ..    . .    .   ..  ..    .      .  .  . ..  . .. .      .          ....          .     .
.     .   .  .   .  .               ..      .        .   .   ......     ... .    .  .. .     .   .     .  .  .  .  . .          . ..  . .    .  ...   ..  . .
..  .  ...      ....      . .  ..    ...      .  ..         . ...  .. .             .   .   ..     . .. .    . ..  .       .. . .       .... .   .      ... .
.          .      .   . .     .   ..  .  .    .      ...    ...   .    .  ..  .   .   .      .  .    .  ..  .    .   . .      .  .   .   .   ..  .   .      .
....      ..    ..   . .       ..      ..       . .     ....   .  ..   .   ..   .     .        . ..    .    .   . . ... . .     .... ....       . .....   . .
.    .  ...  ....  .  .  ..   .. .. .   .. .    . ...   .    . ...     .        ..   .. ..     .  ..   ...    .  .     .. . .   .         .       .     ... .
.    .  ..      .. ...  .     .     ..   .      . . ..     .      .      .          .. .   ..  ....  ..   .   .    . . .    .   ...    ..   . .     . .    ..
.  .. . .....    ..      .                ...    .    .  .  .     . ....         .   .  .   .  .             .   . . .. .     ...  .... .    ..        . .  .
..       ...         .  . . . .        ..    .  .   .. ...   ...        . .  .     . .    .         ..   .       . . ..   .        ..  . .        .  . .   ..
.       .   .            .  .  . .   ...   . ..   . . . .   ... .    . . ..   ..    . .     .   . .           ..          .   . .   .  .   .      .  . ..  ..
.   . .   . .          .      .. .    ..  .   .. .  .      . . .     .    ..     .. .    .  ..  .   ..        .      ..      ..   . .  .      .  .  ....    .
. . .    .  .   .  ... .   .     .      .   .  ...      .. .  .     .   ..   .  .   .       .. . .. .        .             ...  . .. .     .     ..       . .
..  ..  . .          ..   . ..       . .   . ... .  .  ..       .   ...     ... .       .      .       .          . .     .      .      .  .. . .  . ...  . .
.  ..   . .     .  ..  ...          . ..   . .    ..              .      . . .  .        .  .. .        .   .     ..           .  .. .   .. ... .. .  .     .
. ..   ..  .     . .  .           . .   .   .. .        ...  . ..    .. .   ..    .  .    ..          . .     .    .   .   . . . . .  .            .  . .   .
..  .. .    . .     .  .    .  ....   ..  .       .        .. ..  . ...    .   ..  ..      .. . ..        .  .. .     ...     ...      .        . . ..    . .
.   .      .     .....    ..  ... . ... ..  .  .... .   .. .  . .      ..  .    ..  ..     ...     .   .      . .  .    .  .. ..    .   ..      .       .. ..
.   .    .  . .    . .  ..   .   ..   .      .   ..   .          .   ..  . .   .  .   .      ...  .  .  . . ..   ..   .    . .   .  .    .      .       ..  .
.       .       ... .     .     ..   . .  .             ..  .  . . .     ..    .   .  . .    ..    . . .        .  .  ..       .     . .  .  .   .   .      .
. .  .. .  .. .. .. . .     . ...          .      .   .. ..    . ... .. .  ...         . .. .   .     .    . .   .  .      ...   .  .. . . .    . . .  ..  ..
.. .  ..      . ..   .       .                       . .  .  .....     ..   . ..   ..    .        .  .. ..  .  . .     .  .  . ..  . .   .      .    . .   ..
. .          .    .            .   .  .     .   .  .   .   ....    ..      .   . ..     ..     .  .  .  .   ..         ..       ..  ..   ...      ..        .
.. .   .  ....  .    .  ...  .            .      . .            .  .  . .  .   .. . .  .    ...  .   . .  .    . .. .    .     .     .    ..    .    ..     .
.   ..       .     .     .         ..      ..   .            .. . .  .    .     ..    .  .     .   ....  .   .   . ..    ... . ..   .    .  ..        . ... .
.          ..     .       . .  . .  . ...     .. . . ...  . .    .  .  .  .   ...    . .      . .  .   ..        .  . ..   .  .   . .    .    . .  ..   . . .
.  . ... .. ..    .. .. . .    . .   .. .              ....    ..  ...  ..  ...  ....    ..   .. . ...    . .   ..        .  .  . .   ..   .       .        .
. .     .    ..    .   ..   ...        .      . .      .     ..     .   .  .    .         .  .  ... .    . ..     .. .    . ..    .   .  ..   .     X..    ..
.    . .   .           .  .    .. . .   .  ..... ..      .. . .. .       .  .     ..  .   .     .        .   .       .  .   .        . .            .     . .
.     ..  .  .     ... .                       .   .   .  .    ...   .      .. .... . .           .    .     .. . .    . ..  ..  ... .   .  .     .  .    . .
.      . .    .    . ..  ....     .     .       .   .  ...  .  .         ..    .  ..      .     .     .  ..     .           . .   .  . .  .. . .  .        ..
.  ... ..     . .             ......   . .. .   .    ..       . ..      .   .    .      .        .         .   . . .     .  . . . .   ..    .  .        .  ..
..    .   . . . .         .        . ... . .. ...    .             ...          .. .    .  ..      .         . ..   . .          .. .  ..  ..   ...   ....  .
.  .   .    ...        ..   .     .  .   .  .  ..    .  .           .   . ..  ..     .             .   .              .   .   .  .. .    .        .   .   ...
. ..  . .    .   .   ...   .  ....    ..   . . . .         .. .    ..   ..  .  . .   .  ... .                 .      .. .  .  .    ..         .  .    .   . .
. . . ..   .   .       .... ..    ....  .    .    . .  . ..    ... .. .. .    . .  . .. . ..  .     .      ..     . .. . .. ..             . ..   .  ..     .
.   .. ....     .  .       .. ... ....     ..    . .   . ..        .  ... .  .  .    .      .     . . .... .                         .  .... .. .   .   . ...
. .        .  .     .  ..   .. ...      ..  .. .  .        .    . .      .    ..   .    .   . .  . .           .     . .. .  .  .              ..        .. .
.       .       . .    . ..   .     ..     ..  ... ..   .     . . .  ..  . . .   .       .  .  .  .. .     . .   ..      . ...  . .. .  .   ..  .. .        .
. . . .      .  .  ..  .  .        . .   . ... .  .     ..           . . .  .    .   ....  ... . .         .     .    . . ..       . .  . .   .  . . ..    ..
.. ..    ..  .   .. ..    .          . ..     . .     .   ...   .. ..   .... . . . . ..  .     .   ... ...  ..    .    ..   .. .   ...              .      ..
.  ..    .     ..  .   .    .. ... .     .    .  .     ... .   . .       .      .   . . .   . ...  ... .     . .   .    ..     .  .       .  ..  .. ..  . . .
.     . .  .          .  ...  ..   .   ..  ..    ..    . .    . . .   . .        ..      ..   .  . . .  .       . .  . ..      .         .      .  . .   . ..
.       .      .   ...     .     .  ...     ... .    .     .    .   .   .. ..        ..  .    .. ....   .          ..     .    . . . . .        ..       .  .
.           .     . .  . ..  .                . .. . .    . . ..  .. ..  .  ....    .. ..  .      . . ...  .         .      ..   ... . .     . .    .  . .  .
.  .         ..   ...   . .  .    .   . .   . .     . .     .. ..  .  .  . .    .     .   .. ..   .       .     . ..  .            . . .   . .. . .   . .. ..
.        .  .             .. ..   .   . .  .  .    .  .. .  . ..          . .... . . .   .. .   .. . . ..         .      . . .  .    .          .  ..     ...
..  .    .  ..     .  .     ... .  . .    . ... .       .    . .. . .          .       . . .. ..   .. . .   . ..      .  ...    .  .              . ..     ..
.  . .       .  .    ....   ..        . .. .  .. .. ... .     ..  .  . . .   . .     ..     ..  .              ... .    ...  .    .    .    .    .     ..   .
. .  .   . ..   ....      . .      . .    .            . . . .    .       . .   .  . .   .   .  .   .... . .....  ...    .   . ..  .. .           . .   .   .
.  . .    . ..     .    .  .  . .    . . . .       .    ..   .. .  .          .  . ..    . .     .    .             .. .  .     . . . .  .   ...  .     ... .
.  .    . ..   . ..     ..  ....   .    . .  ..  ...  .  . .        ...     ..   ..   .  .           ..      ..      .   .   .  .                .       ....
....        ..    .  .. . .      . .   .     .     .. .  .   ...   .   ...     .     .... ...   ..       ...  .   ..    .. .. .     . .    .   . .  .    .. .
.     .    ..   .  .  . .  .   .   .  .       ..  . . .  .       .     .     .   .    .  .  . .  .   ..     . .  .        .  . . .    .       .   . . ..    .
. . .          . . .  ...  . ....  . ..      . ...  .. .     .  .   .   ..  .. ..  .. .  .     .    . .....     . .. .     . .    ...  .  .    .    .... ....
..      .....   .  .      .     ..   . . .    .   . . . . ..        .     ..      .. .        .  .  .  .       .    .  .  ... . .   . .  . .  .. .. .. .  . .
.  .  .   .     .  .       ..           . .. . .    .  . .     .    ..  . ..  ..     .    .       .  ..  .  .     .  ..  . .  .      ...      .  ..  .. . ...
.        .  ..   .     .  .....    .   . .     ..  .    .     ..            .  ..         ..     .            ... ... ..  .         . .               ..    .
.        ..   . . .     . .   ..  .  .  .    .   . .   ..     .  .   . .. . ... ...   .      .  . .    ..   ....    .    .  .   . . .        .      .   .   .
. .     .         .. .  .  . ..     ... ....   .   .          .......    .     ..    .  . .   .      . .. . . . .  ..        .  . .   .  ...       .. . .....
.      .   .     ...  .  .   . .   .. ....     ..      .       .. .   ... .  .  .. .        .. .   .     .    ..          .   ..  .     .. .     .   .....  .
.                .  .  ...   .  . .      ..   .  .   ..  .    ..            .. ..   . . .. ..     .    . . .  .   . .       . . .... . ..  .  . .  .   .    .
..    ..           .. . . . .   . .  .    . . .  . . ..            . . .       .       .   . . .    .  . . .  .     .  .. .      . ..     .   . . ..        .
.  ..  .. .    .      . .. .. .       . ...     ..  .  ..     ... .    . ...  .        . .       .     . ..        ...   .    .. . .   .      .  ...  . .   .
. . .  . . . ... .        ..    .   ..        .            .. . . .         ..    .        . .   .        .    . .  .       .   . ..  ..     .. .. .        .
.          .  .    ..       .      .    ..               .   .  .....          ..    .. . ....    .   .      . ... . .       ..     ...   ..      ..        .
.   .. . ..   . .     . ... . .  .     ... .    .        .       .. ..   . .   ..    ....      .. .  . .       ... .. ..     .   .      . .         ..   .  .
..  .       . .   .  .     .   .   .  . .. ..                   .  .  ..  .     ..          . . .      ..  ..  .       . .           .       ..      . . .. .
. .            ..     .     .     ..    .          .      ..  .     .         .      .  ....        .   .    . ...   .  .  .. .         .  .  . ..        ...
. .   .... .  . ... .  ..   . .. ..  ..   ...    .    .    .. ..    .   .    ..      .....   .  .   .  .   . .   ..   ..           .   .  . ..   . ..   .   .
.  ... . .    . ..  . .. .   ..  . .   ...  .   ....  .    .     .  .  .    .  .. .      . .  ..  . .  .. .  .   . .      . . .  . .  .       . . ... .     .
.   ..      ...     . .. . .   ...     . ..  .        .  ...   .. .    . .  ...  .  .  .   . .   ...   ..   .      . .. . .  ..   .  .    .         . . . . .
..           ..        .    . .    ..  ..   .   .  .  .    .   .    ....  . .        .. .     ..  .  .     ..     . .   .  .        .    .    .     ....    .
.   .. ...  ..   . .     . .           .           .  . . . ..       . . . ..       .         .. . . .     . .. .   . ..       .  .      ..    . .  . ..  ...
.  .       . .   .      .    .         .        . .     .  . ... .         . ..   .. .          .   .. .    .  .   . .....  . .. .. .   ....    .. ..  .... .
..         .      .       .  . . ..     .    ... ..         .. .  .. .         ..  ..  .   . .       .    .  . . . .      .     .   .. .          .        ..
.  . .  . .  .            .    .   .     ..   .  .     .  .  ..      .     . . .    .. .  . .. .  ..        .        .    . .         .  . .      . . . .  ..
.  ..       .      .  .  .  .   .        .        .    . ..            . .      . .    ..        ..      ...          ...       . .         .    .. .  .    .
.     . . .. .     . . . ... .    . . .  .   .  .             . . ..         ..    .        .   .   .  .  . . .  .   .        .    . ..    ... .  ...       .
. .    .     .   ....  .    . .       ..                 .   .  .  . .... .    ... ..  ..   .           .   .     .  . .      .    .  .            .        .
. ...  .        .          . .         .     .. .  ..  ..    .. .  . .. ...    .    .         .       .    ...             .  .  . .     .  . ..   .   .    .
.     . ..  .    .    .  .  .  .. .   .        .   ..  ......   ..       ..       .   .    . ..  ... .         .  .  .       .   .  . ..    .    .  ...     .
.. .      ...   . ..  . .  ..       .   .  ... . .     .    .    . .  .   .  .  . . . . .. .  . .      .   .   ..  .  .  ..   . .       ..     ..  ..  ......
.  ..  .... .   . .   ... .  .  .  .     .. .   ...  .    . . .  .  ..  .     .  ..     ..  .   .     .  .          . .  .  . ....      ..  .. . .    .     .
.     .  .  .     .. ..  ..           . .     .         . ... . .  ..              ..    .   .       .            .  ...   .    . .  .   .   .  .  ..       .
.  .... .    ...  ....  ..   .   .  .      . .   .                 .   ..           .   ..     .  . .. ..    .     .. .     .     ...    .. ....  .  .  .   .
.     .     .  . .         .        .. .   .  .   . ...              . ....    .  . .. ..   ...   . .   . .   . ..        .. ..       . .        . ..   . ...
...  ..     .      .    .   ..   .  . .   . .      ..   .. .    ..  . ....   .   .   .       ..    .   .    . .          .   .      . .       ..  ..       ..
..      . r. .    .   .. ...        .  .    .   .  .. ...     .     .      ..     ..   .  ..  ..   ..        ..  .     .  .    .. . .   .   . ..   ..       .
.  ... .   .      .  . ....     . ..   .    .. ..   .  .     .   . . . ..    . . .. ..  . .     ..   ..      .     .     .. . .    . .        .    .   .    .
..   ......  .  .    . .  .    ...  . . .  . ..    .       . ..  .  .    . .   .  ..   .  .. ..    ..          ..    ... . .    . .   .   .   ...       .   .
.   ... . .  .    .     .      . ...  .      ..        .        .   . ..  .     .    .   .    . .   .   .     .   .  ...    .       .   ..      .    .  .   .
. .     .    ..   .  . .      ...  .  .  ..      . .. .   ..    .        ..  . ...     .  .      . .    .        .   .  .           .. .  .   .  ....       .
. .    . .    . .   . .  ...  . . . .. .     .             .  . . .          ..   .. ....          .   .    .. .. .   .....           ..       . ..   .  . ..
.   .        .           ..    .  .  ... .     ..  .      .          ...  .   .      .   ..  . . .  .      ...       .    .       .    . .. .    .          .
.   ....   . .  .       .  ..   .  .      ...   .      . . .     .     .   ..     ..            .      .     .                  .....       .      ....     .
. .    . .      .            ... ..     . .  .  .  . .       . ..   .    ...       ..  .      ..    ..    ..  .          .. . . .         . .  . .    .    ..
.  .  .   .. ...         .     .          ...          .       .   ....     . ... .       ..  .. . . .  ..    ..  . ....     .    ...         ..   .    .  ..
. .. .  ..  ..  .. .     .   .     . ..  . . ..  .     ..       .    . .            .    .  .       . . . ..   ...     . ..   ..  .              .       .  .
.    .     ....   ... ..    ...     ..  ..  .   ..  ..       ..   .    ...   .... . .  .. .     ....      .  . . .      .  .  . .. .. .   .  . . ......     .
...  .       . . ..         ..  .. .. .       . ...  .... .  . .      .  .  .   .  .   .   .     ..    .. ..   . .    .      ..    ..   .   .  .    ..      .
. . ..   ..   .  .              .      . .        .  .   ..... .   ..   . ... ...    .   . .  ..   .. ... ..   ..        ..    .    ...  .. . .       .. .  .
.   .  .  . .   . . .  . ..        . ...    .  .              .   ..      .    . . .  .   .         ..      .. ..   .  ...             . ..   .  .      ..  .
.  ....     .    .   .   . .     .  .   ... .     .      ..      . ..       .  .... .     . . . . . .      .   . .     . . ...     ....   .     ..  .  . .  .
. .    .   .   .  .  .     . .  .  . . .     .   ...   . . ..  .    .     .. ..... . .     . .       .. .            .    ..     ..  ...     .   . .  ..  . .
. .  .     .  .  . .. .   .   .   . ..       ..  .  .    . ..  .  .    .. .  .    ... .  . .     .     .     .  .      .....  .       .     .      . ... ....
.       ..   .   . .   .  .  . .     . . ..    .. ...   ...            ....    ..    . . .      . .   ..      . .   . .  ... . . .    ..     . .   .. . ..  .
.     . ..  .   .     . .  .   .     . .   ...   . .  . ..         . ..     ..      ...  .  .        .     ..   ..        ..... .    ..... .         ...    .
. . .... .   .    .  ..   ...   ..     .. .           ..    ...      ...     ..      .     .  ... .    .       .        .  .    ..              ..  .    .. .
. .. ..    . . ..      ..   .  .   .    .   .  .   .. .    . ..  ..    ...  . .  ..    .       .  .     .       .  . .   .    ... .    .     .    .    .  ...
.     . .   .        . ... .  .    ..   . ...  .  .     .    ..       .      . ... .  ..  .   .   . . .           . .. .          .. .  .      .. .   . . . .
.  ..      . .  .  . ..  .         .. .  .  .      .... ..       .    .   .. .      . . .     .. .     ......    .. .  ..  .. . .   .    ..  .            . .
.        .  .      .  .  .          . .       .... .     .   .    .    .  ....    .      ..  .     .  .     .  . .    . .       . .    ...  .    ...    .   .
..         . ..       . ..     .  .      .     .  .  .    .  .   .      .....   . .   . .   .   .      .    .    .. .  ..  ..   . .  .    ...  .      .     .
.  . .  . .  . .    .   .  .         .. .  ... .. .  .     .... .  . .. .       .      .     .      . .  . .  ..   . .  ..  .  .     ...  . ..       .  ..  .
.  .    ..         .    .   . ...      .        .       ..  .  ..  ..     ...  . .     .     .. .. . ..   .. .  ..   .    .....  . .    .        . .      . .
.   .    ...  .     .    .   ...  .      ...         . .    .  .     .. . ..  .. ..         .   . ...  .    .  .   .   ..   .     . .                .     ..
. .  .   ..   . .              . ...     ..   .         ..  .   .  .    . . ..   . ...  .    .           .    ..  . .                      ... .  .         .
..    .     . .     .  .        ... ..   .  ..   .      . ..          .. .         . . ...   ..       .      .      .       .     .  ..      .        . .. ..
.............................................................................................................................................................
