..............................................................................................................................................................
. . .     .     . . .. ..    .. . .... .. ..         .. ..   .          .         .      ...  .  .  .   . .      .  ..    . .... ...   .  . .   .  . . ..... .
.          .    .   ......   ..         . .        ...   .       ..  ..            .....  .... .   .    .. . . .       .   . . .   .           .  . ..  . .. .
. .           ..   .   ..  .  .   ...    . .   ..          .     .   .  ..  . . . .    . .        .   .       . .. .   .   .  .. . ..       .        ..  .....
. .         .. .  .    . ..   ..      . ..      ....    .    ..  ..     .  . .    .    ..   . .        ...  . .          ..     .      ..    .   ..   .    ...
.    .      .         .    ..      ..      .   ..   .  .   . .     .    .  .    . . ..  .    .    . . .  . .     .    .       . .    .  .        . .    . .  .
.   ...   .. . . .    .     .. . .  . ..  ..     .    . .  .   .     . .  ...          .. .    . .      .     .       .   . .    .     ..  ..      .     .   .
. ..     .  . .     .   . .  .   .         .  . ..   ..    ... .  .            .... .           .  .   .  ..  .. .  .        .   .. . .     .  . .    ..   . .
.. .  .  . . ..   .. .     .           .    ..    .  ... .    ..     .    .. ...            ...   ... .   .. ... ..    ..  .     ... .  ..      ...  ..  ..  .
.  ... . .     .    .  .       .     .  .  .   .           . . .....  .  .    .     . . .  .            . . .        .           .      .   . . ....      .  .
.    .   .  .   ...  .   ...         . .      .            . .  .     ..  .    .    ..  .       ....... . . ..   ... .. .  .  ... .      ...   . .         . .
..   .. .. . ... . ...     .     .    ..     .           ..    . . .    .. .   .        .    ..      .    .         .  .    .     .    ... ... .     ..   . ..
..             . .  .   ... .   .   .         .   .   .        .   .  ..  .    .      ..  . .  ....  .   .    ...  .  . . . ...      ..       .        .  .  .
.   .   . .   .     ..   . .      ... ...  ..   .   ..    ..  .   .  . ..  .         .   ..   ..                     .  ....  . .   .  ..  .    ..   .   .   .
.     .    ..    . .. . .   .      .  ..     ...               .    .  . ..   .      .  .       ..  . .    .  . .   ..         .   .  .    . .    .    ..    .
... .  .  . .   ..  .      . .   .    . . ..  .     ..  .  .  . . ...     .      .        .       .        ..  .. .   .   .     .  .. .  .  ..             ...
. ..   . .  .       .  ...       .   . .  .. ...  . . .  .     . .     . .     .     .    .. .. .     .   .     .  ...  ... ... . ..      ...    . .  . . ....
. ... .           .  .    .  .  .  .  .   .      . .         ..  ...  . .  . .  .         .. ..       .         ...  .    . .  .    ..        . ..     ...  ..
.       .        . .  . . .  ..      . ..    ..             . . .         ..  ....    .       . . .  . .     ..    ...            . . ..  .         .        .
.  . .  . .    .   .   . .   .    .   ..    . ..      .  .     ..      . . .    .           . ..      ..           .   . ..    .   .      . .. .     ......  .
.   ..  . . .  ..  .    .      . .. . .   .. ..   .. .   .  .  .     .  .. .   .   . .. .  .       .   ..         ..    . ...        .   ..        . .    .  .
.     .   .    . .  .   .  . ......      .        .  ..    .   .. .       .   . .   .    .   .     .. . .   .  .               .       .    .   .  .  .. .....
.       .   .         .   .             .  ...   ...   .   ...      ..  .. ..  . . ..     . ..      .. .. .    .    ...  .. ..   .    .            .      . ..
.  ... . .   .             ...  .     .  .  .    .     .  ...  ..       ..     ...   .   .. ..    .. .      . ..     ....           . .  ..      ..   .  .....
. .    . .      . .  .    .  ... .. .          . .     .. . .. .     .       . . . . .. ... .      . ..      . . .   .   .  .  ....     ..     ..      .. .  .
..          .  .        ...      ..   . . . . . .   ..   .  . . ..  .       . .      . .    .     .              ..  .  .  .   ..     .  . ...   .  .    .   .
.       .   . .. . ..   ..  .    ..   . .  .. .    .... ..      .          .   . .  .  .... .     .     ...         .     . . . .         .   .    .. .   .  .
.   .  . .    .   .  ..   .      .    ... .    . .   ...  .   ..  .   .  . .  . .     ..                  .. . .        ..          .          .    . ..  . ..
..     ..   . .. ..  ..   .        ..   .   ... ... .    .  .  .     ..   .   .  .     .   . .  ....      ...      .  . .. ...      .      .  . .           ..
.     ...  ....  .  .      .    ..        ..   ..     .       . .    ..  .    .... ...  . ..   . . . .   ..  .    ...  .   .  . ....      .       .. .   ..  .
.   ...       ...         .      . .  .. .  . . . . . . .   ........ . .   . .       ..      .    . .  ..    . ... .           ..  .  .  .  .      ..     .  .
.     . ...    .  .    ....     . . ..   .  . .   .             ...  .     . .. .  .          .     .    .     .      .   .  .  .  .   ...  .   .        . ...
. . .  .  .      .                   ..    .         . ... .    .    .     . .  .. ... .  . . .   . ....  . .  ..  .     .  .           ..   ..  .           .
.    . . ...  .     .    .. .  .  .. .   . .    ....     ...   ....        .    . .   ...... . .         .                  .  ...       .         .  .  .   .
.  .    .. .    .   .           .  . .       .     ..  ..  ..  .   .   .  ..      .   .  .   .. .   ..  .  ... .   .. . ... . . ..  ...   . . .   .      . . .
.   .. ..   .       .  .      .   .    . .  ..           .                 .   . ..    ..  . . .  .        .. .           .. .   . .    .   . .    . .   .   .
.....        .  . .  . ..        . . .  .   . .... .       .     .   .   .  .  . .     ..  .    .   . ...     .   .   .  ..     ...     .   ...    .       ...
.      ....   . .       .        ..   . ... ....  .   .  . .  .  .       ..   .... .   .    . .. ...   . .       ... . ..  .  .         .. . .  ...  .       .
.. .  ..       .....      ..       ..  . .. .          .   ..      .    .    .    . .. .....  .           . .    .  ..  .. .       .  ....    .   ... ..  .  .
.     .   ..        .  .. ...      .  . . .         . .  .    .  ..  .. ...   . .             .. ..      .. .  ... .     . .     . ..      .    . .          .
.  ...  .   . .  . .    . .   ..  . ...  ..     .  ...               . .    ..  .                 .     .    .  .  ..   .  .. .         . .       .  ...    ..
.     ....   . .   .  ..   .  .   .    . .     ..... .    ..    .    .          .    ..         . ....  ..   .              .      .     .. ..   ..    . . ...
.   .  .   . . .. . ...  .    .  .    .  . .  .   .  .. ...  . ...  .   .. .  .   ..   .. .    ... .     .  .    .....        .. . ...                .  .   .
.  .    .       .            .        .   . .     ..   . ..     . .  ..     .    ....  ..     . .. ..   ...  . . .   .  .        ....  . .     .      .  . . .
. . . . . ..        .  .           . .      .   .     ..   .     . . . .      . . . .  .    .   .  . ..       . . .      . .. . .  ..        .      ..  ...  .
. . . . . ..      ...      . ..    .. . . .    ...   . .    .   ..  . . .  .         ... .  . .  .       . . .   .  .     .. .      .  .     .    ..     . . .
. . . ... ..    .  .   . .      .. . .      . .           . ...    .  ..   .     .        .. .     .    .         ..  ..    . . ..         .             .   .
.  . ..    ..       .....  .  .          . ..   .  .  .. .   ..   ... ... .    ..   .          .            . .    ..  .  .         .   .... . ..         .. .
...    ... ..  .  ...    ...  .   .. ..  ..     .  ..... .      .  ..  . . .  .   .  .   ..  .. . ..          .       .      ... .  .    . .  .      ..   . ..
. .....     .       . ...     . ..     .    . .. ...      .      . .      ...    .  ...     .  . . ...   ..       .   ...      .       .    .. .. .  .  . .  .
. .    ..           . . .     .  .     . . . . .. .    ... . .  .    .         .  . . .  .   . ...       .  . .    ..       .   ..   .         .  ...      . .
. .    . .  . .  ..             . . . .   .. ...  .   .  ..  .  .  ..    .  .  . .   .    .  . . .             ...     ..  .         ..    .   . .        . ..
.  . . ...  .. .. .. . .  .  .           .    .       .   .. ..  .     ... ... .....     .   .. .    .     .  .    .. .. . . .     .         . . . ... ...   .
. ..    .. . .   .  ..           .   . .  .    .  ..   .        .       .      . .....  . .. .      .     .       . .. .     .   . .  ..      .  .    .      .
.    . ..   .  .  .    .  ..  .  . ..  .                    ..       .   ...       .       . .  . . . .  . . . .  .        .     .. .    ..                  .
..     .   . .  . ..  ... .   ..        ....          .   .         . ...  .      ..  .  .     . .      .       .    .  ..  .  .   .    .   ..  .   .. ..    .
.     . . .. .                   ..   .. .    . ..  .  .     .     ..   .         .     . .   .  ..     .  .    .   .   ..     . . .     . ... .    .. ..   ..
.   .         . .  .      ....      ... ..  . .         ... .  .     . .   .   .  ..  ..     .      ....         ..   .   .               .       ...        .
..   .    .       ..  ..          .     .  .  .       .    .    .   ..     ..      . .   . .   .         .  .     .   . ..   .. . .     ......  .  .      .  .
.  ..  .   .   .       .           ..       ..    ..    .  . ... ...     . .   . .     .  . . . .  .....   .         .         . ..      .  . .. ... .  .  . .
..  ..    .  .   .  .    .        ..  .             . .    .   .  .    .. . . .    . ..    ..       ..   . ..   .. . .       .       .   .  .     . . .   .  .
. .  . . .. .     .  ..   .      .       .    .    ..    . . .   . . .   ..  .. .  ....        .  . . .  .  .. .  .. .         ...   . . . .   .    ..      ..
. .        ..    ...      . ... .   . .     . X  .     . ..  .  .....     ....          ..      .    . ..   .     .   ..     .    . .  ..            ... . . .
..       . .  .     . .  ..    . ..    ..       .   . ...        . . . . ....   . .    .  .     ...  . .      ..        . .     .  .  .  .         .   . .   .
.... ..    .    ... .  . . . . .  ... .  . . . .   .  .  .   .   ..  .. .       ..   . .   .  .      .  .    . ..           .  ... .       .          .  ..  .
...     .          . .    .   .  ..     .   ..  . .   . .     .   . . ..   .    ....         .   .. .      .  ..  . .    . .   .      .. . . .     .   .     .
..           ..  .          .. .   .  . . . ..     .   .. . ..  . .      .   . .  . . . . ..   .   .  .   . . .                   .   .  .  .  .  .  ..   ....
.....    . .  ..  .  .       .   .      . ..       ..   . .  .  . .         ....   .. . .. . .    .    ..      .     .  .            . ..  . .  .   . ..  .. .
.   . .          ..   .  . ..     .   ...         ..     .  .. .  .     .  . .  .       .   ...       ...      .   .   . .      .    .       ..   .. . .  .. .
...   . ..    .    ..   ..     .   .    .   ..    .         .     . .       .   .  ... ..   . ..       .  .        .. .. .   .      ... .... .   ..   . .   ..
.        ..      . . . ..   .     ..    .  .    . .  .         .     . . .    .        . .  ...  .  .        .     ..  ...        ..         ..     . ..   . .
...  ..          .    .   ..      . . .     ....   .   .   .    . . .. .         .. ...  .. .       ... ..   .     .   ..         .    .     ..  .. .   .  ...
. ...  .   . ..         .      .   .. .   .     .    . .  .  .      ..   .             ...     ...    . ..... ..       ..  .                           ... . .
.    ..       .  . ... . .     .      ..            .  .  ..      ..    . .  .. .  .  ..    ..  . .   .. ...     . .                .    .  . .    .   .     .
..       .  ...   .. .  .     . .  . ..          ..  ..   .     .      . .   . . ..      ...    .    .    ..         .     ...   . . . .      .     .    . . .
... ..        .   .   . .     ..      .. ...    .      ..  ..     .    ... .  .  ..   .  . ..  ....   . . . .         .    . .    . .    .    .  . .  .  . . .
.  .   .  .    ..    .  ....       . .      .     .     .         .....  .         . ..         ..       .       .          . .   .    ..  . .  .        .. ..
.  ..  .. ..  . .     .   .. . .    .    ..     . . .. . .  .  ..    . .        .   . ....  .   . . .   .    r .    .     ..  ..   .  .     .. .    ..  .  . .
.       .    . .    . ..    ..       . .   ..     .....  ..      ..  ..  .     .     . .     .  ..     .              .              .       .      . . ..   .
. .  .. .  .       ..         . . . .      ..  . .  .    .      ..  .    . .       . .    .    .  .          .   .    .  .         .           .    .   ..   .
.  ...   ..     ..   .   . .. .     .   ..  ...     .. . . ..  . .   .   ..      . . . . ..        . . ..      ....   . . .      ..   .... .   .       .  .. .
..    .  . .   . ... ... ..    .       ..    .... .      .....       . .         ....   .  ..   . .. ..   .   .      .  .    .        . ...         ...  . . .
. .    ..   .  .  .   ..      .  ..       .   . .       . .       .  .. . .    .        .. .       .      .      .    .  .    .         .     . ....  . . . ..
.        . ..     .     . ...   ......    . .     .  . .  . ..   ...  .  .. . .      .   .       .        ..         ....        ...    .   ..       .    .  .
.....   .  .....   .   .    ..  .       ..    . ..   .         ...     .   .. ..  ..    .   .    .  ...       .   . . .      ..       .       .       ..   ...
.     ...  .. . .   .     .  . ...      .. .  .    . . ..     .. . .   .. . ...    .  .  ..  .       ..  . .       .   .   .     .. .       ..   .     . .. ..
..  .   .   .   ..  . .     . .....        ..  ..   .  ....  .    .   .    . ...  .               .  .            ..   . .        ..  .  ..    .. ... ..   . .
. .  . .         .  .   . .   .         .   .     .  .  .      .  .     . ..  .  ...  .    .       .        ..     .   .  .        .  .   .     .  .  .  ..  .
...  . .   ..   . ..   .      .     .         . . .  .    .   . .. .. .  .  ..    ..   . ... ..   ..    . ..  .  ..         .     .   ..      .       . .   ..
.. ..  . .      ...  ..  ...    .   ...      .   .    .       .    ..      . . ..  .  ...   .  ..  . .  .      . . .    . .  .  ...   .  .      .. .     .   .
..   ...   ...    .    .      ..            ...    . .    .    . ...   .      .     . . .   . . . .. ..    ..  .            ...              . .   .  .  .   .
.        .    .   ..     .    ..  ..   .  .        ...    .   ..   .   .     .                 ...   .    . ..  ...      . . ..  ..     .     .   .  .      ..
.. . .   .. ..   .  .   . ...       .. . .    .    .  .  .  . .  .    .     . . . . ..   . .         .        ...   .. .   ..     .  ..    . ..   .  . ...   .
..     .          ..     .  ..   ....      ... ..  .   .          .... . .  . .       .      .. ..    ..  .     . . .. .          . .    . . ....   .  .   . .
.     .     .           .  .    .      . .. .         .               .      .    .     . ... . ..  .         .. .  .    . .     ..  .       .       .  .    .
..   . .      .        .   .     . .       .     ..       .  . ..  .       . .      .       ..     .. ... ..           . .  ..        .       .....     ...  .
.          .   .  . ..       ..   ..       .  .  .... .  .      .   .           .   .          .         . .  .      .. . .. . .  .     . .    ..  . .       .
.     .       .     . ..       ..  .    .  .    .         .  . ... .    .. ..  ...   . .. ..  ..   .  .    . .   . . . ..              . .    .     .  .   . .
...    ..  ...  .. ..               . .    ..           . .        . ..      .  .  . ...  .. .   . .     ..    .            . .      .. .    .    .    ..  ...
.  . ..     .  . ... . . . .   .   .      . ..  .     ..    .. .           ...  .    .    . .  .. .   .  .   . .     .   .  ... .  .  .....     .   .  .. . ..
..    . ..    ....    ...       ...   ....    .      .     ....   .  ..  .. ..    .      .   . . . .   . .   . .     .  ..    .         ..     ...  . . .... .
.   ...     ..  . .   .  .  ..   .       .      .  .. . .   ..   ..    .       .    ..  . .     .  .     ..    .   .        .      .   ..  .         ..  . . .
.       . .      . .  .                     ..... .  .    .   . .  ..    ..      .   .      .   .  .      .    .  .   .     .  .    ... ..         .    ..   .
. .. .   .. ...  .         .   .. .  ...    ..       .. .  . .              .. ..  .   . ..    ..  .   .. . .     ..                  .     .. .. . ..    . ..
...     ....        .  ..    .   .  ..  .. . .. .  . .     . .  .    . .  .   .      ..          .                 .. ...   . .  .   .   . .         .      ..
..  .         ..       ...  . .....   . ...   .      .      .     .. .  ..    . ... . ...      .   .         . . . .   .   .    . . .  . .  .. . . . .  .    .
.     .  . .          ..        ... .  .. .      .     ..... .. ...... .     .  .. ..    . . .      ..   .         ..  . .        ... . ...  ....    .   .   .
...      ..     .       ..    . .  . .    ....    .   ..        .  .... ..       .      ...    . .   .     .  . .    ..      .  ... ..               ..  .. ..
.  ..      . .  ..      .                .     .. .   .     .. . .. ..  .   .   . .   .    . ..  .     .. ...  .    .  .     .  ..   . . .  .  .       .. ....
.. . .       ......  .  .. .   .. . .           . .. .      ..    .    ..     .      .          ..  . .. .. .   ....     .... .. ..  . . .  ..   . .    .    .
.... .   . . .     .  ...        . .   . . .  . . .       .      .  .   ..       . . . .      .....   .    .. .   ..    ..        ..  .  . ..     .   .   .  .
..  .      .        .  . . .    .  ....  .  .  .       .    ...         .   ..     .. .       .    .       .    .      .    .         .        .     ..      .
..  .    .   ...    .    ..                .  .   .   . ....    ....     . .   . ... .   .... .  .. .  .     .    .      ..  . .  . . ..    ..            . ..
.   ... ..      .    .  ..   .   . . . ... . . .  ...       .     .   .  . ....  . .    .    ..  .      .       .. . ...   .... .   . ..    . . .  .  ..  .  .
.  . .. .    .  .       .       . ... .                 . ..       . .        . ..   .        .  .   ..   .. . .  .   . .         .     .  ..          . . ...
. .... .    . ....  .          . .     ....     .           .       . .        . ..      . ... .        . . ....  .                .. .       .  ...  ...   ..
. .      ..  .    .    .  ..         .   . . ... ..      . .     .  .  .  .   .  ..         .. . .               .         .  . .. .   . ...  .   .        . .
.        .    . .   ..   .. .   .  .      .      .  .      .        .  .. . .. ..  . .. .        .  . . . ..  ..  .    ........ . .   .     .   .   ..   .   .
.       .... .  .. . .    .    ..  .  .    ..         ...    .   ..    .   .   ..  .   . . .. ..    .  . .     .                     .. ..      ..   .. . . ..
.. .    . .       .     .. .  .     ...    ..     .  .   .     ..          ...    .  . . . .        . .  . ...   .  .   . ....      . ... .  ...  .. .       .
.  .. .  .   .      . .  .     .  .. ..    . .  ..   .  .         .      .  .     .   .          .. .. .. .  ..   . .    . ... ..   ...     . .     ......   .
.    .      . .   . .   .      .... ..     .. ..     . .  .  . . .  .           .  ..   ...     .   .   . .....        .           .       . . ...    .     ..
..       .    .            .  .        ..      .      . .      .  . ..    .  .  .  ..      .. .. ..    .         ...  . .  .  . .. ..   .    .      .  .    ..
....    ..    .   . .  .  . .  . .  .   .  . .    ..  ..         .       .. .  .       ..    .....             .. ... ...     . . . . . ...         . .  . . .
.  .    .           .  . .    . .   .          . .  . . .   .    . ....  ..    .          .    .              .     .             ...   ..  . .      ..      .
. . . .   ..  .. ..  .   .   .     .. . .. .  .   .   .     .  . .        .    . .        . .  .  .  . .    . . .  .  .      ..       .  .. ... .        .  ..
.    . .   .    .  . ..   .. .      .     .   . ..  ..   .   . .  .. . .      .    .     ..        . .   . ..  .  . .   .    .        ..     ..   ..      .  .
.             .   .  . ..   .. . .  .... .     ...  . . . ..      . ...    .. .   . . ..   .  . . .   ..         .   ..    ..  .   .    .   .     ..  ..... ..
. .  .. ..    .   .   .    .. .   .... .      ..   ..        .  .       .  . . . .    . . .. ..  ..  ...      .   . .   . .      .   .    .     . .       .  .
.    . . . .   .        .    .        . . ...  . .  .    ... .        ...   .. ....        . .  .  . . . . .    .   .     .    .   .  .        . .   . . .  ..
...  .  .     . . .  .    . . ...   .       .    .       . .    .   ....   .     .  .  .    .. .   .. ...    ..  . ..  .   ..   ....  .  . .   . .. . . ... ..
. .     .   . .       . ...    ..  . ..   . .  . .  . . .   .     ..  .  . .  .      ..  .  .    .             . . .  .     .     .  .  ..    ... .    . .  ..
.     . .    .             .  ..  . .  .      .      .  ..  ...    ..      . .. .     .  ..             .. .  .          .         .  .   .   .  ...  .   .. .
...  .      .      .      . .. .  .    ..  .   ..       . . .   ....  .      ..   . .         .  .    .   . .  . .     .   .    .    . .    ..   .  ...      .
.     . .     . .  .  .          .      .   .  .  .   ..   ..  ..        .     .    .    ..         .        .   .  .  .  .                    .   .  .   .  .
.. ..    .        .  .   .  .. .   .. .  ..  ...            ..  ...         .     .      ..  .    ..   .    .     ..  .   ..  .  .   . .     . .   . .. .. . .
.      ..        .  ..     ...     .   . .       .   .. ..  ..   .     . ..   ..  .   .      .. . ..     .. . . . .          .   . .  ..   . .        . .    .
.       .   .  .    . .     . . ..    ...  . .        .  . .    . . .    .                   . .  .         .  .. . ...  .        .    .     ..   .  ....   ..
...          .     .        .    .  .. ..  ..   .  .     . ...  ...           .  .   .               .     ..       .   . .    . . ..   .    . .          .  .
.   . ..        . ...  . ....      .   .   .. .   ..    ..      ..  ..  .... ..   .   .       .    ..  . .   . . .    .   .          .         . ..     .    .
.      .  .   ..   .       . ..  . .. .         ...  . .   ..   .       ..      . .  . . .    .    . .      . .. .            .   .    . . .    . . .   ...  .
..   ..   .. .  . .     .     .   .   .    .  .   .  .   .     .   .    ..          .      . .. ..  . ..  . . .           .       .  .    .  .   ... ..  .  ..
..       ..     .    .  .  .   ..   .      ..   ...      .  .       . ... .   .   .     .  .    . . ..  .   .      .     .  .       .  .. .   ...    .     . .
. ...          . . .    . .   ..  .       ..   .    . ..     .        .   .. .. ..      .     .  .   ..  . .     .   .  .. . .       .  ...   .         ..  ..
...    .         . . ..  ... .   .  . .         .  .  . .       ... .          .          .   . .. .        .   .     .            .  ...  .     .       . ...
. .. .  .  .    . ...  . ..   .  .   ..    .. . .     . .      .     ... .    . . ..    ..   .  .    .   . ..      .     .      . ..   ..    ..    .      .  .
. .  .   . ..  .    ..   . .  .   .   .   ... .      ..  .. .  .       .    ..    ..   .    .      . . .            .        .. . .        .  ...    .  .    .
.. .  . ..     .             . ...  . ..       .  .    ..   .  ..  .   ..     .          .         .   .   ...  .    . .. .      .           ...        ..  ..
.  .  .    .      .   ..   . . .. . . .   ....        .            .   .      .  ...   . ..    .. ..       ..  .. .  .         .      .     .. .   ..  .  ....
.  .   .    . .  ... .   .       ..       ...      .  .   .   . . .  .    ..      .   . .    .  . .   ..   .             .. .       .  ..     .  .   .  .    .
. . ...  . .        .  ..    .             .    .. .      ...       .    .    .        .  . .    .   . . .      ..   .  .  .        . . .          . .      ..
..   .          . ...  ..  .  .... .   . .  . .  . . ..               . . ...  . .    .. . ..     . . ..     . .   .     ....   ..    .  .   ... .        .. .
...    .. .        .   .     .   . .    ...   ..  ... . . ...  ..             ...  . ..     . ..     .   .   .   . ..    .  .   .          ..    .    . .    .
. . .. .  .  .  .  ..   .    .    . .    . .. .    .   ..     ..   .   .     .  .      .   ...      .   . .     ...       .   . ..  ..  ...    ..       . .. .
.    . .    . . ..  .. .   .    . ..      ... .     ..  . .   .  ..  ....    .    ..     .    . .   . . . . .       ..     .   .. .  ..   .   .   .     . .  .
..    ..          .   .    . ..    ..        .          .  .  .    ..       . ..   . ..   ..    ..      .   .        ...  . ..    .     ..      .          . .
..  .    .  ... .   .   .  .. .       .   .      ..     .   . .   .  .... . .    ..  .. ...    .   .           .      ...  .   .  ..    .   .     .  .       .
..............................................................................................................................................................
