...............................................................................................................................................................
..     . . .  .     .    .  .    ... . .       .     .  . . ..   . ..      .. .  . .     .  .   ..  .  ..   .           .  .    .   .   .   . ..       .  .   .
.        ... .. . . .  .  .  . .  .. .         . . .       .   ..    .. .          .  .  .   .  ....     . . . .  ..   .    . .    .        .   .      .      .
.  ... .  ....         .     .          . . ..    .  .    ..    . .  .  ..     . ...  . ..    . ..    . .  .......    . ... ..     ... . .      .   .. ..   . .
.   .    .    .        .   . .   .  .     .     . .  .   . . .    .  .    .         .        ...   .   .  .   . . . .   .   . .. .         .  .. ... .   .   ..
.        .. .    .             ... .    .  .  .  .  ...   . .    .   .           .   . . .    .     .     ..      ...   .      . .   .  ...     ..     .... . .
. .   ..  .. ..   .   .         . . .     .. . .    .  .    . .      .     . ..    .   ....  .....  .      .     .. .  .   .    .. .  .  .    .    .  . . . . .
.  .    .   . . .      . . ....  .  .    .     . . .. .   .  .. . .  . .. . .   .. .  . . . .        ..   ..     ..  .   .     .            .   .. . . . ..   .
.  . .   .    ..    .       .. .  . . .   .   .              .    .    ..   .  .     .  .    .   .. .         . .      .   .         .   .   .   . .. .       .
.   . .  .. .       ...           ... .     .    .  . .   .  ..          ..        .  . ... .      .     .  .. .  ... ..  .  .  . .   .     . .         . .   .
. . . .  .  ..  .       . .  ...     .  .    .       ..   ..   . .     .    . .   .. ..      .   .   ..    .    .     . . .  . . ..        . .. .   .    ..   .
.  .. .  ..           ...    .  .     .. . .      .       .     .  . . .   ...      .    .....       . .. . ..  .   .    .  .  . . .     .  .   .  . .  .    ..
.  .   . .   .   .  .     . . .    ...  .   . .    .      ..         .  ... .      . . ..      .  .   . .  .  .     . .            .   .  .      . ..  ..  .  .
.               ..... .  .  . ..       . .  ..          .            .  ....  ..    ...   ..   . .  .       . . .    . .   ..  .    . . .   .    . ..  .    . .
.   .        .      .  .  .  . ..           ..      ..  .  .    .   . .     .        .. ....        . . .    .   ..  ... ....  .    .  .  ..   .  .     .    ..
... .. .    .. .  ... ..      .  .  .  .   ..  .   ..    .. . .  .   .......   .  .             . ..  . ....     . ..          .   .     . .   . ..    ..     .
.  . . ... .  .    ..   .  .    .. .    .  ...     .        ..     . ...      ...  .  . .    .       . ..       .   . . .   ..         .   ...      .       . .
. ...     .      . .  .. .. .  ...    . .      .  .       . ...  . .  .    .    .   .  ...  .   .   .  .. . . ..       . ... .   .    ..  .    ..  .. .  .  . .
.      ..   . .  . ..    .   ..    .. .. . .    .  . .  .        . .      ...  .     .   .  .. ...  .. . .. . ..   ..  .. . . .. .   .  .. ..     .      .   ..
..      .  . .   .   ..    . ..     . . .  ..    . .   .    ..    ...          .    . . . .      .    .      .   ..            .       .. .   ....    ..      .
...   .              ..          ..  .     ..   .    .  ..         .       .     .   . .  .    ...  ..  .   .... .     .  .     . . .      .  .   ...     .  ..
.    .  .. .. ..   ... . . .  ... ...      ..   ..          ..   . . ... . ..   .. .      .  . ..   ..  ...    .  .. .    .       .      .. .   .     . .   ...
.   .       .. . .. ..   .      . . .        . .   . . ..          ..  ...      ..       .  .  ..  .      .  .  .  . .  ...       . . .    .        . . .    ..
.   .      . ..  .       ...      ..  . .. .     ..  ..     . ... . .  . .  . . .  ... . .  . .   .     .  .  . .. .   .   . ..  ... .     .     . .    ..    .
.   .   .           .. .  .    .   .    ..  .. .. ..      .   .       .  .   ..  .  ... . .. ..    .    ..    .   ...... ..  .            .     . ..       ....
. .   .    .  .....  .  ...    ..       .   .  .   .  .   ..  ..  . .  .  .    .    .   . .      ..     .   ...  . .  ..   . . ..  .   ..  . . ..   .  .  .   .
..   .            .. . . .   ...           . .    .    ...      . .     . .  . .  . .      ...   .       ......    . ..  ..        .    .    ..         ...   .
.      .  .   . . .  . . .   .       ..   ..    . . ..  .  . .  .  .            .   . . . . . . . .     ....        .   .  ... .   ... .  ..    .      ..  .  .
. ..   ...           . . .  . . .         .  . . ..     ..   .. ...   .. .              ..  ..  .  . .  .....    . . ..     .  .   ....  ..                  ..
.  ..  . .  .      . . . .    .  .   ... .    . ..  .  .. .     .   ...   . ..  .    ..     .  .      ..  .. .      .  .    .   .  ..      . .      .        ..
....      ... .   .. .  .            .   . ..        .   . .   .. ...  . .  .  ..   . .  .    .       .  ..    .. .  . ..    . .      ..   .  .. .   . .      .
.     .  ...     .   ..          .. .     ..  .   ..   ... .   ..     .   . .. . ..  ...     . .  ..  ..     .      .            ..      .. .        ..  .  . .
...  ..    .  . .  .  .    .     ... ..      ..   . .... .    .  .   ..   .  .  .   .    .         .    ..   ...         .    .      ..     .. ..  ....  ...  .
.     . ..   . .. ....    .          .     .. .  .     . .   .      .   .. .           .....     .     . ...     ... ..  ..  ..   .        .      .   . ..    .
. ..    ....    ..  .     . . . .   . .  ..  ..   .  ..         .    .  .    . .   .   . . .    .... ... .   .            .    .     .  .       . .   .. .  . .
.  .  .       .      . ...   .  .       . .        .  . .  .      ..   .      .            .  .       .     ...      .    . .  .  .   ...       . .......     .
.   .          . ...    .   .    .   .               ... . .. . .             .    .   .     . .. .   .     ..   . .  .  ..  . .   .           ..  .  ..     ..
.. .     . .. ..   .  .  .   .. .    . .  . .   .           .  .   . ...    .       .  ..       . .  ..     ...    .. .  ..     .  . .  . .   .        .   .  .
.   .    .      .           ..  . ... .    .  . . .  ..... .  .    . ...           . .   ...  . ..   . .  .     .   .   . ...      .  . .     .     .  .    . .
. ...    ...    . . .      .  ...  . .  .  .  .    .    .. ..     .   . .              ..       ..  .  .   .           .. ...  .. .   .        .   ....     ...
...    ..   ...... ... .  .      ..    . .       . . ...    .. ...      .   ..     ...      .. .        .  .      .. . ..                    .   .    ... .   .
.    ..   .    .   . .  . ..   .    ....   ..   . . .   .. .     .      .   .. . .  .        .   .. ..    .     .          .           .    . ..   .    ....  .
.    .. ..  .. . .     .   ..  . .. ..   .    . . .   .    ..   .   .   .       . .     ... .          .  . ..    .  .    .     .. .   .  ...     . .    . .  .
. .       .           ... ..  .  .. . ...    ....     .   .   .. .     ..     .     .    .    ..        .    .       .  .    ..     .  ..   .     .        . ..
.    .  . ..  .    ..     . . .. .     .  .        .  .   ..        .      . .   .  ..  .     .  .    . .  .           .. .    .. ..  .  ..      ..     ...   .
.     .    .  ..      ..  .  .   .  . ..   .   ...      ..   .  .   ..  .              ..   .   .  . .         .    .     .. .  .   .   . .      .  .. .      .
.     .               ...  ..  .         .  .   ......  .  .   .  .        .       .   .     .. .. .      .        .       . .... .  . .    . ..     .       ..
.  . .     .   .  ..  .        .    .  . ..     .  ..     . ...  . . . .     . ..   ..  .   .  .      .         ..    . .... .   .   . . . .         .  ..    .
.  .      .   .        ...      ..   .   .     .    . .    .... .    .  . ..      . .             .  ...   . ....  .       .  .    .       .     . . .   . .  .
.       .       ..          . .  .    ..  . . ..     .... . .        .       ...         .     .. ..    .       .   . .           .   .      .     .   .   .  .
.  ..    . .. . .    .  . .. .  .   .. . .         . . .   ....     . ..      .. .     .      ... .      ...  . .  . .   . .  ..   .   .   ..    . .    .     .
.   . ..  .   . .   .       .  .. .   .. .   . ..  .   ..         .  .     .. . .  .   .      .    . .. .   ...             .  .  . .. .   . ..     .   .   . .
. .   .   . .. . .         . ..   ... . .  . . . .   .    .  .  .      . .          .         .  ..       .      ...  ..  .. ..   .  . ...                .....
.        ..     .  .     . . .  .    .   .      .  .. .           . ..   . ... .    .  . ..  . ... .   .     .  .               ...  . ...   ..        ..     .
.. ..    .  . .  . ..      ..          .  .  .      . .    .     .. . .  . ...   .   .      .    . . .   . . .          ... . .     . . .. .    ..        .. ..
.. .  .     .     .          . . .  .  .       .      .       .... .    .  . .  .   .   . .... . . . .. .  r    .     ..          ..      .    . ..  .      ...
.     .     .. .    . .      .  ....    .   . ...   .      .      . ...    .   ..     .         . .  .  .   . .     ...   .    .  .     . ....  .  ..         .
. ...      ...    . .    .. . .       . . ..  .  .  .     ...         .   .            .            . ...  ...    ..       .    . ....  ...  ..       .    .. .
.  .      .     . .         .   .. .. .     .     ..  .   .   . ..   .    . .    ..  .    .    .  .      .   . .     .     ....  .                  .  ..  . ..
. ... .  ..        . . . . .       .  ..  .   ....    .  .    . .    .       . .  .  .. ...         ...   .         . ..      .  .   .  .   ..  .      .    . .
..   ..   .  ...    .     .    . . .    . .  .  . . . .   .   .    .       . . .       . .   ...  . .      .  .          ..... .. .   .. . .      .       ..  .
.  . .  ..  .      ..          .  .    . .     . . .. . .     .          .  ..     .  . .  ..  .       .  .  .  .             .  . . .      ..  .   . .    .  .
.     ...    .  ...     . .         .   .  ... ..    .     . .     .      ..  .   .  ..  ....  .      .   .    .    . .         .....   .   ..       .   . . ..
.  .  .    .  .. ..      .   .  . .            .  .  .            ..    ... . ..       . . ..        .        .     . ....     . .  .      ... .. . . .     . .
..    ....                .   . ..  .. ..   .      .         . . .              . ....        .. .    .   .   .   .    . .. ..  .   ..  .  ..  .  ..      .  ..
.   . ..   ...      ..   . .      ..       .  .  . ..       ..   ....           .... .    .  .     .    ...  ..  ... ....       .  .   ...     ...  ..  .    ..
. . .           .    .         ..    ..       .           . .     .. ... .   . ...  .  .       .     .  .. .   .   ..       .    . .      .  .   . ...       ..
.    .  .    . .  .                .       .           . ..    . .....      ..    . .    .      . ..       . ..  ...   .  .   ..   ...  .      ..    .    ..  .
.    ..    . .  .    ..     .    .     .. .    ..        .   .   .. . ...  .  .  .    . .     .. . .. .    .  .     ..  ..  . .  . .   .. .  .     .        ...
...  ...        .   . . .  . . .  . .       ... ...              ..     ... .         .    ..       ..  . .     .   ..     ..  .           .      .  . .      .
..             ...    .    ..    ..    .   .     .          .       .    ..   .           ..    ....    .. .    .  . .  .. ...   .  ... ..              . ... .
.    .   .         .    ..     ..   .  .     . .....      .. .... .      . .      .  .. .     .  ...    .   ..   ..   ....    .   . .   .       ..  .       ...
..           ..    ..  . .. .     .                 . .      . .     ... . . .   ..     ..   .     .    .       . .  .           .      . . .. . .      . ..  .
.  .   ...  .    .  .  . .. . .. ..  ...  .  ....     ... .... . .. ..   .  .         .. .   .    .  .       . .  . . .      ..         .     .   . .         .
.  .      . .    .  . .         .     ....      ... .      .       . .   . .   . . .    .          ..   .   . .   .. . ..   .  . . .          ..            ...
. .    ...     .   .   . ..  .  . . .        .      ...   ..   ..  .  . .   .   .   .  .. .   .  ...   . . .      . .  .    . .  . .  . . ..    .     .....   .
.. .  . .       .    .     . .  . ..      . ..  .    . . . .  . .. ... .   . ....  .        .     .      .    ..   . .. . . ...  ..      . .   .            . .
. .       ..          . .. .....  .   .     .                   ... .  .   . .  .  .   ...       ..       .               . . . .    . . ..   .          . .  .
. .. . .   .     .    ... .  .   .. .         . ..      .  . .. . .  ...       .    ...   ... ..        ... .. .      .  . ...  .  .   .. ..  . . ..  ..  .  ..
. .           .  .     .. . .       . . .   .. .. .           .        . .. .   .  ..     .    .   . . .   ...       ..  .    ..   . ..  ..  .. .          ....
.        ... .  .    . .  .   .  . ..   .    ..  .  .  .   .  ..        .   ..    ..   .    .      . .    ..   . ..          .       .   .     .             ..
. ..    ..        .   . .   .      .. . ..  .  .  .   .        .      .       .     . .    .  ..   ..        .     .  ... .....        .    .  ..    .  .     .
.    .  .   .       ...   .   .  .. .... .         .. .          .    ..    .  .   .  . ..   . .  ..   .     .     .   . .  .    .  . .   .         . ... . ...
.    . ..    .  .. .     . .   ... ..         . ...             ..  . .     . .     .  .    . ..   .. ..         . .. .      .  .        .  ..         . . .  .
. . .    .. .  .         ..    . .      .. .   ..    . . . .  ..       .   .  .       .  .     .   . .    .   . .  . . .       . . .. . ..  ..      .  . ......
.  .   .       . .      . .  .  .    ...           .    . . .  ..    ...     .     .    . . .  ...   ..       .      . ..     .  .      .   .      .. . .   ...
. .   . . .   .   ... ..   . .  ..   .  . .        .  ..   .      .  ..        .   .     .   ...  . .  .      . . .  .    .   .  .. .   . ..  .  ..    .      .
.           .. .             ..         . ..        .. .  .. .              .. . .  .     ..  ...      .   ..  .  .. ...         .        . .       .   ..   ..
.     ...    .     ...     .   .  .    ..  .                     .   ..  .  ....  . .     .   .            .     .       .     ...   . .     .     .  ..     ..
.   .    ..        ....  .            . .    .   ..  .  ..      . .    .    . .  .       .      ....   ..... . .   ..  .   ..    .. . .    ... ..   .    .   ..
.   .  ..    ...   . .    . .   .. ..  .    .  .  .. . .   .       .     .   .      ..     .       .   .   .  . .        .  .   . .        ..  .     .. .    ..
.        ... .   .      . . . .  ..   .. .     .        ..       .      .     .. . . . . .   ..    .  .. ..   .        .       ..      . .  .. .       . . .. .
.    . ..  .  .    .       .  .     .   .      ..  ....  .        .   .   .  ..    .      .. . .       . . .             .  .          ..  .   ..   .        ..
.  .  .      .    .   ..  .  . .       ....  .  ..       .   . .    .      ..    .     .    .     ..  .       .  .  .     ...          .      . .  .       .  .
.   ..  ..  ..     ...               .   .          ...          . .         . . .   ...          ..     .  .  ... ..      .    . .         .  ... . . ...   ..
. . .   ..        .           .  .    .   ....    ...   .. . .  ...       ..              .      .   ..      .    .           .  ..  ...  .             ..    .
..     ..    .      . .  .  ..  .... .  .   .   . .   .   .  . ...      ..             .   . ..  ..           . ...      . .  .  ..  .  . ....    .  ...  ..  .
.. .    .         . .    .  .     .  .   ...      ..    ..         .   .  ..    .   .. .  .  .     .    ......    ..... ...    .             .  .        ...  .
.    .  . .     .    .  .. .  .    . .   . . .  .. .     .. .   . ..    .. .. .   .     .     . .. .       .  .. ..        . .     .. .   .               ..  .
. .  .     . . . .  ..     .    .    .     .        .  .          .         .  .  .     .    ..   . .         ..         .       .  .  .    ... .. ..  .. ... .
.  . .      .         .    .   .    ..     .    . . ..... .     . .    ...                        .  .      . .       .  .  . . .. .        . .    . .  .     .
. .     .. ..        .        ..        .   ..   .. .  ..   ..    .  .  .    ..      .       .     .  . .         . . .  .. .  . . . . .    ...        ..  . ..
. ..     .  .                .           ....          . ...       .  .   ..    . ..             .   .   .. ...         ..  . . ..     .  .  ..   .  .       ..
.  .   ...      .        . ..      ...  ...  .           .     ..   .. ... . ..  .    ..        .         ..     ..            ..        ..        ...    ... .
. ..   .      .  . .    . .      ..   .      ...      .      .  . ...  .      .  . .    .....    ..     .. .  . . .    ..     . ...   .    ..   . ...      .  .
.     . ..  .  .  ..   . .    .   ... .  ..   .        .   . ..    . . ..   .  ..  ..     .      . .       .. . . .     .  ...  .     ..      .  . .  .       .
. .       . ..    .   ..    .        . . .  . . ..  .    .     . .  .  . ..      .            .. ..     . .. ..     ...      . ..     . . ..      ..  .  .  . .
.. ..         ..   .        ....   .  .     .   ..   ... . .          .  .  .. .  .  ..       .  .    .  .   .. . ..        .    . ..         .    .  .  ..   .
.  .  ..  . . . . .     .         ..    . .   .....   .    .  .  .  .. ..... . .     ..  . .     .. .  .. .       ..  .                    .    ..  .   . .   .
.   .    .            .      ..         ..      ..  .  .. ...          .    .       ... . . .           .. ..           .  . .    ....    ..  .    . .  ..    .
.    . ..   ..     ..... .        . .     ....      .  . . .. .  .  .         ...      ...     .     ..   . . . .. .. ..  .  .  . ..... . .  .    .   .     ...
. . . .      .          .   .   . . . .  .... ..  ..      .  . .     .   .  .   ...     .             ....           ..    .      .   .   ..         .   .    .
.     .  ... . . .  .      .  . .. .   .    .. ..  .... . .     . .           .    .. ..     ...   .    .. . .   ..   . .    ..   . .  . ..    . ... .    .   .
. .     .....      ..   .      .      .   .  .        ..   .   .. ..  .       .   .. .   ..  .   .      ..   .  .       .    .     .   . . ...   .. . . .  .  .
. .  . ..   ..                     ..             .      .  ... .    .  ... .  .. . . ..    . .     .        ..    . ..  ..    ....  .   ..   ..       .      .
.   .     .         . .     . . ..   .. .  ..         .. ..   .     .   .       .    . ..       ..  ....  ..... .  .       .  . .      ..      . .   . .     ..
.               ...     .   ..     .  . ..        ...  .       .   ..   ..  . .. .  ..   .       . .    ..        ... .    .          .    . . .   ..   .    ..
.. .. ..  .       ...          ..   .  ..     ... .    . .  ..          .    . ..     .      . ..    .. . . .        . ..    ...  . .          .       .    ...
.   ...  ..      .      ... .     .        ... ...      .. .  ..  . . .   . .       . . ..      .     ..   .  .   . .    . .  .  .  .  . .   .     .  .    .. .
. .   .  .   .  ...  ..   ..         . . .   . ..   .  .. .      ..  ... . .  .       ..  .    ..   .    .  . ... ....    .        ..       ..  ..   . .   .. .
....    .        ..   ..   ...  . .. . . .    .   .           .   .           ... . .   . .   ..            ..    . .       . .   . .. . .              .     .
...   .   ...  . ..  .....     . ..   .  .   .    .  .     .. .          .  ...  .    .  .    . .     . .   .   ..     .   .  . .     ..     .    .... .   . ..
.     . . .           .     ..... . .    . . .   .     .   ..   .  . ..  ..  . . ..   .   .... . . .        .  ..  .  . .     . ..   .  .  .. ..      . .   ...
..     .      .    .         ..  ...   . . ..... .   . .         ..          .  .    .      . .  .    .  .      .   .  ...     . .        ...   .  .          .
..    ....        ..    .  ..  .     .  .. .          .   .   .   .  . .    .   .  . . .     .    .     ..     . .   .    . .. .  . .    ...  ..   .  .  ..   .
..     . . .         .   ...   .         .  .   .  ...  .    . .   ...  .    .    .      ... .      .. .      ..   ..  ...   .  ..    . .   .       . ..   .. .
. .  ..  ..   .  ...  . .  .     ..   . .  . . .    . .     .   .           .  .  . . .  . . .             .   .    ....        .   .   . ....             .  .
.   ..    ..   . ..   .. . ... .              .  .  . .            ..            .  .    .      .           .       .  ..  . ..  . .   .  .  ..   .  .    ..  .
.. ... ..  ...           . . ....  .           . . .. .       . ..     ..        .   .      .  .   .             .  .. .  .. . ..    .     . .       . . ..  ..
.   . .  . .     .  ..         .  .     .        . .  .     ..     .  .                 .....     .     .  .     .           ..    . .     .       ..   . . ...
. .  ..       ... .                  . .  .  . .    .  .  .       .      ..   .  .        .    .     . ...    . . .     . .    ...   ...   . ...  ..    ..    .
.     .   .  .  . . .     .  ..  .      . .. . .     .    . .     ..  ..       ..  .  .       .      . . .      ..    .. .      . ..         . ..  .  . ...   .
.    .         .  ..  .       .  .  . .        ...    .       .  ..  .  .      .  . . . . .   ..       .    . .     ...  . . .     ..  .. .     ..    ..      .
..  .    .  .              .   .    ..   ..    . ..   ..  .   .    .....    . ..          . ..  . ..    .   .  .     .. ... .. .    ..   . ...  ..     ..  .  .
. .. .   .  ..    ..    .    .       ..  .       . .            ..  . .  ..  ..  ..      .             .     .  ...   .  .   ...  .    .. .          ..     . .
.   .  .  . .   . .  .    ... . .  ..   .. .    . .    . .  .  .  .        ..  . ..    .     . .     . . . .        .  .. .. .. .       ..  . . .    . ..  .  .
.  ..    . ..  .   ...          .. . .. .          .   .  . .  .     .  .. . . .    .      .            . . .... ..       .     . . ...   . ..   . .       . ..
. .  ... .     .    ..  .     ..      .....    ..   . ..   .       .. .        .  .  .     ...  .            ..        ..  .  ..  ..  .  .      .... .  .  .. .
.   .. . .    ....       .     .   .   .     .. .         ....   .  . ...    ..  .     .         . .  .       .... .  . .     . .   .      ..  .   . .......  .
.      ...  .   .    ...  .            .    ..   . .  .  . .         .    .  .   .  ..                ...      .  .  ..  ..    .     ..  ..    .    .     .   .
.   .       . .  ... .  ..     . .    .   .     . . .....    .     . .    .   . .. .. .    ......    .               .   . . .   .  .. .  .  ..   .  .    .. ..
.          .           ....     . ..  . .  ....  .     . .    ...   ..  .  . .  . .   .  . .  .    . .  . .      . ..    .  ....  .     . .  . ..   .. .   . ..
.      .   .  .   .          .   . ..   .  ..  . .   .   .     ..  .        .  .  ..  .    .  ... .   . .. ...       .     .   .. .     . ..  ...   . . . . . .
.   . .  ... ..     .  . ..      .  ...  .   .  .       . ...         . .  .  .   .      ...  .         . .. ... .          .    . .  .          .  . . . .. ..
..  ..  . . .    .. .. ..      ..   ...  . .      .   ..  . .. .     .  .. ..        ...   . ...  ....     .   . ..                     ..      .    ... ..   .
...    ..   ..    .         .  .    . .                 .  . .    .   ..... .   ..      . ..     . .  ..    ..  .   .   ..      . .  .      . .. .   .   ..   .
.       . .  .. .     ..     ..  ....       . . .    .    ..    .     .  ..         ..   .   ..  ..   . .     .       .      .      . ..  .    .       .     ..
.   .          .    . .   .   . .   ...   ..    .   .   . ..   .     . . .. .   . .         .    .   ...  .        .    . .   .  ...   ..  ..  . .       ... ..
.        . ... . . .                       .             .  . ..  . .  .  .  ..   .  .     .    . .  .  .  .   . .    .      .  . ..     .. .    .    .      ..
..    .. . . ..      .         .  . .  ..  . .             . . ..     .      ..       ....       ..     . ...   .    .                      .  . .       ...  .
.. .     .. ..   ..     .    .  .     .. . .  .    ...   ..    . .  .    .... .   .. .  .    .  .   .  .            .     .     . .. . ..   . ...         . ...
..        .  .    . .        .    .      ..        . .      .  .. . ..    . .   ..   . . . . ..  .       ..       .   ..    . .    ..  . .    .      ... .  . .
. .  .   .      .   .   . ....    .  . ..  .   .   ... .. ..            .       .. .   . .  . .   .    . .    . .  ...     ..   .    ...  ....       . .      .
.  ...      . .    .         ..    .    .. . . . . .      ...  ...     ..    ... .. ...  .... .    .    .  ... . . .  .   .           .. ..        . .        .
.  .  .    .   .  ..    . .        .       .   .  ..             .         .  ...    .  .            .  .     .  ...  .   .       .   .   . .  .          .   .
.     ...   .   .    . . .   .           .. .       .  .  .    .. ... . . .      ...  . . .  .  .    ..  ..   .  .    .    .  .   .. . .      .      . .     ..
. .     . .    .. .  ...      .  . . . .   .    .  .     .   .       .   ..  .  .    . .. .   .  .  .   . .     .   .  .    . ..  .. ....   .  ..... .        .
.  ..     . .    . ..        ..      . .   ...  .         ....   .. .  . X.      .   ..   . ..   .  . .. .    .  ..     ...     ...   ....  .   ....    . .   .
...............................................................................................................................................................
