...............
..  ...   . . .
.  ...        .
.      X.   ...
.  . r        .
.. .  .       .
.  .    .   ...
....  ..     ..
.    .  .     .
... . ...  .  .
.      ...    .
.             .
. .   .     ...
.. .. .    .. .
...............
