................................................................................................................................................................
..        ....   .         .. .  .   .  ..           . . ..  .     .  .     .          .        .   .    .  ..   .        . . .   .    . ....  .  ..    .....  .
...  .  .    .    . .       ..  .   . .    . . ..   .  .    ......  . .   .   ..    ....   .     ..   ..   . .  . ..  .      ..      ... .. .   . .  .. ...   ..
... .. .    ..     . .     .   .   .   .        . .  ....   .   .    .          ...      ...   . .. ..    .     ..           .     ... .      .  .        .    .
..  . .. . .        .   .       .   . . .      .            ..   .  .    . .. .  ...    ..     .. .  ..  .    .       . .   .    ..         .    . ..        . .
..  ..  . .      .. ..  . .   .  .      ...   .    . .      . .      ..  .        .. ..   .           .   .  ..    .       .      ..    ... . ..   . .. ..     .
.  . .       . . .    .   .     .        .   .     . ..    .    ..  .  .       .        ..  ...   . .  .....  .   .     .    ..  ...    .    .  .  ..   .  ... .
.  .  .   . .                 ..     ..  .. .       ..   ...   .  .   . .. ..    .             . .     . . . .. .     . .  ..   . .  .       .  .        . .   .
..         .... .  .. .         ..    . ..  .  ..   ..  .   .         .     .   .. ...       . .   .  . .  .  ..        . .      .  ... ...    . .. ..   .     .
. . .    ..  .   . ...    .      .          . .  .   .  . .     .      .. .   ....  .. .     ..      .  .   .        .             .   ... ..   ... . .        .
..  ... .  ..    . ..   .. .        .   ...         .    .          .     .  .          ...      . .. .  .    .  ... .      .     .  ....     .. .       .   ...
.       .  .. .  .. .  .. . . ..  .   .. ..   ....  . .     .    ..     . ...  .     . .  .   .      .      . . ....  . . .  .    .  .. .  . .  .    ..       ..
.    . .     . .         .. .      ....    . .     . .. . ..   ..  . .     ..  .     . ...      ..  .   .    . .      .  .           .  .   . ..  . ...  .  .. .
..   ..      . .   . .   .  ..     .   .  .    . . .    . . .   .    ... ..  . ..  .      .   ..   . ..   .   ..   .    ..       . ...  ..    .   . .    .. .. .
. . . .     .. ..   .      ..    . . . ..  .    .     . .   . ..  . ... ..  . . .  .   .   .     ..    .       ..   .   . .  .  .   .   . .   ..  ..  . .    ...
.      . ..  .   . .  ...  .     .  .. .  .   . ..  .   .  .  . .   . .   . . .        .  .   .... . .     .. ..    . ..     .. .   .   .   .    ..     ...   ..
.. .  .  ...             .      .  . . . .   .  . . .   ..     .     .   .   .  .   ... .         .  . .     ..  .  . .  ..           .         ...  . .       .
.. ..  .   .   .  .   . .  .    ..   ...              .  . .      . .    . .       .          . . .... . . .   .      . .     ..     . .   . ..    .        ....
.             ..         .  .    .    .    ...     ..  .   .  .   ..  .      .    .    .    ..  .. .. . .      ..  .        .     .     .       .   . .  ... ...
.   .   ..    .  .         . .       .. . .      .....  .  .     .      . .. .       .    . .  ..  . . ..  .   . ..   .   .  .  .. ...    .   . . .       . .  .
. .  ..       .           .  . ... ...  . .     . .. .. ...  ..   .       .     .   . . .    .  .   .  . .   .    ... ..     ..   .  .. .       .  .  . .  .  ..
.   . ...      . . .. .     .     .   ..    ..  .     .   ...  .  . .. ..     .. .. .    ...     . ..     ..   .. . ..  .    .    . .              . ..  . . . .
.  .     .  ..  .   ..     ..  . .  ...          ..  .    .    .    .  ..        . .   .   . .     .           .    . . .      .           . .                 .
. ..   . .... .   .     .  .    .   .... .        .     .   .  ..  . ..           . ..     .  .   ..            .   . .      .       .   . .    .   .  .  .    .
.   ..  . .. ..   . .. .. . .. .    .     .....     . ...  .  .      .   .     . .  ..    .         .    ..   ..      .. . ...   .    .    . .   . .    ...  . .
..      .     .  .   .. .         . .   . ... . . ..  .   .. .  .   .       .    .          .. . .   .   .           . .    .  .   . . ... .    .   .        ...
.. .   .     .   .   .. .     . .    .   .   .. . ..   .     . .. . ..   . .            ..  . .   .    .     .  .  ..    ..    .    .  .   .          .   .  . .
..        ..      . ..  .  . .         .          . .  . .. .  ..   . .  .   .  .    . . ...     .          .  .        ... .  ..   ...   .       .. .    ..  ..
.. .   ..   ..        .          . .                  .     .  . ...   .                 ...  . .   ..    .   .   .         .. . ..   .   ..  .  ...        ....
.. .    .     .        ..  ...   .      .  ..   . .   .  .      .      .   ..       ....      .    .          ...     ...  .     .... .    .    .        . ... .
... .  .          ...       .. ..    ...     .  ..   .  .            ...       . .      .. .         . .  .      .. .  . .. .        .     . . .     .   ..  . .
.      ..  .       .  . . .   ..   ..  ..    .           . .       .       .     .           . .        .  .  .. ... .  .    .    .. .  .  .   . .. .    .    ..
...  ..   .     ..      ..    .   .  .     .    .   .  .  ....  .    .   .   . .    .       .          ... .  .      ..         .      ..   .             .  . .
... .     .    .      ..       .    .  . .   .       . .   .   .           .. .  .       ..  ...   ....   .       . .    . ...             ..   .     ..  .    .
.  ..  .  . . .   .     .. .     .   .            . .      ..   .    . .   ..     .      .         .  .          ....  .    . ...     ... .   . .   .   . . .. .
.    .    .      . .    .       .        .      . .           .    ..         ..   .      . .   .   .    .....   .          ..       .     . . ..        .  .. .
.    ..     ..      .             .       .     .. ..    . ..  .            .       ..     . .         .    ..   .  .   .       . .  .  .    ...   .... ..    ..
. .  .      .     .  . .   . .. ...     .    . .   .  ..  .   .         . ..    .     .     ..      . .  .        . .               . .             ....     . .
.  .    ..    .. . .  . . .  ..  .          ..  .   .     .      ..    .  .  .         .            .     .    .             .       .       .. .        .. .  .
..     ...   .  . .. . .  .  . .       .. .        .   ...   ... ..    ..    ... . . .   .    .  .  . ..   . .  .... .          .. .         .     .    .    . .
.  . . .   .    .   .. ....    .   .    ..    ..        .         .  ....    . .  .....        ..  .  .   . . .  ... .      ..     .      . .  .  .  . .  ..   .
.     . . .  ...     .  . .     .   . .       .     .  . .     .   . .   . .     .   ..           ..   .     ..  . . ..  .  .. .    .      ..  . . .     .   ...
.   .          .    .      .... .   .  .    .     . .   . . .       .          .. .     . ...   .  .       .  ... .  .  .  .  .        .   ..  . .  ..      .  .
. .. .....   .  ..  .  .     . .          ..   .. . .  .    .   .       .    .   . .     .. .  . .    .            .        . .       ..    .    . .   .      ..
.  .   .          ..  .. ....        ..    .. . ..  .     ..      ..    .       .        .   . .  .      .. . .. .. . ..    .  .. .  .       .  ... ..  ..    ..
.  .      .    .  .  .   .   . .     .      .    . ..      .  .            . . .        .    .     .  . .     .   .      .. .   .     .   .    .   ....       ..
.     .   .   . . .  ..       .     .      . . ..    . ..   .    .      .  .               .  ...       .        .             .  ..  ...        . .   .    .  .
.  ....    ..  .      .       . .  .        .      .      .. .    . ...   . . .     ..  .   .         . .  .. . . ..    ..  .... . .    .  .   ..    .   ..    .
.       .  .                  . .     . .. .   ...  ..  .      ..        . .     . . .  ..... .      . . ....       .   . . ....  .    .    .  . .     ..  .  ..
..  .       .         .  .  .      .   ..   .  .     .  . ..   .      ..  .  .  ...    .         .  .   .   .      . .    .   .    .   . .  .    ..  .    .. . .
. .    . . . .. .  .  .  .     .  . ...  ....          .      . . ...  .           . .   .   ..   ...  . ... ...   .     .  .. .    .. .  .       .  .   .  .. .
..   . .. .. . . ..    .        .  . ....   .  .     . ..  .. .  .   .    ..   .      .  . .  ..  . .  .  .. .. . .. .    . ...   . .    ..   ..  .     ..   . .
.. . .  .. ..  .  . .       . ..   .. .  . .   .   .  .....  . .    ...    .  .   .    ....         .  .  .....  .     . ..  . ..     .    ......          ... .
.      ....  . ..  .  ... .    . . .   .          .     . .      .  .       ....    . .  .         . . . . . .     ... .  .      .   . .    ..           .    ..
.   . . .     .      .          .    .  .  ...    ...       .     . . .    .   .  . .  .  . .  ..  ...  .    ... ..     ..   . .    .  ..        .   . .   . ...
.   . .   .  .   ..  .   .. .... . .       .  ..  ...   .         ...  . .   . .......      . .   . ..    .. .  . .    .  ...         .    ...     .  ..     . .
.    .  .....  .. ..   .      . . . ...     . ..... . .   ..  ..    ..  . ....  . . ..... ..        .     .   ...      . .      .    .  ... .  ..  . .. .      .
. .   .   ...   ..      . ..     .         .. .     .... .    .    ..  .    .     .      . ..  ..    . .  ...  . . .  .      . .. .   .      . ..   .   .      .
.   ..  ..   .    .       .       .. ..  ..          .    ..      ... .    ....    .  .   . .   .    .  ..     ....     .    ..  . .           . .   .. .   . ..
..   .  ..    .  . .    ...      ..              . ...  ..   . . .         .      .  .   .    ..  .  .. . . . . .. .       ..        . .  . ... ..      ..   ...
.      .    ....      .    .      .  . .  .  . . .  .  ..   .    . . .      .  .     .. .  .. .  . .. . .        .      .  .      ...        .  .  .... . .  . .
. .. . . .    .       . .  .          .  . .  .  .     . .  .  .     ..     .  .  ..  .  .      ..                  .   .    .  ...   .   ...         ...    . .
.  ..     ...   ...             ...   ..   .     .   .       .    .    ..  .     .       .  . . ..     .   ..  .  .  . .  .    .     .       .    .. . ...   . .
.         .      .             ..   .        ..    . ....   ..      .        . ..      .      .      ..  ..        .          . .   .        .   . .. .  .  .  .
. .  .  . .      .  ...  .    .  .       . . .      .  .    .  .      .. .    .         . . . .   .  .  ..     .    . .   . .  .   .       .      .   ..   .   .
.   .     ...  . .  ..       .   ..      .  . .  .   .    .  .   .     .. ..     ..  .    ..      .. ..   . .     ...     . .   .    .... .. ...      . . .  . .
..  ..                     .  ..  .               . ..        .   ..     .  ..     . .     .     . . .     . . ...    .         ..    .     ...     .      . ...
.  . .   .. . ..   .. . ..  .  .     .    . .   .    ..   .... .  .. .    .. ..    .  ..... .   ..       .  .  ..     ..   ..  .     .         .  ..    . .    .
.  . .. . .          ..   .      ..  .     .  .    .       .       .......       . ... .. .         . ..    .       .      .... . ...       .      .   .  ...  .
.    .     . . .    .   ....         . ...   .  ..   .   ...   .   .  .  .      .. . . ....  . ..            . .     .. .       .      . . ....     .   .  .   .
.  ..    . .  ......   . . .    . .    .   .  ... .      . .      . ..  .. .   . . ..    .                 ...     .... . . .   ...    ..   .          .  ..  ..
.   ..    ..   .   .        .   . .  . .   .   . ..        .. .     .     .. .          ..  . .. .   .  .  ... .   .    .   .  .       ..   .   ..... .. .. .  .
. .  .      .  .               .       .    ...  ..    ..    ..     ..   .    .      .                 . .  .   .     .   .. .        . ..   .. . ..  ..  .    .
. .    .   ..  .. ...        . .    . ..        ...   .        ..       .   . ..  ..      .     . .   .. .  ...   .      .   . . .  . .      .. ..    .        .
. .   .   .        ....   .. . ..             .. .      ..  ..     .     ...       .   . .    ..   . ..  .             ..  . .. ..  .   ..  .        .    .... .
.  ..     .  .   .  .... ..... .         .    .              . . .    .   ...    .   .   .  .     .      ..    .             ..   . . .    .   ..      ..  .   .
.            .  .  . .     .   . . ..        .  ..     ..   . .      .   .  . .    .. .     .  .    .  .         .  .  .    .          .         .   ... . .   .
.  .  .    .      .                .. .          . . .  .       . .. .     .        .   ...  ..   .  . .   . . .  .  .     .....   .. .  .     .    ..  ..    ..
....    .    . .        .. .       ....  .  ...  . .  .     ..   . . .  ....      .   .. . .. ....       .   . .               .  .  .  .    . .  .    .  . ....
.  .    .  .   .       ... .   .   . ...  ...  .       .  .  . .    . . . .     . . .  .  .   .. . .      ...  .    . ..  .   .     .         ..   .   .  ...  .
.   ..  . . .. .  . . .    .    .    ..        .  . .  .  .  .     .  .     ..   .   .   ... . .  . .   .  .   .    .  .  .  .     .    .      .   ..  ... . . .
.        .  .. ..   .          . .       .   .   .           . . .. ...    .  .    .    .   .    .   .    .  ..   . . .  .. .  ..                ..  . .... .  .
. ...     .   .   ...  .      . .... ..    ..       . .      .  ..   .     .   .  . ....  .  ..          . .    .      .    ....   .   . . .  ..     .  ..     .
.. .   ....     ..    . .  .   . .    .  . . .    .. . .  .     .           . .   ..    .   ..        .  ..  ..   . .  .  .   .       ..  .   .. .... ..    .  .
. .  .  ..   .   .. .    .     ...  . . ...           ... ... .  .      .. . ..   .     .   .   .  ...  .   .    .           ..  .  .   .    .     ....   . .  .
.   . .. ..         .    .  .   .  ..  .   .  ....   . . .    .. . ...       .  .   .. .  ..     ..   .   ...      .       ... ....  ..        . .  ..   ..   ..
.       ..   . ... .... .. .   .. ..        .   . ..   .      .. . . .... . .. ..         . .          .      .   .          .               . .. .     .. . . .
.    .   .  .  .    .      .  .   . ...   .. ..          . .. . . .   . .   .   .       ... .   .  .  .    . .    .   .   . .       . .     .. .  .    .....   .
.     .. .     .   . .   .    .   .  .     ..   .    ...   .    .    . .    .  .   .          .    .   . . .. .   .    . . .    ..  .      .     ..       ...  .
.     ...    . .   .   .   .. . . . .   ...    .   .   .   .  ...      . . .  .  .     . .  .    .    ..           ....    .   . ..     . .     . .         .. .
.. .     .        .. ... .      .    . ..  .  ...  .      ...      .  ..        .     . ..  ....       .  . .   . .. .  .  .       .   .  . .    .   .         .
.    . .  ..    ..       ..  .  . . ..      ....  . .  ...   .. .    ..  . .  . .    ..   .  . .                ..... . ..    . . .           .  .             .
.  .   .  . . . ..     .         ..  .  .. . .      .  ...  ..       .  . .     ..   ..   .   .     . ....          ...  .     .    .. . .   ...      .  ..   ..
....   . .. . .    .      .  . . .   ...      .  .       . .  . .    .     . ..   .  ..     .  . .            ... .. ..     .      . ...    .       ..         .
..  .....  .     .     ..  ... .   .  ..  .   .          ..   .     .    .       . . .  .   ..   .   ...   . .         ..   ..     . .  .   .   .     .     . ..
. .  . .     .      .. . .   . .   .  .       .      .. .  .       ..  .       .  .  ..       .    ...  . .    .    .  .            ..     .    ...  ..  .     .
. . . .      .   .    .. . ..         . . .. .      ..     .  .   ..        .  .      ..   .         ...        ...  . .... . .   .     . .       .      . . ...
.   ..  ..          ..      .  ....    .  .  .   . .          . .          .  ..    .    .                ..    .         .           . .. ..  . .   .    .    .
. .      .    .     .   . ..   ..  . ..         ...    ..       .     .  .. . ...     . . . .        .  .   ...    ..   .   .. . .   .       .  . .  ..  .  .  .
.   .        ..      ...   ..     . . .  . . ..  ..      ..      . ..        ..   ...       ...  ...   ...    ..       ..   ..    .    .  . ... . ..   .  ...  .
. .  .. .X  . .  . .  .       .  .   ..    . . . . . .         .     .. .  .      ..       .     .   . ... ....    .. .  . .          .   . .  ..    .. .   .  .
.    .  ..      ...    ...      . .  .    . .      .  .. .   .   .   ..   ..    .. .     .     .     .     ..       .   . ..  .  .. ..    .      .. ..     . . .
.    ..    . ..  .  ..    .           .   .  .        .. .. .       . .       .    .      ..  .  .  ..    ...  .    . .     .  ..  . .   .      .   . .       ..
.    .   . .. .   ..     ..   .      .    .  ... ..  ....      ..  ...   .  . .....   . .  ..      ..      ....     .....     . .     .  .    .  .   .         .
.    .   . .. .     ...       . .                      . . ..  .   .       .  .    ...     .           .  .        .   .   .. .  ..  . . ..  .  ..  ..         .
.    .         .  . .   .   ..   .....  .    ...        ..  .  . . .   .      .   .   .     . .        .    ..   ...  .  .       ...      .   .  .         ... .
. . .    ..  ..     . .  .  .          .  .    ..   .      . .. ....  .        .    . .      .. .    ..    . .  .... .             ... .    .   .        .  .  .
. ..     .  .     .. .       . .     .  . .      ..  .  ..       .  . ..    .   .   .. .  .   .  ..     .   .   . .     .. ..    .    ..   .     . .  .     . ..
..        .  . .     .  .  .   . . ..       ...      .   . .        ..  . . .   .  .  .   ...  ...       .    . .  .    .                .  .  ... ..    .     .
. .  . .  .  ... .     .    .  .        ...  .    ..   . .   . .   . .        .    .  .  ..     .  .   .    .    .. .       .  ..  . .  .. ..   . .  .     .   .
.  .  .  .      .          .             ..       .         . .   .  .  .  .     . .   ..   . . . . .           .  ..     ....              .        .     .   .
.    .         . .      .. ..  .      .      .. ... .   .  . .    .    .    .  .   .  . .       .       .       .    . . .    .   ..  ..           .   . .   ...
.  .   .     .      ..   .  ..                  .  .       ..  ..  . .        ..   . . .    .    .        .. .   .  .. . . . ..    .. .     .   .    ...    .. .
.....   .       . ...     ...  .. .   ..         .   .. ..          .              .  .   .  .     ..  .        . .       .    . .  .    .   ..          .  .  .
..  ....  . . .  ..   . ...  ..  .. . .  . .   .                        . .  .  .          .    .          .   ..    . ..     .     ..  ..   . . ...  . .   .  .
.  .     .. ...       .     .            ..         .            .     ... .        .. ....  . .        .  .      .     .   ..     . .   .    ...              .
. ....   .   ..   . .     ..      .    .  . ..   .. ... . .     ... .     .   .. ...  .  .    .   .  . .   .    .  .    . .    .      .. .     .  .       ..   .
.   . .. .  . .  ...  .  . .  .   ..      .  ..    .        ..  . .  . . .     ......    .  ..   .   .  ..  . .  .   ...      ...       .  .    . .    .     . .
.       .   ..       . .  . .           .       . .. . ..     .  ... .    . ... .   . .   ...    .   .  .  ....   . . .      .  . . .  ......  .      . .. .   .
.. . ..      . .  .  .   ..        .   . ..    ..  . .  . ...   .     .  . .    . .       .     .. .   ..        .    . ..  .        .  .  .    .      .  .. . .
.     ..   .      .. . ..   .    .    .   ..     . .    .  .  .      .. .. .  .    .....  .      .        . .  .   .     .  .. .   .. ..     .    ....         .
.   . . . . . .   ..     ... .    .    .   .     .    ..  .   ...       ..    ..   . .. .    .  .  . .     .  .      .    .              ...    .      .  . .. .
. .      .     ..  .      . . .  .  . .    ..       .  .        ... .     .     ..       .      ..            ..     .   . .       . .     . .   ...   . . .   .
. ..      ...     ..            .  ..  .... ...  . .    .     .   .     . .  . .     ..   .      . .    .  . .  .          . .    .  .   .  .        ..   .    .
.    .   . .  ...        .     . ..       . ..  ..   .   . . ...   ..   .   .. . .  .  .    .   .  ...    .  ..   .          .  .          .  .  .    .      . .
.  . ...   .   . .   . .   . ...    . .       .   .   .        . ..     .  ...    . ..         .   .  .  . .  . . .... .   .   ..   .    .. .  . . .   .      ..
. ... .    .. .  . .   .   .    .....       . ..    .  .   . .     . .     .   . ...        .  ... .    .   .    . .  . .  .   . ..        .   .    .  ..      .
..     .  .     . .  .. .   .   .  .     ... .      .   . . ..     .   .   .   .  ..    .  .     .    .     ..      .    .. . .     ..  .   .     .     .  ..  .
.. .  ..     .   .       ..  . .     .   .        . . .  ...   . ..         .  .     . . ...    ..    ..    ..   .         .   . .... .        ...   ..  ...   .
. . .            .     .. .... .      .  .. . .  ... .        ..     ...    . . ..       ..  . .       .  .. ..    .     .  ...  .     .   .     . ...      .  .
.        .     .    .....   . ..     .. . . .               .           .  .. .  .  ..     .     .   ..  ..   .         ..   ... .    .  .     .      ...   ....
.            .     .    . .     ... ..   . .  .....  .          .       .    .    . ...  .   .    .   .      . . .  ..         .   .      .    .    ...      . .
.           .      .       . .        .  . .. ... . . . .  .  .           . ...   .   .  .   .  .   ....  . .     .      ... .  .      .    .     ..   . . .   .
..    .     ..         .. .  .     .    .  . ..         .    .  .  .      ...   .       ..      . ..  . ...        .. .... ....  . .     . .    ..         ... .
.    . ..      .        .   ...  . .  .       ....   . ..          ..    . . .  .   . .  .   . .      . .          .    ..  . .  ..      . . .  .            . .
.   . . .        . . . .  .  . ..  .. . .  . ..  .... .     . . .. .. . .       .   .  .    .... .  .   . ... ....  ..  . .     .   . ..  ....    .   .  .   . .
..  .       .  .  .   .  ...  ..  ..       .  .       . . .  ..   ..   .      . .  ..         . ....     . . ....      . .. .    .      . .. .. . .. . . ..   ..
..   .  .   .  .   ..      ..       .    .   ..      .   .  .  .   .  ... .     .  ..  .   . ...   .  .  .  .       ...   .        . .  . . . .  ..       .    .
.       .   .  .  .    .    .  ..   ..  .        ..  .     .. .  ... .       . . .   . .     .   . .       ..   .... .   .           ..     . ..    ......   ...
.         .  . ...      .  .  .   . .       .  . .....  ....  .      .      . .       .      .  .   ..   .    . ...  ..     ..   .    .   .     ... .  .   .   .
.  ....        . .   . .   .  ..    .        .  ..    .   .   ...           .     .  . .       ... .   .   .     .      .. . . . ..  ..    .       .    .. . . .
. . .     .         . ..     .              .  ..      ..   .  . .   .    .  .....      ..  .. .  . ...       . .         ...   ... .     ... .   .  .         .
..  .  .    ..   ..   .  .     .    ... .   ..   . .  ..  .  ..      .   .  .   .    .  ...   .           .. .        ... . .. . ..      .     .  . ..  ...    .
.. .  . . ..       .   . . .  . .    .       .  ..   .       ... .. .      ..      .             .   .     .    .  .  .   .    .  ..   ..  . .. .      .       .
..    ..  .       ..    .         .    .    .       ..   .  ..     . ..  .        . .     ..  .  ..   ... .     .    .     ...    .  . ..  .         . ..      .
.   .    . ..         .      .  . .         ..       .        ..      ..   .   ..   . .                ... .      ..        .. . .  .  .. .     . .       ...  .
.  .   .   .   .. .    .   .          .   ....    ..   .  .  .    .   .    .  . . .     . ..  . . .  .    .   ..  .  .       .      .     .   .  .        ..r ..
. ..    . .      .      .  . ..      ...     .....  .      .   .    . . .   ...   ... .    .  ..      ...    .   .    .      .     .   . .  . .  .           . .
..     .   . .     .      ..  . .  . .    . .    . .   ... .. ..     ...    .  .       .. .  .   ...   .   .   . .  .  .  .   ..    . .   .  ..           .    .
...   . .      . .       .   .      .     .  . .    .  .  ..   .   .        . .. ... ..     .              ..    ..       ....         .   . . ..      . .  .  .
..   .. . .... .. ..  .  .... . .    .    .. . .  ...   . ..   . .   .    .  . ..     .     .. ..      . . ...    ... .          . ..    .  .  ...   . .       .
.     .. .      .    ..      . .  .. ..  . . .    . .  .              .. .. .    .       .  .    .   . . .      .. .   . .      .. . . .   .     .  .  . . ... .
.....  .    ....  .   .  ...  .         . .  ..           .  . .   ..          .     . .    . ....      ... . .. . . . ..  .  . .   .   .  .          .  .   . .
..    .      ..   .            .. .   .  . ..     .. .   .  .. . ..     .  .        .   .        . .   .    .   .   ..   . ...  .  ... .    ..  ..    ..   .   .
.  .   .    .  . ..     ..  ..   .    ...   .        .... .   ..    ... . .  ..  . ..  .      .     . ..  . ..      .      .    .     ...    ... ... .  . . ....
.       ...       .    ..    .      . .. ...  .   ..  ..  .     . .  ... .. ..      .. .    ... ...     ..     .    . .  .  . . . .  .      .... .  ..    .    .
. .    .. ... . .  .      .    .      . . .  .      .  .  . .     ...             .    .         .      ..      . . .   ..  .  .. .   .   .    .  . .. .      ..
. .    .  .    .      .  .      .  .  . .. ... .. . .    .      .    .  ..   . .  .. .    .  ..  ..  .       ..    .   ... .. .  ..   ..   . .     .        .. .
. .      .   .     ..     .  . .  ..  .  .... .     .   . .  ..  .. .  .  .. . .   .  . . .   . .  ..  .  . .         ..     ... .. .  .  .   .      ..      . .
................................................................................................................................................................
