.................................................................................................................................................................
.      .  ..    . .... .        .      . ..  .  . .. .. . .. .  .. ....    ..       . ..   .   . .  ...  .  .  .   .    ..  ..     .      .      .. ..   . .  . .
.        .  .  . . .          .  .  ..  .    .   .. .   ..   .. .   .        .  ... . .    .        . .. . . ..      .     .    . .     .       ..   .      .   .
..     . .   .     .     .     .... .  ...  . .. . . .   ..   .    . .       .    .  .   . .  .        .   .    ....  ..  ...   ..   .. ..     ..  ..  . .    ...
.. .  .        . ..  ..   .    . ..         .   ...    .. ...   .. ...    .  .  .  . .   ..  .   . .. .   . . ..   .....    . .  ..  . .     .  .    .  .. .  . .
...  .   .  .  .  . .    .. . .     . . ..    . .    . .....  . .     ..  .   .     ..    .    ..    ..  ..   .     .   .    ..  .. .      .       .. ...  .    .
.  ..        .    .  . . ..    .      .            ..      ..  .     .  .   . . .      .. .  .    ..  ..       .     . .  .  .  . .     .  .. ..    ..  . . .   .
. .      . . ...  .   .    .     . .     .  .    . ..  .. .    .    .    ...   .  .     . .     .    ..            . ...  ..  . .  .. .   .  .  . . . . . .     .
... .   ...  ..  .  . .   .  .  ..   .    .        ...  ......   .   . .    . ..       .    . ...          .        .. .  . .        .  .            .  ...     .
.  .    .  .  .        .              . .   .. . ..  . . .    ..    ..               .  ..  .. .    .   ..   .               .            . ..    ..   .  .     .
. ..  ..      ..   .   .   .  ...  ... ....  ...   .. .     .  . .   ..       .       ... .           ....    ..    .   .. ..    . .    .. .    ..  .    . ..   .
.  ...  .         .. .  . ..   ..     . . ...       . ..      . .    ..   ..  .      .   .  .  .. .        .     .    .     .      . .     ... .     ... .. ..  .
.       ..  ..       . .  .    . .....   .     .. .. .    ...  .  .      .  .    ...  .  .   .      .    .    .. ..      . .    .   .     ...  . . .  ..      . .
. .  . .    ... ...   .      .     .   ...   .... . . ....  .    .    . .   . ....      .   .. . .     . ..        . .       .     . . .   .  .    ... .  .. .  .
. . .          .      .. .     .         . .  . .      .   . .  . .       .         ..           ... .    . .    ..  . .. . .. . . .  ..  . .  . . .   . .   .. .
.          . ..  ...             .  ..   .      .    ..        . ..     .. .  .     .   ..                .  ..              . .   .          .  ..      .   . ..
.. .     .        ..      ...     .   . . . .        .     .     . .... ... .         ..   .  .  .      .   .        ... . . .           ... ..  .   ..    ... ..
.  .       .     ..        .       .  . .. .      ... .  .   .   .     .  . ..   . ..   .. .  .  .     . . . ..    .  ...       .        .          .    .     ..
. .      ...    . .              .          ..    ..  .  .              .         ... . .        .   .         .   . ... .  . .   . ..   .  .    ... .  .    .  .
.     .     .  . .  . .  .  .     .... .    ..   .     .... .   ...    . .... .              ..   .   . . .  .             . . .. .     ..  .   . .    ..    .  .
..      .     . . .     ..     ..  .  ..  .   .   .            .  .  . . . .    .       .  . ..    .    ..  . ..  .   ..  .  . .    ... ..     ..   .. .. . ..  .
.   ..  ..       .     . .      . .   .   .  ....  ..         ..  . .   .  . .. .       ..      . ..         . . .  . .    .. ..           . .  .  .      .  ....
.  . .   .   . ..  .. .....      .       . .          .  .. .   . ..  .   .    .. .    .            ..   . ..  ..        .  .       .   . .   .  .  . .  ..   ...
.  ..    ..    . ..  .  .  . .   ...     ..     ..     .   .. .. . .     .  ..  .       ..   .   .   . .   .      .   .      .    .     .      .   .   ...  .   .
..       ..  ..   ..      . .  . .. .  . .   ....   .. .   .           .    .     ..    .     .   .  . ... ...  ..               ..    ..    .      . .        ..
.      ..  . .   .  ....  ..  .     ... ..  . .   .   ...     .   .         .  .. .  ...  .  .  .   . ..             ..   .     .    ...   .    .        ..  .  .
.          .    .   .    . .     . .        ...   ..  . . .   . ..   ..    .  . .  .     .....  .   .  .          ..  ..    .    .  .           ...  ..  .   .  .
.    .  . ..     ..    . . .  . . .  .  . ..     ..       ..       .  .  . . .. .   . .   . ..  .  . .      . ..    .     .   .    .    . .      .      .       .
.. ..     .. .         .  ... .  .  ..    .  .    .... .  .  .... .  .. . .    .    .  . . .. .          .. .  . .   .  . . ... .       .    .   .  . .    .. . .
.         . ...  .. ...  . .         . .   .. .     .    .   . .  ...  . .. .      .  . .    .  ..  .      .  . .. .       .  .     . ..   ..  . .    . . .     .
.  . . ..   ..      ..  . . .    . . .         .     .. .. .  ...   . .  . .  . .  ... .  .  .   .   .     ...  .. .   .  ..   ..      .   ..    . .   . .      .
. .      ..   ..          ....   . .    .   .  ....  .  .. . .       . .    . .  .. .  .  .  .     .  .          ..     .     ...   ..  .  ... .  . .     .     .
..   .... .  ..         .      ..       .  .   ..  . .  . .       .. ..  ... .    .            .   .. .   .... .   .      .    ..              .  ...  .  ..   ..
.    .   . .      ..  .. .       ....       . ..   .   .  . .    .      . .   .    . .       .   . .         .      .. ...        .. .  .. .. .. . .         ....
.  .         ...      .  ..  ...        .. .. .   ...         . .       . ...         .        .     .              .         ...    .           .      ..      .
.      .  .    .    ...   .  ..   .      .  ..     .      . .  .  .   ....   .   .      .    .   ..   . ..    .. .  .    .       .    ..    .      . ...  .    ..
.  . . .. .       .. . . .          .....        .   .       . ..     . . .. .   ...  .   .      ..  .         ..   .  .     .   .  . .  . .   ... .   . .  ... .
.   .   ...     ...             ...   .   .. . .  .     ..  .         . .  . .  ..  ..  .         .    . ..   . .   . . . .    .. .  .  .         ..   . ...  . .
.  .     ...  .      .   . .         .             .  ...    ..   .. .   .. ...   ..  . .       ..     .         ..   .     ..  .    ..  .    ..  .   .      . ..
. .        .  .       .   . ...      .     .  .               ..    . ..  .  ...  . .      ..  . . ... ..  ...   . . . .       ...      .  .  .  .        .  .  .
.    .    . .  .  .       .     ...              .  .    .. .. .     .   .    . . .      .           .     .... . ..  .   .   .     . . .    .. .   .       .   .
..       .      .     .  .  ..   .. .    ..      .. .  .   ..   .     .     .    . .. .     . .   ..    .    .    .    ..     .   .   .             ..     .   ..
..     . . .  .  .     ...              ..               ... .      . .   ...  . .   .      .         . .          .    ...   .      .  ...    .   .  .  .    . .
. . . .  . . .  .    ... .        .  .       ..  . ..   ..   . ..   .    .  .  ..  .    .  .  .         .   .  ...           .  ..  .    . ..  .     ..     . ...
. .  .         .. .    .  .    .... . ... .           . .  .. .   . .    ....   .      . .  ...     .  .     .    .  . .. . .  . ..        . .  ..    . .  ..  ..
...      . .          ..... .           ... .     ... .        .    ...      ..       ..       ..    .      ...      .   .  . . .. ..    .    .   .             .
..        . .    .    .  ...   .    .    .      ..   . .    .       . . .. . .      . . ... .   . .           . . .       ...    . . . ..  . .   . ..  .  . .   .
. .    .     .         .. ... .  .  .  . ..  ..          .  ....  .  .         .           ..  ... .    .  .  . ...  . . .   .  .      ......    ..   .   .  .  .
. ..         .   . ......              ..  .  .                 .      .  ... .   .      . .. .. .  ...  .  .  . ..          . .     ..   .      .  .  .  .   ...
.. .  .. .  .    .  .. ..     ..  .     .  . .   ..  .               ......  .      . . .. .     . .  .   ..  .     ..     . .. .. .   . .      .    ..  . .    .
..     . .          .. ..     .     .  .   ..        .    ..   .. . . ...  .    . .       .   .   ....  .        ..  .   . .        .   .  ..   .      .   ..   .
...      .  .     .  ...  ..     ...        .  .    .  .. ..  .  . .... ..           ..   . ... ....       .         . .     ..       ...                       .
.              . ..     ....             .       .    . .   .   ...   .       ..   . .. .  .      ....    .  .. .         .   . .    ..      .     .     .   . ..
.  .      .       ...           .   . .    . .. . .     ..    .   .         .... .    .            ..  ..    . ... ..  .   .   .        .  ..  .     ... .  .   .
..   .            .     .       .  ..    .     .    .        .          . .  .   .   .          .  .  .  ...     .  .  .. .  . .. .   .  .. .     ..  . .  . .  .
.     .       .    . ..... ....  .     .  ....  .      .   .      .             .    . .. . . .  .   .  .      . . ..         .  .  .        .     .         ....
.   .  .  .     .   ..   . .           .  .     . . .   .  .   ..  . . .    ..  ..          .  ..   . .. .  . .        ..    .   ..  ..  . .  .   .   ..  .   ...
.  ..   .  . .    . ..    . ..       ..   .   .  .   . .   . .     . ..  ..  ...  .      ...  ..    .      .    .   .     ... .    ... .. ...    ..  .     . .. .
.. ....         .     . .   .    .          .    .   . .  .. .   .   ..                .      ... . . .            . .. .          . .   .. ..      .. .   .. ...
.  . .    .  .     .    .  ..      . .    ..     .   .  .            . .     ..   .   . .. .       .      . .       ..   ..          .  .  ..   .  ..          ..
.. .   . .     ..  .     .  .  .    .  .    .     .  .. .  ..   ..  .   ..  .     .      .     ..   . . . .    ..      .     .  .   .. .  . ..... ..     ... .  .
..     ..  .  ...   .     . .  . . .    .   .  .     ..     .   . ..   .        .. .. .  .    .. .  . . .. .    . . . .  .      . .    .   ...         .  .     .
.  .             .... ...       ..  .     ..         .  .          ..       .  ..  .  . .. .  .   . .   .   . ..    .       .   ..     .. .. .      .   .    .. .
. ..     . .   . .      ... ...   .  ..    .      ..  .          .   .. .      ..      . . .. ... . .  .  .       .         .      .  .      .   .      ..   ....
. . . .          ... . . .  . . ....     ..      ..      ..    .  .    .              .  ..    .  .   .  .   ...  .. .. . ..     . . .     .  ..  .  .   .. .. ..
.   ..  .... . . .. .. .     . .. ..    .   .  .  . .     ..  .  .                ..     . .  ..    . .   .  ..  ..             ... .  .... . . ..     ..  . ....
..    ..  ..      .  .. .  .   ..  . .   .  .   .  .                  .        .  ... ... ....           ...  ..     .    .    .    ..  .  ...     ..         . .
..    .          ..         . . .  .     .   ....     . ..      .   .  . ...  ..      .   ...  .     .  . ..  .    .. ..  .        . .. .. ...        ....   ....
. .    ..    . .  .                .       ..  . .  ..   ..    .. .       . ..  .   .     .  . .    . .   .. .     . . ...     .. ...           .        .  . ...
..         .. ...... .    .   ..   .     ..          .            . . .. .      .  . .   ..  .   .  .  .  .  .         .    . ..    .  .    ...    .. .         .
.        .     .. ...  .    .  ... .    .   ..  ...  ..    ..  . . ..    ..   .     ... . ....     .   ..   ...   .       . .. .         .        ...    .   .. .
. . .    . ...  . .  .  .         .. .    .      . ...  .      . .... ..   . .       . . .        .      .      .   ...  ..       .  . .   . .    .   . .  .  . .
.. ..  .. ..   .  ..   .       ..   ...     ..  . . ..     .  ..... .    .   .     .   .. . .      ..   ...    . .    ..   .. ...          .. . . .     . .     .
...     . . ...    ..  .       ..    .  .         . .  . ..         . .   .    ..   .       . .   . .....     ..  . . .     .    . . ... ...         ...  . . . .
. .     .     .   .    .         ..     .   . .   .  . ..   ..   .     . ..   . .   ..   ..     ...            .   ...    . . .   .. .  . ..   ....        .    .
.    . . . .        . .  ..  . .    ..   .  ..    ... .    .     ..       .  .    . .   .   .  .      .         ..   .   .  .       .     . .  .  ..  . ...     .
.      .  .       .   .     ...    .   .   . .  .  .   .     .  .             .     ..  . ... .. . .  ..  .    .  .   . ..   ....   .   .      ..   . . .       .
.    .         .. . ..  . .    .   .. . .    . .  . .. . .    .     .                  ..  . .. .. .               . .      .    ..        . . . .. .       . ...
.. .   .  ...   ..   ... .  . . .. ..    .   .. .  .        . . ...  ..   .   . ..  .       ... .      ..        .. .  ..       . . ..     .    . .   .    .   ..
.   .     .   . ....  .  .  ..  ...       .        ... . . ....  .   . .    .        .  ... . . .        ..   ... .  .  ..    .   .  ...   .    .      .   .    .
...       ... .     ...        ....        . .  . .    . .   .. . .  ..    .  . .      ..      ..  . .  . . . ..   .               .   .  . .. ..    .... ..    .
..     . .  .         .    ..  .  . .  .    ..           .   .      ...     ..  .  ..   .. .     .. .  . ..       ....     .  .     .  .   ..      .  . .    . ..
.   .       .  . .  .        .. ..   .  ...  .. . . .  ..       .       .... .  .      . .    ..   .   .     .        .. ..         .....   . ..       .    .   .
.    ....  ..  .      ... .  .    .        .   .      .. .      .  .   ..  ..     ..    ..   . . .    . ... ..   ... .      . . .    .  .  .   .       .    .. ..
...                              . .. .              .          ...   .     .      .   .. .. ...  .   . . .            . ...     .. . ..      .     .    ..   ...
. .  ..   . .             .  .       .        .    .   .  .      .  .   ..             .         .    ..   .  . .  .  .. ...      .. .   .      .  .    .  . ....
.  . . .  .    ...  .             . ..      . .  .     .   .   .. ....   ..  . ...    . . .. .         . ..... .   .  .    .     ...       .   .  .    .      . .
.       .   .  ...  .    . ..    ..           .     .  .   .   .  . .    . ..   .       .    .   .    ..  ..     .   .. .     .    .  ...       .   .       .. ..
. .       . . ...   . ....  . .   . .      .        .   .      .   .         ..             ...  .   .     .    . .   . .. .     ...       .  . . . . .  .   . ..
..  .     .   ..   .. ..  .  ....       ..  ..  ...         .   ... .    .     . .    .   .    . .   .. .    ... .    . .   .    .. ..    .. .          ...     .
..  .   . . .    .        ..              .      .   .. .         ..  .         .. . ..            .  .  . ..  ...  .    .      .    . . . .....  .  . . .  .. ..
.   . .. . . .   ...   .     ... .     ..    .. .   .      . . . . .    .  .    . ..     . .   .  .. .         .     . .     ..     .   .     .        . . .    .
.    .    .      .          .                   . .  ... .  . .  . . . .     . . .     ...      .  .        ..  .  ..      .     .  .  .  .    .  ..  .   .    ..
..      ..       .    .  . ...             .  .   ..           . .       .   .      .  .  .  .   .  . . .. .   .    .         .   .  .   . ...        ..        .
.    .   .  .   . .  .. ....  .   .  . . .... .   .     . .. ....  .  .       ..       .  ..        .. .  . .  .      .    .. .  . .  ..  .             .     ...
.      .  ..  ....    .     .     .     .   ..  .                  .  ..    .  .    .  .   .  . ..  .     .   ..  .   . ..  ..  ....    . ...        ..  .    ...
.  . .  ... ..     . ... . . .    . .  .. . ..      .     .. . . .        .   ...   .  .. .      . .. .      .   .  . . . .       .  . ..          .          . .
.... ... .   .  .       .. ....  .....   .   . .    ....  .   ...  ..   . ....  ..  . .          .    .  . . .    .  . . . .  . .   . .   .... ..  ..  ..   .   .
. . .. .   ..       ..  .    ..        . .   .      .             ..   ..        ..  . .      .   . . . . .. .  ..        .   .   .   .   .   ...  .    .       .
.    .      .. . .. ..  .  .     . . ... .. .            .   .. .            .          . .       .                  .     ..  .   ..     .  .  .          .    .
..  .. .  .       .      .  . .  . .         ..             .. .    .      .  ...               . .   .  . . .  ...         ...    .    .  . . ... .       .  . .
.   ...   .  .. .      .     .      .     .    ..           ..   .  .     . . .  . ...               .       .   . ...      .        ..        ..  .. .   .   . .
.            .  ..       .     .  ..    . .     . . .  . .    .    .       .      .       . ...  .  .  .   .     .....         .  .  .   ..  .     .....  .   . .
.   .     .      .  .    .  . .         .  .       .   ...  .  .     .  .    .  . . .   .  . . ...    . .  . .   .  .     .  .   .. . . .   . . .  .  .         .
.  ....    .. . ... .     . .       . .   .   ..  . .       .   ..       . ..  .  .  .    ..  .  .   ...   . .. .   ..  .    .. .        .   .   .       .   .  .
. .   ..     . ...   . ...        . ... .   .        .  .  .      ..   .    . ..          ..  .  .        .  ..   .  .       .    .     ..      . ..   .    .   .
.  .        ..    . .               .. ..       . ...  .   .      .    .  ..   .       .   .   .  . . ..  ...       .  . .           .       .    .           ...
. .   .     . . . . .. . .  .. .    ..   .  .  ... . .  .  .  .  . . .    .  ..  . ..    .. ..   . .       .     .      . ..           .    .    ..   .  .     ..
.... .   .. ..   ..   .      .        .  .   .  ..  ..   . . .      .  .. .    .  . .  . ... . .. ..   .. ..      . ..   . . ..      ..  .     .. .  .  .       .
.     .       .    . . .      ...  . ..  .     .    . .  . .....    . .  .. ..  .. ..  . ..... .  ....    .. .  .   .  ..  . ..  . .    .  .     .      ...     .
.      .  .  . .. .   . ...  .   . . ..  ...    .      . ..     . .         .      .. .      ...   .     .  .  . .  . .    .        . .    .          .   .     .
.    .           ..  .       . . . . .  .     ..   .  ... ...   .  .    .      . .  .   .         ..     ...  . . . .   ..        . .   . .    . . .. .    .   ..
.    .    .  . .  .    .  ..  .             . ..  .   .  .         . .  .  .  .   ..        . .   .  . . .    .     .  .    ..  . .  .  ...  . .  .  . . . ..   .
.  .     .... .    ..     . .. . ..               .  ..    .    ..  .   .. . ..  . .      . .  .       .. .  . .    . .     .  .       . .    .       . .  . .  .
.    ..     . .             ...  .    .         ..   .  . .    . . ..       .. .   ... .     ..   .  . .  .   ..         .   .  ...  ...     .         .       ..
.  .      .  ..  .  ..       .   ..  . ..      .   . ..      .  .    .         . ..      .       ..     .     .   .   .... ..  .  .. ..  .       . . .   .. .   .
.. .      .     .   .          .   ..  . .    ..   . ..             .  .       ...   . ..          . ..   ..   ..   .. .  ..  .  .     ... .              ... . .
.       .    .. .     . . ..  .                     .. ..   .  . . .  .   . ..    . .        .... .. .        ..       . .             .     .  .     .    .  . .
. ...  .  .    . .    ..   ..... . .   . .  .       ........      .          ...      ..     ..  .       .  .          .       .  . . .. ..  .   .   .  .   ..  .
...    . .  .      . .   . . ... . ...       .    .  ..  .   .   . .  ... . . .     .     .  ....   ..     . .            .. .. .     .  .  .    .  .  .    .   .
.    .   .. .  .                   ..   ..     ..  .    .     .   . .    ..  .    . .      .   .   . .         . . .              . ..  .       .     ...       .
.        ..   .. .. .  .  . .              ...     .   . . . . . . ..   .   .    . .  .   ..   . .   . ..        .  ..       .  .   .. ..  .  .  . .        .   .
..       . .    .   ..       ..   ..     .  .   .   ..  ..  ..  ..  . .. . ..        .. .        . ...  . . .  . ....    .    . .        .       .  . . .  .    .
. . .... .       . ...      .    .  . ..  ..  ..         ..    .  .  .  .  .    . .. .     .    .    . .      .  .    ..   .    .  .   .  .    ..      .    .   .
.. . ..        ..  . . ..               ... . ..      .       .. . ..  .  .   ..     ..  .            ...     .   .     .. ... .  . .     .     ..          . . .
... .   .    .     .  ..     .    .          .    .    .     ...    ..    . .   .     ...  .         .  . .         .  ....  . .. .       .    ... .      ..    .
.. .   ... ...        .   .      .... .   .   .  .  .   .   .       .   .      .              . .. . ...         . .    .   .  . . . .    .      . .   .. ..   ..
.... .   .  .  ...  .  . .   .  .  .       .      .  . ...  . .      .   ..              .   .  .   ..         . .       .      . ..   .. .     .. .   ..  .. . .
..  ..  ...      .    .       . .   . ...         . . .   .. .   .    .  .           . . .            . .    . .  .    .   . ..     ..     .   . . .   . .    ...
. .   . ..  ..   .  .   .  ... .  .     .       . .. ..      . .. .    ..     ..  .   .    . .       ..          .  .. .     ..  . .  .   .  .  . .  . ..       .
.  .   ..   . .   . ..     .     . .... ..  .   ...  ...   . .   .. .    . . .   .  ..    .   . .  . ..            .   .    ... .  .  .   .     .        .   .  .
.      ..  .     .    .. .   .   .    . . .. .      . .         .  .  .    ..  . ..   ..        .    .     ..  . .  .   ..         ....    .    .          .    .
.  .    .     . .   .  .  .     X       .     .. .     .     .        .   .     . ..  .    .. ..  . .  ..        . ..   . ..           .  .  .    .   .       . .
..   .     .  .....  .   .. ..          . .   ....  . ..              .  ..  ... ..   .  .      .... .    .  .     .                .   . .   ..   ..   ... .  ..
. .             .  ... ..     .     .  ......       .  .      .   .   .     ..  . . ...    .   .        .     .     .   .    .  .... ..   .  .     .. ..   . .. .
.  ..       . . . .     . . .   . ..      .    .      . .  ..   . .       . . .      ..  .     .   .. .          . . .  .    .  . . .. . ....  .       .   ..   .
.  . ..     ... .     .    .    . .     .  ..   . . ..     .  .    ...        .   . .               .   ..     . ......  . ...    .  .   ... ... .  . . ..  .....
.   .      .    . ....     .        .                .. .   ..    .           . .                . . .       .  ...   . .      ...      . . .        .    .  .  .
.   .       . ..   . ..      . ..   . ..         .   .  .      .    ... .  .      .        . .  .      .   .  ..   .   .      ..  .   . . .  ..    ..    .. .  ..
.  ..      .      .    . ..  ..     ..  ..      .    . ..  ..     .     . ..  .  . . .    .  .       ..   ..    . ...  ..   ...    ..    .. . .   .         . . .
.  ...  .. . . .  .      .   . . ..    .       .      ..   . ...    . . ...   .     .    .        .. .      .  ..  .      .  . .    .     . ..    .    . ...... .
..  .       .    .   .  ... .   ..     .  .    .  . . . ..        .    .   ....   .  .    ..        .. .   .    . .  ..   ..      ....  .  .   .. ..  .    .  . .
..    . .  .. .   ... ..    . .. .   .      .   .        .. .     .  . .. ...   .. . .  .     ... ..    .. . .   . .. ..   ....       . . .. .              .   .
.  .. ...    . . . ..      .     . .      ..    .  ..   .  . .   . ..          .            .  ..  .  .     .           .    ...     .  . .   .   . .           .
.          .      .. . .     .   .   .   .     .   ...  .    .      .             . .. . . .      ... . .    . ...      ..          ..  ..  .   .     .  . .  . .
.   ...    .     .  . . .. .. . .  .  ..     . . .    .  ..  .       . .         .. .    .  .  ...  .  .          ..      . .   ...         . .    .       .. . .
... .  ..    .    .    .   .     ..  .. . .  .          . .  .  .. ... .  .      .  .     ..    . .. .      .  .    .   ...    .   .     . . .   . .    . .  .. .
.  ....  .. .   .  .  . .     ..    .. . .   .   .  .   . ..    ..  ...    ... .. .      ...  .      .  ..   ..  . . .    .     .   .    ..    .   .         .. .
.  .       .        .       .  .    .      .  .   .               . .       .     . .     . . .  .         ..  . .    . . . .    ..   .    .  ..   ..  .  .    ..
.    .     .       .      ..       .     ...      . .. .    . .   .        .        . .  . .. .   .   .       .   .  .. .         . .     .  .   ...      ..    .
..  .   ..    .      . ...  .   ..     .   .     ..     ..    .    ....  . .       .   . .       . ..    ..  .   .      ....        . .             .    .     ..
..        .  .    .  . . ..   . . . ..          .   ...       .      ...  .  ..  .   .          .    .  .        .      . ..    .       .   .       . ..      ...
.   . .  .  .  .    .     .    .              .     ..   .       ..    .. . .   .   .  .   .. .       . . ...     ..    .. ..  . .      ..  .  .  .  .    .  .  .
. .   . .        .  .     . ...        ..       ..       .      ..     .     .  .. .           ...    .. .       ... ..      .. ..               .  ..    .    ..
.  .    ..  . . ..   ...     .. ..   . .  .    . .             .     .  .    .    .  ..  ... .   .   .     .. .  .  .   .  .  .  .. . ..    ..  .  .    .    .  .
...   .. ..   . . ..    . ..               .      ....   .     ...      .. .  ..   . . .  .. ..  . .  .   . ....  . .          .   . .. .   ...    .  .  .   .  .
.. ..  . .       .. ..      .   .             .         .. ..  . .  .  .  . ..  .   .     ..   .   .   ..   .. . . .    .     .     .     .  .               .  .
.  ..  .   ..       ..     .   .. .  .....        ..  ..        .     .        .    .  .  . .   .. . ..     .. .   ..       .  .   .      . .   .   ..     . .  .
. .          .     .      ....  .  ...        ..       .. ..        ..   ..    . .  .  ...  ..         . ...   . . . . .. .  .     ...      .  .    . ..       ..
.  . . .          .. .r    .   . .  .    . . . ..       ..  . ... .    . . .  .   . . .    .   .  . ..  ..     .    ...      .   ..  .            ..     ... .. .
.................................................................................................................................................................
