..................................................................................................................................................................
..  ..             .  .   ....  .. . .  ..    . . .  ..  .            .      ..    .     .   . .. .  .       .   .  . .   . .    .   ..       .   .   . .. ..    .
......  .. . .  ....  .    .    ....       .    . .    . ..   ..   . .    .   .  ...      .    .. .    ...  . .  .      ...    .    .        . . . .   .   ..   ..
... .  ..    . .     .       .      .. . ..  ..       ..       .  . ...  .  . ...    .        ...  .     .  .  .      .      .   .  .  .. . . .. .     .   ..   ..
.   .  .        .      ...    . .   . .  .  .    .  ..  .   .      . ...             .   .. .   . ..  . . .  ..  .  ..    . ..          .  ..    .....        . ..
..       . .    ..       .   ..  .  .  .  .    ..  .  .   .   ....      . .. .   . .  . .          . .  . .   .. .   . ..  ...     .     . ..    .     . .    .  .
. . ...    .   .   .      ...  ..     .. ..  .  . ...    .  ..  . .  .  ..   .  . .  .       . . .   ..     .  .      .    . .  ..  .   .       .      . ..  .   .
.      . .  . .    . . .. ..      .    .    .... . . ...  .    .    . .   .. .     .   .      .   . .   . .    .  .      .  ..      . .... .    .. .    ..    .  .
.  ..  .       .... ... .     .   .    .  ....       ..    .  .      . ..    ..  .     .      .... ...  .. .       .. .. .        .            .  ..             .
. .    .  .  .. . ..  ...  ..  . .        .  .....     . .       .    .   .   ...  .... .      . .           .    .. .. .   .....   . ..      .      .  .    .  ..
. ..         .  .    .. . ..   . ... ..  ...     ... . .  . ..  . ..      .   .  .    ...  .  .   .       .  .        .     ..  ..   ..    ..   ..        .  .   .
.   .     .. . .         . . .    . . .   . .   ..  . .         ..   . . .    .   .  .  .         . .. ..   .        .                  .   . .      .    .    ...
.    .   ..    ..   ..  .    .. ...  .  ...    .  .               .        ..      ..     .   .           .   .   . .   .    .. .      .. .       .    . .      ..
.       .  .. .   .   .         . ..    .  . ..   .                .     ....   .  .     .   ..      ..  .  ..        ..            .  ... ... ..  ..  .         .
..    .      . .  .  .  . ...  .     .   .   .        ..  . . ..     ... . .        . .   . .  . .  .   ... . .           .   .     .    .             .  . .   ..
.  .        ..    . .. . . . .       ....  .     . .         .  .        .      . .  . .  ..  . .    .. .    .     .. .      ...    .  . ...         ..      .   .
.    .. ... .    . .  .    . ..   ..        .  ..  . ..   .    .  . . .. .  .   ...  . .  .   .  . . . ...           .. ...   ..  ...    ..           . .        .
.    .  .  .  .        . .             .  .       . . . . .   .   .. . .  .       .       ..    ..          .  .   .. .       ..  .  . .  .  ..  ..   . ...      .
.    . .    .  .  .           .  .      ..                  ..  . ..    ... .    ..        . .    . .       ....   ... ..    .            ..    .  .  .  .   .   .
.  .           .    .    .      .       .   ....      .   .  . .      . .    .   .. .    . .        . .. . . .. . .  .   .  ..   ..    . .. .  .    .   .  .   . .
... ...           .      .   .  .       .   .. . ..  .             .   .    ..   .     .   .. .   ..               .  .  .  .. .    .  .   .  . .    .   .  .... .
.  . .... ... . .. .   . .            ... ..   .     .   .  .   .       ... .  .   . .   ..    .  . . .  .    .   .....      .        .. . .   .    . .  . .  .  .
.         .. . .       .   ..    . .   .      .. .   ....     .     .. .      .  ..   .    .  . .  ..       ..   ..  ... . .    .. .  ..               ...  .   ..
.   . .. .          . .    .          .       .  .         .         .  . ..  ...     ..  .     .   .  . . .   .  .    .    . . .  ..    .    .      .     .    ..
..  .  . ... .        . . .....   .      . ..     .. . .    .   .  .. .. .   . ..   .      . .   .     . ...  .       .     .. .   .    .  .  . .       .   .   ..
... .      .  ...      ...  .     .          .      . .... ...     .    .  . .  ..     ..     ..  ..  ..  . ..   ..   .   .  ...  ..   ..       . . .. .     .. ..
. .  .           ...        ..   .       . ..   .. .     .        ..    ..  .  .     .       ....        .  .     .   .... .   .  ..  ... ..    .    .. ... ..  ..
. .        .      . .  .  .   .  .  . .    .    .      .  . ..  ...         . ..   .     . .    . .     ... . .   . ..   ..  ..   .. .. ..  . .   .   .        ...
.  ..         .  .   ..   .. ..        . .  .    .    . . . . ..      .     .  .   .     .            . .   .  .      ..  .  .   .      ..         ..      .  .  .
. . .   .  .    .       ..  .  .      . . . .. . ... ..     ...   . .     ..       .     . ..  ..  .  .       . . . .  . .    .     .     . .  . .. .     .   . ..
.        ..     . .   . .  .        .       .   ..    .              . .  ..   . .    ... .  .   .                .  .   .   .    .     ..  . .. ....     .  . . .
. .. ..         .  .      . ..   .  ... .  .  .     ..            . .       ..  . .         .. ..   ... ..   .....       .   . .   .  .  .....  ..      . . . .. .
..  ..        .        .    ....    .    ....       . ..   . ..     . . .. . .           .     . .     ..    .   .  . ..    ..         .  .  ...  ..  . ..  ..   .
...   ......  .  ..        .     ..     .  .    .   ...    .   ...  .   . . .  .    .   ...     . . . .    .    . .     ..   .      .     . ..    ..        .. . .
.   .. .  ...      .  .      .     . . .  .   .  . .   ..         .    .  .  ..  ..  .   . . .. .    .. .    .  .       .    ..     .  .  .  ...     ..     .    .
..    ...      ..  ..           ..       .      . . . .. .     . .  .      .            ... . .....    .   ..... .  .      .. ......       .      ..  ...  ..   ..
. ... .      .     .   .   ...    .  ..     .    .   .      .. .....       .  .. .   .. .. . .. . . .        .        .   ... ... .. .  .  ..       .  .. .     ..
.  .. . .. .   ...  .   ...  .  .   . ...     .  .    .    .   .     .  .   . .  .       .        ..   .   .   .   .   .  .   ..  . . . .  ..  ...  . .  ...  . ..
. .      . . .     .     .  ..                    .    . .      .    .....     .. .  ..  .       . . .   ..     .   .    .  ..             . .    .        ..    .
. ... .       .    .  ..... .  ...         .   ..  . .   ....  .  . .  .  . .  . ..   ..                  .   .         .....    .....  .   ..  .  .  ... .  ..  .
. .     .. ..  .  .. .    .      .    ...  . .  .          .  .    .     ..       ..  .   .    ..   .  .     ...        .     .    .      .      .   .    ..  .  .
. .   .   ... .   .        ....   ..    .       . .  . . .   ... ..       ....  .                .  .  . ..    .  .         ..    .  .  . .  .   .         ..... .
.   .  .  ..     ..    .      .. . .  . .         ..       .         ..   .            ..   .       ..   .      ..   . ...   ..        ..   .   . .   .. .  .   ..
.  . ..    ...           . .   . .. .  .   .  .    .    ..        .. . .  . .  ..  .      . ...   . .    . .  .  .  .        ..      ..  . .      ..      .. .   .
. .   . .. ...    .     .   .. .. .      .     .   ..    ..... .. .      .     ..       .   ..  .   .     .    ..     .. ..   .   .        ...     . .   .    .  .
...  .  ..  . .  .   .   .   ...   ...           .      .         . .  ... .. .        .  .  ..  .     . .    .               . . .  .       .    .   .    .     .
...     .       . . ..      . .   .. .   .  .. .  .        .. .  ..  . . .    .   . .     .  . . ..  .           .      .  . ...  ..     .  ... .   ...    ...   .
..  .  ...  .   .  . .. . .  ..   .   . .  ..     .      .   .   . .    .  . ...       ..   .  .   .         . .       . .                 .  .   ..     .     . .
..        .       .          .    .   . ..... ..  .  . ..  ..       .    ... .  .  .      .         ..   .. .         .   . . .   .    . .   .    . ...        . .
...  .          .        .             .        .  .  . .     .    .. ... .        .. .    . .  .   . .    . ... ..    .             .    . .    .  ..  .        .
.  ..                 . ..  .    . ..     . ....   ... . .  .     .      . .  .     . .. ..     .      .  .. . .  .   .  .   ....    .  .  .    .. . . .  .   .  .
.        .. .    ..       . . ...               . ..   .  .    .   . ..    ..    .. .   .   .  .            .  . ..  ..  .  .  . . .    .  .      ... .       . ..
..      .. .  . . ..             ....   .. .   .  .    . .. . .  .   ..        . ...  .      .    ..   .   ..   ..       ..  . .       .    . .   ...    . .  .. .
....  ...       . .   ...          ..  ..  .     .    .     .          .   .    .. ..          .   .   . .        .. .  .  . .   .    ..      .. .     . .  .    .
...       .. .   ...  ..     .  ..     . .  . ...  .... . .  .  .  . .    .          .   .             . ....       . .    .  ....  .         .   ..     ..      .
..    ....  .   . ..    ..       ..      . .. .    . ....    . .  .. .      . .          . . .          .         . .      .     .     .   .. .  ..    .   .     .
.    .          .     .    ...        .    . .  .   .      . .  .         .   ...    .       . . . .       . .  .  ..       . . .   .  . ..   .    .         .  ..
.  ..  .. .  .. ......  .   .    . . . .    ..    . . .    .     .       .  ..  .  . .     .       .         .    .  .. .  .  .          .   .    .... . ..  ..  .
.   . ..  .. .. ..  .   .    .  .  .  ..       .           .     .   . ... .    .        . .          . ..  .   . ...    . .  . ...  .   .  .   ..  .            .
. ..      ...   ....   .   ...   ..       ..   . .    . .        .    ..  .. .      .      .   .   . . .         .   . .. . .  ..    . ..  . .   ..     .  .     .
.  ..  .   . .  . . .  .. ..   .      ..     ..     .  .   ...   . .  .  .. .  .   .  .    .      . ..         .     .  . ..          ..  . .    ..   . .      . .
.      . ..  .    .              ..          . .   . . . . ...     ....      .  .    . .   ..          .  .         . .  ... ..      .. .  .  .     .    .. .   ..
. ...     .   . .   . .  . .  . . . . .  .  .. ... .    .      .   .   .    ....     .          .. .       .        .. ...    . .     ..      . .  .  . .   . .  .
. .   . ..  ..       .  ...   . .          .    .   .  .. ..     .   . .    . .   ..     .     . .   .. ..... . .  . .             .. ..   .         .   . .     .
..  ..  ..    . . . .     . .     . .      .              .                .           . ..        ...  .     .   .      .       .  .          .   . ..      . . .
.   .     . .. .   . ..      .                 .     .       . .      .. .. .. .   ...      .  .   .        ..  .  . .  ..        ....   .. .    ... .. . ..  .. .
. .        .    .     . .     .   .  .   .   .. ... .  .. . .   . .         .     .  ..        ..... .   . .  .  .           .   . . .    .        . .. ..       .
..  .. .     ..     .    .    .     ....   .    . ..    . .          .. .  ..     . .         ...   .  .               .  .. .. ..         .       ..   . .      .
.  . .          . . . .  ..        .      .     .. . ..        .     ...    .    .  .    .      .   .         ... .  . ..    .... .     .    .     .  ..      . ..
.     .  . .          ..      . ..  ..             .   .  .  .   . .   .  .  .  .  .   ... ..  .  ...        . .              ......  ..  .  ....    ..   ..   . .
.    .    ..     .           .. .   .. . .. . . .  .....   . . ...    ..  .    .....      .. ..  .  .    ..  . ..  .  ..  ...   .   . .      ..   .       .     ..
.. .              .. ..    ....   .    . . . ...   ...       . .   .  ..         . . ......     ...  . .    ...    .   . .   .  .   . . ..    . ..    .  ..  .   .
.    . . .... .  . . . ...         .     .  .   .      .        ..   .     ....  .   . .      ..   .. .  .   . .  ... . ..  .  .   . .... .        .     . . .   .
.   ...       . . ..   .     ..    .   . . ..  . .  . .    . ..   .   .   .   ..   .     .   .    .  .           .      .     ..   .   .   .  ...   .   .  . . . .
..  .. .   .   .. ..  .  ..  ..   .  .  . .       ..    .  .     .  .      . . .   .  ...   . . .    . .        .   .   .. .     .. . .....   ...       ..   ..  .
.   .....   . . ..   .. .   .         . . . . .  . ..      . .    . .. .             .. .              ... ... .   ...   .  ..   .. .    .         .   .. .    ...
..  .  .. . ..  .  .      ... .    .. .    .   . .  .       .    ..     . .     ...    . .   . .      ..       . .  ..        .        .    .  . .       ..  . . .
.  .  .     .  .. .. ..        .     ..  ..  ....  ..   .     .  .  ...  .      .   . .     .         . ..     .  ..  .  .   ..         . . .        .  . ....  ..
. .       .    . .. .      .. ..         . .  .    . .     .  .   ..       .   .   .     .  .    ..       .     .  ...     ..     .    . .  .  . . .  ...  .     .
..     .. .  .  ..      . ...  .....     .  ..  . .. . .      .       .    .  .   .  .    .  . .         .  . .  .   ...  .     .   .. .  .  .        .     ...  .
.   .        ... .   . .      .  .  ...   .   . . .   ... . . ..    . . .. ...... .    .   . .        . .   .  ..   .    .   . .   .   . .   .      . .   .     ..
..    .  .   .         .    . .   . . ..  .    .. ...  ..   . ....   .  .  .  ....        . .. .   . ..  . ..  .  .   .    . .   .     . .      . . ...     .    .
...    . .. . .   .   .         .  .  .  .. . .  ..       . .      .  . . . . .   .  ... .  .   X      . .   .      .. .     . ..  .   ..  .      .  ... ..      .
. ..  . .   .    .    ...  . ... ..     ... .         . .       . .. ..    . . ..   .  .  .  .     ...     . . . . .       .  .      .. .  .   ..   ..  .   .    .
.     ..  ..  . .       .          .       .. ..  ..  .        . .  .. .  .     . . . . .   .      .       ... . .     .   ..  ... .   .. ..   .      ....       .
..  .     .      ..  .      ..    . .  .         ....      . .. . . . . .   .  .          .  .                            .      . ... . . ..     .  .       . . .
.      ... . .      . ..  .  ...   .    . .  .   .        .    .      .. . . . .  . . .     .      .  .. .         ..   .     .       .     .. ..    .. ..     ...
.      . . ..   .  . .      .         .    ....  . .  .   . .         .    . .  .   ..   .  .  ..   ..   ..  .   .             .                   ...    . . .  .
....    .     ... ... .      .          . . ..   . ..  ..           . .  .     ..  .    .  .   .. .  .             .   .   .. ..      . .    ..    .        .    .
.      . .   .     .   .. . .  ..   . .                 .       ....    .    ..       .    .        .    .    ..   .  .    .       . .      ..    ....     . .  ..
..   .  ... .  .   . . .   .     .   .    .  ..        ....  . .       ..  .     .   ..  .    .     ..     .. .   .   .. ..   .  .           .   ..     .   . .  .
.   .      ...    .     . .     . .    .  . ..  . .      .     ..   . ... .     ..  .         .   . ..            .  . ..    . ...    .   .    .    ..  . ..     .
....           .         ... .   . .     ... ..  .   .  . .   .   .    . ..    ..   .  .  .               .     .    . ..  .   .. . ..           .  .     ..   . .
.             .   .... ..   .   .         ....  .   .  .      .   ..    . .   ..    .  .   . .   .. ... .  .   .     .    . ..     . .        .  .         .   . .
.      .        ..  . ..   .    .  .    .  .. .   . . ...   .  ...  .  .   . . . .    . ..  . .  .      . . .      .     .. .. .. .. .. .    ... . . . .. ..     .
.. .. .  .. .    ..  .    .  . .            .     ..   .  .. ..   .   ..    ..    .. .   . .    ....   .    ..  .        ..     . . .   .   .   .  .    ...   .  .
..    .   .  ..       . ..   .  . . .      ..      .  .  . ...     .  ...  . ..        .       ... .    .   ..        .   .      ....      .  .   .  .     ..    .
.  . .   .    .  ..   .. . .                      . .  ..       .    .  ..  .  . . .  . .    .       .    .     .    .    .   ..   . ..         .     .   ..  . ..
.      . ..    .      .      . ....  .. ..   .  .         .       .  .. . ..     .   . .    .     . .   .   . .   .  .   . .  . . . .   .   .... .        ...  ...
. ..    ... . .  .       .. .  . .    .  .    . .                  .       ... .    . .  .  ......    .. .        ..  . .  .. ..  .   .  . ..   . ..        .    .
.   .  .         ...  .. .      ..      ..       . .         . .      .            .   .  .. .    .... .  ..    . .  .   . . ..   .     .  ... .   .  . .   . . ..
. ..  . .   .        .    .  .. .  .   .                       .... . ..        .    . ....      .    . .. .   .   .       ..           .  .  .  .    .   ..     .
..    ... ..  .. ..  ...  ..  ..  .  .   .   .      ...  .               .    .. . .  .  .      .          ..      . .           .   ....    .   ..   .          .
.    .   . .  ..      .              .   .       .          ..   . . .  ..    .   .... . ...           .. ... .   .    .     .  . . ...   ..    ..  .  . ...     .
.     ..         ....   .  . .   .   .      . ....       .    ..   . .. .    .     . .      ... ...        .       . . ..            .     .  . .             .. .
.   . ..           .  .      .      . ...      .   ..     . .         .   .. .    .   .  .. .  .    . .     ..   .      .  .. ..    . ..  . . .  .   . . ..      .
.               . .. .        .  . ..        .  .  . .     .  .   ..   . . .    .  .... .     ..      .  .. .      .     .  ..        . .                  ..    .
. .  .   .  .     . ...       ..    . ... .     .  ...    .       ... ..      .   . .              .. .   ..    . . . .  .  ... . .  .   .     ...    .          .
.  .   .   ..  .. . .   . . . ..     . .   . .       . . . .. . .. . . ..  .   ..     ..   .      .       .  .      .  .       ..         .       . .   ..    .. .
..  .     ...      .       . .. .  . .       ... .    . .  .     .... .   ..       .   .   .       . . ...  .  ..  ...        .  . .. . .. .   .   . .. .     . ..
.   ...       ..   ...    .  ..  . .    . . ..  ... .    .   ....  .      . .   .  .  . ..... .. .....         ..           .. .             .. .        .      ..
.  .    ..                   .. .   .  .  .  .          ..           . .    ..  .   ...    . .... .    .   ..  . .         . ..    ..  .           .  .   .    . .
.   ..  ..   . .  .               ..   .   . .  .  ...    .   . . . .  ..  .    . ..    .     . .  ... .    .   ..  ..      .   . .   .  .   .      .  . .    . ..
.   .. .....  .    .  .. ..       .. .    .   .     ..... .. ..       . .  .       ...                .     .   .  ..  .     . .  .  .  .  . .. ...     .   . .. .
.            .  . .    .         .   .   .          ..      .  .  ..     .  .  .     . ..  .. .  .    ...   .  .          ..  . ..            . .  .  . .  .    ..
.  ..     ..   .... ... . ..   . .  ..      .        ..  .   .    .  .   ..      . ..  .             .   . .            ...      .  ..... ...  . . .. .     .  . .
. .. .  . .       .   ..    .   .    .   ..          .  .  ...  ...    ..                  .. ..      ...        .         .  .        . .    ...  .       .... ..
. ..   .  .   .. ..      . ..    .   . . . ..   . .  .     . .. ....   .  . .        .     ...     . .   . . . .     .      . .       ..    .    .    .  .    .. .
...       . .           .  ... . .          ...   ..... .   ..      ..    .    .  .. .  .           .        . .  ..    ..  .         ..  .  .. ..  ... ..      ..
.         . .       ...  . .      ..  .    .    ..   .. .    .    .. .  ... ...       .    .   .         ..     .   .  .   ..  .    .  ..  .    . .   . ..  .   ..
..     .         .   ..   ....  .    .. .. .....  .   ... . .       .    .        . ....   . ..       . .   . .                  .      .. . .  .    .     .    ..
..  .   . ..       ..               ..  ..     . .  .  .......       .   ..    ..  .     .         .. .  .. . .  .  ..     .       .  .   .....  .      .. .   ...
.       . .  ... .    ....             .    ..     . . . ...   ..   .   .  .      . ..   ... .      .. .  .  .   .   . ..       ..    . ..            .  .  .    .
. .                 . ..          .    .        .  .      . ...        .          ....  .   . . ..  .   ..  ..  ..  . .  .   . .   . . .. .....  . ..  . . .     .
.  .. .. . .   ..   . .   .....     . .       .  .              . .    .. . . ... .... . .....       .   . .    .  .      ...   .      ...        .. . . .  .   ..
.  .       .     .  . . .      .  .   . .    ...   .  .  .     .   ..       . . .   .           .         .   .      ..   ..  ..   . .  ..      . .   . ..  . .  .
. ...  ..   .  ...    ..     .           .     .  ..     . .. .. ..   . .. .   .   . .  .   ..    ..    .  .  . .       . .    .   . ..   .     .         .. . ...
...     . .. . .   . .      . ..    .  .          .    .   ..   .. .. . ... .  .        .  .. .  ......  ....        ..     .   .     .  .           . ... .  .  .
.    . .       .   ... .           .      .    ...    .... .    .    . .   . .  .....   . .  .   .   . .  .. . .   .  .    .   . . ..   .   .. .   .  . . .  ..  .
. .  ..      .  .  .         .      .   .  .     .               .         ...       . ..  .        .    .      .. . .        .           .     .  .... .        .
..    . .     ..    . ...   .       .   ...     .        . .... ..  ..  ....  . .. ..   .   .  .     . .     .      .. . .    ..        .    .   ..      .    .  .
. .  . .. .    .           .. ..    ..  . ...   . .   ..       ..  . . ..  .  .. ..   .     .          . . .        . .  ...      . .    .  .   .   .    .  ..   .
. ..  .   .       .   .    ....    ..       .      .       . .           .  . .        ..   .   .       .    . .           .    ..     .    . ..     .   .. . .  .
.     . .. .  .      .      . .    . .  .     .   .  . .    ..     ..  . .      . .     .   .  .       . ..  . .. .   .. .. . . .    . .  .  .          .   . .  .
.  ..     .  .           ...  .      .     .    .   . . . .. .     .   ..  ......       ..  .   ..     .. ..         .          ..      . ... .....   .    .     .
.     .    ..   . .       ..    .    . .  .. .     .  ..  .     .      ....       .  .  ....  . .     ..      .    .       .   .  .  .  .     . .  .  .    .  .  .
..   .. ... .      .      .  .     . ..   . .     .  ...   ..  . .  ... .    . ..    .    ....   . .        ..      ..           ...     ..    .    ..     .   . .
.   ..  .. .  . .  ..  .    .     .    ..    .      .  .  .   .  .  .. ..     .       . ..    . . ..    ..    ..  .   . .                        .   .. .       ..
.        .  .     . . .      .           .       .    .   . ..  .       .  . ..            .     .    ..     . .  ..   ..   .  .  ..   r           .  . . .  .....
. ...   ..        .         .  ..   .  .    . . .     .  ..        .     .   ..   ..      .  ..              .     ...      .  . . .    .. .    . ..   .        ..
.....       . ....  .. .. .  . .      ..    .  ..     ... . .  .....   ... .  .         ..     .   .. ..  . .     .             .. ..        . .  ..         . . .
.   ..   . .  .   ...     .....     ... .  .   .     .   ..         .  .. .  .. . .    ..  .   .    ..      ..  .   ..  . . .  .  ...  .   ...   .     . ..      .
..       .     ..    . . .... . . .. ...    . .   . .  . .             .  ..       .   ..  .   .    .       ..    .     .      .  . ... . .      .  .  . . .    ..
. ..    .    . . . ... .. ..   . .  ..      .. .   .    .. .. .   . .    .   .  ....  . .    .  .      ..         . .   ..  ..       .        .     .    .. . .  .
.   .      .... . .    .      .  ..    .    .. .   .    .         ..   ..    .  .      ..         ...   .   .    .  .   . .  . . ... .   .    .     ..    . .    .
. .       . .        .     .  .. . ...  ..   .  . .        . ..   .    .    . ..   .  .     . .... ...   ...    . ..    . .               . ..  .  .    .  ..   ..
. .      .    .   .       .. ..   .    .   .    . ..   .  . .        . ..  .        .. ..    .. .      .  ..  .     .       . ...        .    .   ..  .     .  . .
... . ..        . .. . .     .        .           .  .        .    ..       . .    .  .      .. .  . .          . ...     ....   ..    ... . .   .    .    .     .
..     .       ..... .  .      .     .    .  .. ..    .        ..   . . .       .   .   .     . .   .   .   .  .    . ..  .   . ..        .    .   .             .
..   . .... .  .         .        ..     .  ..   .  ..  .            .  ..  . .    ..          .   .  ... .          ..    .... ..        . .            . ..    .
...    . .. . .   .... . . .  .   .    .   . .    . . . ... ..  .   ..       ..        .      ....       ...   .   .       .   .       .... . .    .    .        .
.. .  .. . .. .    .. .  . ..      .  ..  ..        .  .  .  ..      ..    .. ..   ..  .              . . .             ..  .     .  .  .  . . .            .  ...
.  .  . ...  ..    ..  ...    .     ..  . .  ..   .     ..   .    ... .              ...     .    .. .         . .    ...  ..    .            .  . .    ..   . . .
...  .         .  .  .    .   ..   .  ... .        .      .  ..  ..   .    . .    ..   ..  .. ..... .      .          . . .     .      .   . .        . .. . ..  .
. .   . .           ..    . .. .    .   . .  .     ...             .        ... ..       .        .           .    .   .          . .         .. .     .   .     .
.  .  .  ..     . .....    .. .   .   .  ..   ..    .  .   .     ....   .    .        . .   .  . .. . .. .       .     .           .. .  .          ....    .. . .
.. .   .. .   .     . .       .  .    ..     . .   . .       . .     ..  . .       . .      .     . . .  . .  ..      . . . . .      .. .  . . ..     . .   .   ..
.. .  . ..   ..   ..       .   .  . .  .    .        .   .    .      .    .    .      ...  ..  .      . ..        . .  .    .  .   ..    . ..  .   ..        . ...
... . .    .  ..   . . .. .    ..     .                 .. .         ...    ..    . .   .           .     ..   ....    .     .. . .     . .  . .    .     . . .  .
.   .    .           ...  .  ... .      .      .   ...   ...  .        .  . ..       ... .     . . . .. . .       .  ..    .      ...... .. . ..           . ..  .
. .   ..     .    . .. ..  .    .      . ..        .    .       .. . . ..   .    .  .    .    ..      ...   . .                .       . .    .       ...        .
..................................................................................................................................................................
