...................................................................................................................................................................
.            ...      .  .. .  . .   .. .  ..     ..              ..  .  .  .    .  .  . .     .   .  .  ... . .  .    . ..  .  .   ..    .  ...      .  . .     ..
.   .                . .  . .   ..          .   .      .      .         . . ..     ..   ..   . .   . . .   ..  .  ....  . .        . .      .. ... ..  ...   .    .
...  X       .  ..     .  .  .   . .   .  .   . .  .        . . . .   ..     .. . .       . . .     .   . ..  . . . .. ...        ..     ..           .     .  .  .
.    .     .          .   .      .   ..  . .   .  ...    .   ..      . .  ..   .     .  .      ...    . . ..   ..     . .      .   . .  .  .  ..       . .. .   ...
.     .     ..          .   .      . ..            . .  . . .           . . .     .       .  .. .      .    .     .      .  . ..   .  .       .    . .     .  .. ..
..  . .   .     .    .  .      . .. .    .    . .   .   .      .    .   . . .... . .   . .          .  .  ..  .  .    .  .  .   .... . .      ..   . . .      .   .
.  . .. ...   ..   .  ..  ..   ..              .     .        .   ... .....    ..   ... .. ...   .  . .....  .    .  .   .         .  .   .      .     .  .. .   ..
.. ..     ..  ..   .        ..    . .    ..  .   . .        .  . ... . .    .   .     .    .  . .     ..   .  . . . .      .     ..       .   .   . . ...         .
.  ..   .   .    ..         . .     .        .     .  .. ... ..  . .   ..    .  .      .  .      .. ....    . . ..       .   . .   .   ...   .   .   ...  .  . .  .
..     .      .    ...   .   .. .  . .  .    ....   .     .   ..  .. .     .   .    .         .. .   . .    .     ..        ..   .. .     .  .. .  .    . ..  ... .
...  .    .   .  ..   . .   .  .   .      .    .       . .       .      . ..  .    . .    ..  . .  . ..  .   ...... ..      .   . .. . .  .     ...  ..  .     . ..
.  .. .   .      .. .. .  ... .       .   .   .     .  .     .  ..  .       ..  .  . ..  ... .   .  .     .  ..     ....        ...       . .      .   .    .    ..
.    ..         ...       .  .  .  ..   .        .   .       . .   .    .  . .   . .. .   ..            ..       .  ..   .    .       .        .    .     . .  .  .
.  .  .  .         .      . .   .  .        .       .    .         . .      .  . .   .    ...    .  .. . ...             .. .  .  .        .. .     .   ..    ... .
..  .  ..        .  ..  ...  ... ..  .   ...                ..  .    . . ..     .   .     .   .     .      ...         .   .  .  .  . ..   .   . .     . .  .  .  .
. .         .               .     .  . .     .  .        .. ..  . .     . . .  ..   .. .  .  .   ..   .      .   ..         .        .       ..    ..   ... ..  . .
. .   . .      .    .   . .  .  .  . ...... .       .  .  .          .   .      .  .          ...  .    ..       . ..  .  ..     . ..  ..     .    ..      ..  .  .
.  .              .     .     .. ..    ..  ..   .   .    ..     ..  ..     ...             ...    . ..      ..   .   .   .. .  .    ..     . . .     .  .  .  . . .
. .   ..    .   . .  .   ..  .       .     .  .   .              ..     . .            .  .. .      ..  .  .. ..  .   . .     . ...    . ..                   .   .
.  .  .... .         .  .  . . .  . .. .    . ..  .  . .   . .  .    .   ..  . .  .   ... .            .  ...          . ..     ..           .   .  .. . .        .
.        .   ..   . .       .   ....   .      .       .  .   .     .        .  .           .          ..  .. . .. .    .  ....     .  .    .            .      . ..
.        ..  . .  .  ....    .      .   .       . .. ...     . .        . .  .    ..     .          .    . ..          .    ..        ... ..  .  .... . .    .   ..
. .    .   .  . .   ... ..   .  .      . .   ..   .   .   .     .          .    .  . .      .   .  ..  . . ...        .. ....      . .          .      ..  .    . .
. .    .  ..   . .    .. ..  .        . .    .    ..    ..  .     . .  ...   ..  . . .    ..    .. . ..   .  .      .              .. ...       ... ..   . .      .
.   ..   . ... .  .           . . .  ..  .     ... .  . ...     . . .. .                    . .      .    .  ....  . .. .  .. .     . ..  . .  .  . ..  . ..      .
..  .. ..   . . .               ..  .     .  ..     .......   .        .  .  .     .  .     .  .   .    ...  ..   .  .  ..    ..    .    ..  . . ....        .    .
.       . .. . .          .  . .......        .  ..       .    ..  ..       .        .          .     ..  ..      .  .           .    ..  .. ..    .         .    .
.   .  .  .       .   .     . .   .    .         . .  . .  .. .      .    .    ..   .  .  .. .       ..    . .  . ..     . . .    ..  .    .    ..    . . .  . .  .
.     .  ..  ...    .   .. . . .   . .           .     ..    .   .. .           .    ...   .... .  .      .. .   . .        .        .. ....      .    .   ..  . ..
.  .   .   ..      . .    .  . .   .  ..   .. .  ... .     .  . .    ..    .    ..  .  .  . .    .          ..    . .     .. . ..    . .      .        .        . .
.   .  .   .      . . . .   .    .    .... .        .  .....       .         . .    ..   .  .  .   .    .   ..  ..   ..   ..     .  .  .   ... .   .      ... . . .
.  ..   .   ..   ..  ... ...      ...  .       .       .  . . .       ....        .....               .   . .        ..  . .    .    ..   .. . ..  .    .  .  . . .
. ..    .. ..   . . .   .                          . .....  .  .      .   . ...  .   ..  .      ..  .    . .  ...   ..  ... .    . .    .. . .  .   .... .. .  .  .
. . ...  .    . ..     . .   . ..       .     .    .. ..  .   ..  ..  .    . .    .  . . . .... .   .        . .   .    ..  .   ...  . .     .     .. . .       . .
.   .       . .         ..  . .      .  .. .     ...      .   ...  .  . .  ..        .. .  .. ....    .                      .      ..   .   ..      . .      ..  .
. .   . .  .  ..   .         .   ..  .. ..     ..    .    .  . .  .  . .   ...    .      ... .         ..              .   ...... .      . ... .. .  .    .  ... ..
. ... ..   .  ..  .            .     ...     .     ... ..  .. .  . .   ..     .     .    ...  .      .    .    .     ... .     ...  ....   .     .   ..         . .
. ...   .  ..   . ..  .    .    .  ..  .   ..     .      .  .  .  . .  .. .. .   .   ..   .  . .       ..   .    .. .     ......      .  ... ..   .   .     .     .
..    ....          .. .   .  ..       ... . ..     ..     .    .     .      .         .    .  .         . .          .   .  ..       . .  .  ...      . .  ..   ..
.    .. ..  .   ......    . . ...  ..      .   .     .   .  ..   .  .. ..  .   . .    ...       .. .  . ..   .     .  .  .    .   . .   .  .. . ..  . .        .  .
. ..  ..  .             .  .     ....     . .   .   .    ..        .... ..  .        ..       . .  ...              .. .  . ..   . .  .            .  .    .   . ..
.    . . ...     ..  .       .   ..     .    .    .  .        .             . .   ..        . .     .. . .  . .          . .   .. .         ... .  . .       ...  .
. .  .  .     .      . .. .. .     ..    .  ..   .    .. .             ..        .       .  .  . . . .    ...    . .   . .  .  . .  .        ..  . .   .      . . .
.    . .  . ..  .               .     ...           .   ..... ....  . .  .   .  . .. .. .   .  ..  .             .     ...        . . .   .  .  .  ..       .. .  .
.    .    ....       . .. . .      ... .   .  .  . .   . .      .  . ...  .    .   .   . .    .       .    .    ...  .   .    .. . .   .      . ..       .     . ..
... .    . . . ..      . ... .   .   . .  ..   ..    . . ..    .    .  .         .  .   ..  . .  .      . .. .. . .  .       . .       .. . ..     .    .  ..     .
....      .      .  .  .      .  .  .  ..       .  .  .. .   .   ..         .. .     .   ...   . . . ..  ..  .  .  . .. ..    .. . .  . . .     . . ..  . .   .....
.      .       .   .   . .     .        .   ... . .    . .. ..  .  .  ..  . .    ..   .         . ..         .         .    ...   . . .  .        .... .       . ..
. .    ..   .   .. . .   ..  .  ..  .   . ....   ..       .   ..  ..   .   ..      .... ....    .  .     .                    .   .     . . .       ...     . . . .
.  ..  ..     .. . ..  .      .  ..   ..   ..       .   ...  .  .    . ..       ..   . .     .  ..          .... . .     . . . .   ..     .   . .   .  .   . .    .
.  .       . .    .  ..       .  .  ....      .  ...  .. .. .      .    ..   . .  .   .    .      .  . .   .     . ..    .      .. .    . .  .     .        .     .
.. .    .   . .    .  .   .       .  .       ..     .   .      ..    .. .. . ..      . . ..  .           .  .   . . .    .        .   . .. .  .   .   . ..     .. .
.   ....    ..       ..    .   . . .      .         . ...   ..     .  .   ..       .  . ... ... .   ....      .  .  .      . .   ..   .  .    .     .        .    .
.  ..       ..     . ..    . .     ...    .   ...     .                 .. ...  ..         .        .            . .  .       .  .     . . .    .  ..  ..  .      .
.     . .. .  .     .. ...  ... .        .. . .  ..  .   ..    . . .   .       . .   ..  . . . .          . . . ..  .. ....    ..  .       .       ..  .        . .
.   .  .     .. ..    . .   .  ...... .    ...    .   . ..    .   ..     .   .  . . .   .....   .....  .. .  ...  .     .     ..     .      .         . . ..    . .
.     . .. .   .. .   ..    .. . ..   .    .   .    .     . . ..      .    .     .    . .   .   . ....  ..   ..  .  ..        . .   .    . .  .    .    .     ..  .
.  .   . .   .    . .     ..   ..     . . ..  .  ..   ..      ..    .. .    .      .   .     . .     . .  .            .  . .     .           .  .. . . .  .   .. .
.    .. .           .  .. ....  .      .   .            ..    .   ..    .  ...     .        .   .       .    . .   ..         .  . . .  ..    .     .  .. ..    . .
.   . . . .. .     ..   ... .     . .     .  . ...    ..             .   . .  .       .. ..         .   .  . .           . .  ..    . .  .          .    ....  . ..
. .   .  .     ..       .. . . ..      ...     .       .     . .  . .  . .    ..  .    .  . . .   ..  .  . .   .   . . .   .    ..       .  ...    ..         .  ..
. ...       . .... .    ..    .     ....  .   ..              .  ..       .      .    .   .      .  .  ..  . ..    . ..  . .      ...  .     ..        . .  . . . .
. ..  .                   . ..   .   .    .    .  ..      ..     .   . ..    ... ..  . .     .        .    ...     ...    ..     .     ...     .        ..  ...  ..
.. .    . ..        .  ...     .   . .   . .   ..   ......      ..      . . .        .  . .   ..        .   . . . .          .   .... ..... .        .      ..  . .
.    ...      . .    .   .   . ..   .   ...     .         . .        ...      . .  .        .     . . .         ...   ..  ..    .          . .. .   . .           .
..     ..   .   . .  . .        .    .. . .    . .  . .   . . ..     .          .         .           ...   . . ..  .   .   ...       . .  ..    .      .       . .
. ...  .  ...  ..    ..  .   ..  .  .        .    ..  .  . .   .     .. . ...   .  .. .        ..  .   .   ..      .  . ...   . .  .  .   .            .  . .   . .
.  .   ..     ..     .  .....     ..  .  .      .  ..     .  . . . .        ..   . ..  .  .. .  ..      ...       . .     .   .   ... . .    ..         ..   .    .
. ... .      .  ....   .     ... ..     . . . .        . .   .  .      .  ..       ..      . .  .       .    . . .  ...      ..  . ..   .        .    .   ...  .. .
. .    .       .     .   . ...  .... .            . .    ..    .    . .....  .. ..      . ..      .. . .  .  .  .  .           .          ..  .  .       ...  . . .
. . ...     . .  .   . .  .   . .      .        . .     .  ..     .   .   .   .....  .   .           .      . .... . ..      .   .  . . .        ..            .. .
.        .  ...   .          . .      .   .   ...   .  ..  .    ..  . .   .. . .   .   .   ...   .    . .         .. .     ... . . ..  .   ..       .   .    ...  .
.      .. . .      . .        . .  .  ...     .        ...     ..    . .    .    .     .     .        .  .   ..  ..       .  .  ..     .  . .   .       . ..      .
.          .  ..  ..       .      ..     .   . .   .  . . .     .. .  . ..    ..         .   ..   . .  . .  .... .. .  .  ...       ..      .  . .    .   ...   . .
.  .  . .  .     . .  ..  . ..    .     ... .      .  .           .  .  ..       .      .  .  .       ..         . ... . .    ...    ..  .  .       ..  ..   .    .
.         .   .     ... .  . ....  . .     . .      .. ..    ...    .  .  . . . ..  . . ..  .      .  .            ..   .   .     ... .  . .  ..       .....   .. .
....    . .     .      .    ....   .  ..  .    ...   .  .. ..  .  .   .  .  .   .. .     .     .     ...    .  .   .  . .  .   . .  . . .    .  .  .       .    . .
.   .  . . ..         . .   .   . . .   . . . ..  .    ..  .   .  .. .         .        . .   .  ..   . ..     ..  .... . .        .     ... . .    .    . . .. ...
... .. .  .   .  .      . ...       .   .  ..  .. .          .  .    . .... .. .   .  . . ...    .    .  .     . ...    .. ... .  . . .     .  ..       .       ...
.  .    ... .   ..  .  .....  .  .... .  ...   ... .. .   ... .        ...    . . .   .   ..       .  .. . . ..     ...  ..  .       .     . .. .    .       .    .
.        .      ...    ....     ..    . .           ....  ..        . .   .          .  .            . .   .      .. .   .   .. ...    ..  ..  .       . . .      .
. .          .   .  . .    . . .          .  .  .   ...   . ..  .  ..  ... .  .  ..   .     .        .   ...   .         .   .        .....   .       .. ..  .. ...
.... ..       ...     ..  .   . .          ... .  ...       .          .  .   ...      .      .     .  ...  .        .. . .      ..   .. .    ..    .   ... .     .
.          .     .  .  .              . .  .      ..  .  . . .. .        .       .. .   ..   . .   ..   .   .  . . .    .  . .  . .  . ..  .        .  ..   . .   .
.  .     ... .. .   . .      .   .       .    .     ..  .      ..             .      .. ..  .  .. .  .  .      ... . .   .    ....  .      .   ..    .       .    .
.  ..   . .  .   .. ..   .  .   . .     ..  .  .   .    .    .  .   ..  . .   .  ... . .        ..       . .   .      .. ..  . ... .  .   .. .             .  ..  .
.      . .   .. .    .  ... . . . .  . .. ..  .  . .  .    .       . ...     . ..  ..  ..  . .. .. . . .       ..  .. .  .  ..   .    .     .     .   . .  .  .   .
..    .   .     .  .    ..    .   .. . .. .. .      .  .         .   .   .      ..   .       .          .   .     ..    ....     . ... . ..  ...  ..   .  .       .
.        .      .  . .  ..  .   . .    .         .            .   .   .     .    .  .. ..   .. .        .   ..  .       .. .    .       . ..   .        ..     . ..
..    . .     . ..  .      . .      . .    .    ..   .      .       ..   .  .        .. .   .        ....   .  .  . . ..     .   .  . .      .        .           .
.... . ..       . .. .   .  .     .   .   .  .. . ...   .  ..   ..   .  .     .  ....         . .             . .. . .  ..        .  .  .....   .    . .    .     .
.  . . .. .. .   . .           ..    .  .. . .          . .             . ..  .      .  .     .    .    . . .. .  ..       .  ...    . .    . . . ..   .. ...  .  .
.   .     ..  ....     .. .  ... ..  ..    ..   .. ...      .   .    .   .    . .   .. ......  ... .. . .    .    ..              ..  ..   ...  .  .      .  .   ..
. ..   .   ... .  . .        .       ... .      .       .   .        .   .    . ..     ...                       .  .        ... . .     .         . .   . . .  ...
...  .  ..            ..    . .   .  ..  ... . ..     ...  .  . .   ..  .      . . .  .        .  . . .         .     ..    ..      .  . . .   .    .   ... ..    .
. .   .  .. . . . . ..        .. . .   .  . .    .  . ...    ..     .        . .  .     .     .    .  . .    ...  .          .  .. .   ... .  .    .      . ... . .
...   .... .  .   .  .  ..  .. ..  .  ..  ..  . .  .  .  . .  ..     ..      . .    .   ..  .  .      . . ..   .  ..     .  ..  .    ...   ..        .. ...   ... .
... . ..   . ..   .  ..  .  .  .... ....      .            .   .   . .     . .          .  .  . ..  .  . ..   . ..   . .          .   .  ..   .    . . . ..       .
. . .      . .      .  .. . ..  ..   ..       .   .  .. . .           .. ..      ..      . . .    .  .....      .  ...      .   .   .  ... . .. .. ...... ...     .
.   .   ..   . .    .. . ..    ..  .     . .  .  .  .       .         ..  .   ..  .    . .   .....    .   ..         .  ..    . . .     .    .  ..  ..   .    .  ..
.  .   .    .  .         .   . ....    . .  . .  . .     .   .  ..  .     ...  .    .    .  .      .  .     .   .     . .   .     ..    . . .        ..     .. . ..
.       . . .  .    .         ..      ..  .               . .       ....        . . ...       .       .          . ..    .    . . .  .. .   . ..    .  ..  .  .   .
..          .  . ..   .    .     ....   .    .  . .     .    .                    .   .. . .     .    .  ... .. ... . .      . ..  .     .       .    ..  .      ..
.. ... .   .   .. .       .  .... .  ..    .  .     .  . .                ....      .  ..  .  .  ...   .                  .  .     .  .          .. .   ..   .  . .
. . .       . .      .       .  .    .   .   ...     .     . ...   .  ..    .   .. . ... ..             . .      ..     ...     . .    . ...    .  ... .   .. . . .
. .     ...        ..          . .   ..  .  ......  ...      ..  . .. .. .          ..   . .. ..  .  .       .  ..   .      . ..  .       .   .  .    . .  .  . ...
.    .      ..  . .      ..     .. . ... . .   . .  ...    ....    .                 ..   .  .      ..  .  ..       .. . .    .   .   . . . .  .    .   .   .     .
.   ..  .   ...   . .      .    .  .   .   .    . ..  .  .   ..       ..          .   .     .       .          .  . .  .         ...      .....   . . .. .  ... . .
. .  ..     ..  .     . ...     ....  ...  .     .  .           .   . .  . . ... . . .  .  .     .  .  . .   .. .   .. .    . .  ..      .....   .  . .  .  . .   .
. .  .. .... .  .    ...  .  ... .   .  . ..  .  .... ..  ..  . . . . .   .... .  .      .. ..   .  .. . .   .  .      .          ..    .    .           ..  .  . .
.   .  .     .    ...   . ..     .  .   ..  .  .     .  .     ..      .  .        ..  .    .  .  .     ...   ....   .. ...  ..   ..  .    .        .  ..   . .    .
....    . .       ....  .      ...        . .  .  .  . .   .          .   .    .         . . .. ..    ...  . .           ...         ..  ..    .   .         .  . .
.    .       ...  .   ..    . .     .     . ....   ...   .    . ..        .   .       . .   .         ..  .           .  .     .      .    .     . ....  ...      .
.   .         . .  ..  .. .     .    .. .    .  .   .  .           . . ...  . .   ..  .  .  . .        .  ..   .   . .         . . .  ..        .    .  .    . .  .
.          . . . .   .   . .  ..        .. .      . . ..   .      . .                   . ..        ....   .        . .           ...  .    .  ...   .      .. .  .
...      .      .   . .  .      .   .               .                        .  . .   ..              .      .    .... .                  . .   .   . ... . .     .
.. .       ..         .       ..      . . .  .  . .  .. . .  .    .    .    . . .       ..    . .. ...   . . .      .   ..    .        .        .     . .  .. . . .
.       . .     ..   .... . .   .. .  ..           ..   .  .          .    .   .. ..   .     . . .  . .  .     . ..    .  ..       .. ..  . ..      .  .. ..  .. ..
. .     . . .....      .   ..     .       .  ....  . .....   . .   .... .. . ..    .    .   .  .  .   .  . .     .    .        .  .      .  .     . ..   .        .
.. .    .   .  . .   . .  .. .        .     . ..      .  .   .. .  .     . .. ..       ... .... . .      ... .   ... . ...       .     .  . .     ...  . ..  .    .
.  . .   .      ..    . .              .  ..  .   ..            .      ..    .  .   .. ..  . .               . .  .     .   . .          ....       .   ...    . ..
. .  . .    ..  ..    ...         .   .  .   .    .      . .  . .       . .        . .      .       .   .  .  .   .         . .    r . .     . .       .    .     .
.  . ..          . ...  ..  .   ..  .   . .  . .     .   . .    . .    .     .  ...   ...    .   . .  .    .  ..    ..   .       .              . .     . . ..    .
. .     . ..       .     . .  ..   .        .     . .. . .  .  .   .   .   .   .   . .   . .. . .. .. .... ..   .   .    .  .  .    .     .  .       . ...        .
...       . .      ..     .   ...       .      ..    .     . .  .  .. .   ..... .    ...       .  .     . .    . .  .... .. . ..     .  .            . .. . .    ..
..   .   .    ..  . ..  . .    .  .             .           .  . . .  .... .     . .   . . .     .     .  .. .  ..     .  . .   ...         . ...  .  . .    .  . .
. .    ...  ..    ..    . . .  .  .  ...  .     .. ....   . ...      . .   . .. .              . .. ....     .   ...  . . ... ..   ..  .    . . .  . .   .     . ..
.. .. . ...   .     .. . .  .   ..   . . .. .  .   .. ...   . .      ..    . . .    ..  .                ..  ..  ..   . . ..    .  . .   . . .     .   . . .  .   .
. .   ..   .     . .  .    . . .     .    . .  .  .  . ..  ...   .  .. .     .   .   . .        .. .        .    .  .       ...        .  .   . ..            .   .
.      .  ..         .. . . . ... ..  ..   .  . ..     . . . .   .          . .  .      .      .    ..   ..   ..  ... . . .  ..  .     .   .      .  .   ..    .  .
... ..   ..  .   .... .        .  . .         . .    . .   .  .  .  .  .   ...  .  . .  .    .    .      .      .          .  .    . .  . .. . .  .     .         .
.       ... . .    . ...   .          . .  . ..    ..  .    .                .     .   .       .. . .. .  .           ..     .   .  ..  .....      .   .  .      ..
..        .  .   .     .. .     .      .      . . . . .        .  . .   .  .      .  . .       .  . .         ..        ..        .  .  ..      ...     ... .     .
..     .      . .   ..     . . .       .  .. .            .      .. ..   .      ... .     .    . ...  . ..   .. .          .  .. .    .     .     ..    .   .     .
. . .    .        ...          ..   .   .     .       .   ..     .     .      . .  . . .  ... ..  . ..  ..   .. .    . .        . .  ....   .   .   .  . .        .
..                 . .. . .    . . .. .. . .    .      . . .. . .         . .  ..  . ..    . .     .  .                .    .         ..   .       .   .     . . ..
..  ..  ..  .  . .      .    . ..    ... .  .       .       ...         .    . .   . ...  .      .     . .  .   .    ..         . . . . .  .        .  ...   . ....
. .  .        .   ..   .. . .   . .....       .          .  .. ..       .     . .      . .. .   .   .          .   .  . .   .. . ...  ...     .  .           .    .
..  . . .      .    .  .   .  .   .   ...   .    ...        .  .  .  .  .      ..  ..  ....    .    .        ..      ...        .  . ...   ..  .  .   ..      .   .
. . . .   ...   .   ....  . .   ...   .   .    .   .    .. .   .           .    . .    .  . .    .  . ..    .       .          .  ..  ..     .. .... .  ...     . .
. ...   .     .     ..       . .  ...              ...       .    ...        ..  . ...   .  .  .    .   .    .   .    .  .. . .     ..  .  .. . .    ..     .  .  .
. .. .            .     . .  .    .    .     .   . . .. .  .   ..   ..       .     .. .   .        . .  .   ..   ... . . .   .. ... .  . . . . .            . . . .
.  ..     . ..    .. . . ... . . ..  .    .   .    .   .  . ..       . .  . .   .        . .. ... ..  .  .   .           ....     ..       . .    .             . .
.         .... ..    . .  .. .   ..    ... . .  .  . .           .               .  .         .      .  .  . . .   ...  .  .   .    . .      .    ..    .    .    .
.   .   .         .   . . ..  ..            . .   .       .. . .   .    ..   ...  .  .                    ...   .    .      .    .. ... . .     ..     .  . .     .
. .  .  .    .    .         . .. . .    .  .. .    ..     .  . .  .      . .              . . .   .   .  .. ..  ...   .. .    .    .  .   .  .     . ..        .  .
...  ..      ..       .          ..    .      .      ...  . .. .   . .  ...   ...    .     . . . .  ....   .    ..    . ...      .  .  .   .   .     ..      . .  .
.. . . .. ... ....     .... .   . ...        . .     . . ..  .   . . .  ... .  . .        .  .    .    .       .. ..  ..    .. ....   ....       .  .  .    .   . .
..  .   . ....   .   .    .. .     ...   .  .          .      .  .  .   ..  .    .  .      .   .  .          . .             .    . .  ..       .  .  .  .  ..    .
.    .  .       .  .. .     . ..       ..   .  .   .   . .     . .   .      .  .. . .  .. ..  .  . .  . .         . .  ..   ... .   .     . .   .  .   .   . .    .
. .. .   .  .  .  . .      . .  .   . .    .          .  . ..    . . .. .. .      ... .  ..      . .       .  . .. .    ..       .. .  .        .     ...         .
.    .     .   .  .      . .  .  ..             .   .   .     .   ..   .   .  . .  .    ... . ..     .   . ..   . .     .      . .       ..    ... . .   .       ..
.  .             . .    . .  .  ...     .. . . .. ..  .   . ...    .      .       ... .      .   .   .  . ....     .    .           .  .   ..    ..       ..      .
..   .       .. .     . .   .           .  . . .    ... . . .  .       .      .         ..   .         .. . ...     .   . .. . ..  . .      . .    .     . . .    .
..    .  .    . .  .    .    . ..   .     .   . .  .       .   .   ..  .  .   . .   ..  .       .     .  .  ..    ... .   ...  . . . .     ....     . .   .  .    .
.          .    .  ..    .  .    ..   .   .  ...  .   ..  .    .  .   .  . .       .        .     .   ...   .              .       .  .    ..     .   .  ..       .
..    .    .  .   . . ...      .           . .  ..   . .  .        .  . .   .      ...          ..   . .   .. . .     ... .      .  .      ..  .   ..  ...   .  . .
. . ..  . . ..     ..   .  . .  . ..           . .    . .   .  .     .       .      ..   ..     .     ..  ... .    .     .   .   ....       .   ......    .  . .. .
.  . . .     .  .  .      .    ......  .  ..     .         .    . .  .   . .  .  ...        . . .     . .   .          .       .    .  . . .   . .              . .
..     .    ..  ...   . ..        .             ..    .      .     . ...       . .  .     . .       .  ..      ..          .   .           .  . ... .. ..  .      .
.   .     ..   .     ..     .   .. .     .. ..  .     .... .  .       ... . . ..  .   ....    ..   .  .  .  . ..   .     .   .  .      .   .. ... .   .      .    .
...................................................................................................................................................................
