....................................................................................................................................................................
.         .  .    .. . .    .            . .        ...   .     .    . .      ...  .      ..   .  . . ..  . .. .     .           .   .  .     . .. .. .... .      ..
.      ..   .       .   .  .   ... .   .            ..  .    .   .      . . . .   .     .    .     .    .  . .    .    .. ..  .  .   .     .    ... ...    .. .    .
...  .   ....      .  ..    . .      .. . .      .    .    .    .  ...  ..... ...... .    ....   . .   ..      .  ..     .  .  .       . .    .    . . . . .  ..   .
.     ..     .      . .   . . .    .  .   .  . .    . .      .   . ...      ....        . .   . . ..     .  .  .       .      .      . .   ..   .. .    ..   .     .
. .     .  .. .        ..    . ...       .      .  .       .    .  . .. .. .... .       .     .   ..     ....     . . .   .     .   . .    . .        . .....     ..
.       .  .    .    . .          . .       .  X .  .    .   . .  .. .. ...  .    .  ..  .      ... . ..                    .   .   . . .      .    . .  ..    . . .
. ..  . .         .   .. . ..       ..   .       ..      ..       .          .         . ... .  ..  .. ..    . . ..   ....   .  . .   . . .    .  ..    . . .     ..
. . ..  .  . .    .    ..   .  .        .  . .     .          .  .      .         . .   .         ..          .. .    .  .  .      .  .. .    .. .      .. .  .    .
..            .       ..  .      .    .      ...  . . .  .     ..  .. .   .           .  .      ..             . . .  .    . ..   .    .     ..   .    .           .
.. . . ..  . ..     ..    .. . .   ....  .       .  .               ..   . .     . ...  .   .. ..   . .  ... .   . .  . .   ..   . .  .. ..     ..  .  ..   ..     .
. ..  .  .     ..  .   .  .  .  . .. .  .       .  .  .    .     ..   ..     .  ..   .    .        .... .     .  . ..    ... .... .        .     .    . .      .   .
.          . ..  . .  . . . . .          .    .  . .   . .    . . .    .   .. .     .      . . . ...         . ..  .    ..  .     .   . .             . .         ..
.. ...    ...         .   ...   ..     .    . .   . ..                       .  ..    . .    .     . .         . ... .     .   . .             . ..  .        .. ...
. .            .     . .. .  .   .    ... .        .   .            . ... ..... ..        ....             .. .. .      .      .    ...  .   .    ..  ..      .  ...
. . ...      . .    . . .   .         . ... .. . .  .  ... .. .   .. ... . . .. ..    ..      .   .      .  .   .        ..      . ...    ... ...      ... . ... ...
.        .     . .      . ..   ..  ..  .. . .  .         .... .    .  ... . .    . .... ..   . . .     ..  .   .. .. .. ...     .  .  ..  ..   ...    .  . . .     .
.    .  ...        .    ..     .     . .  .      . .  . .  . .            .   .  .  ... .     . .. .  . .           ... .     . .      ..    .    .                .
...            .  .. .   ..  ... . . .      .     ..... .   ...             ....   .   . ...  .   .    .   ..  ..    .    .   .    .           . ... ..    .     . .
. ..  .  .          .. ... .     ..   .  ...     .     .  . . ....  ..  ..       .  .        .      ...  .  . . . ..  .   . ..    . .  ... .                 ..    .
..  .  . . .  ....   .   ..   .  .  . .. .            .. . . . . .  ... .   .  .  .. .             .. .    .     . .    .   ...                     .     .     .  .
.       .     .  .  .  .     .      ..   ..       .      ..  .  ... .    .  .  ..    . .. .   .  .  .         .         .. ..        ... .  . .      ..      . .   .
. ...                  ...          . ..    .  .  .    . .    .  .   .       ....   . .    . .  .      .     ...  . .   ..  ..    .   . .  . .        . ..   ..    .
.   . ...     .  .      .   .  .  .       . . .. .   ..  .     .   ..  .     . .    .          .... . .   .  ..    .  ..   .   .     . .      . .            . .  ..
. . .. .  .   .    ....    .   .      ..   .          . .  .  .. .     .    ......   .  .     ..    . ..        . . ...     ..          . .   .   . .       .   .  .
. .  .....  .    ...    .      .  .   .   .  .  .    ..    .  .    ..  .. .              .    .       .     .     .   ..  .....             .    . .   ...   ....  .
..  .  .      .. .     ...   . .  .      .   .   .     . .        . . .  .            .   .     . ...  . ..  .  .    .     . .        .  .    . .  ...   .    .    .
.  ..    ...  ..         . .   .      . .    ....  .       .  .   .  .     .        .  .  . .  .      .     .   .   .   .  ..  .           .   .. ..     .  .      .
.  .    .    .. . . . ..  .  . .    ..   ...   . .  ..  ..  ..  .    ..         .  .. . .   .. ..     . .  .                       .  .. .     .   . . ..    .    ..
.  .     . .   .    . .   . .   .  ..   . . .   .                .      ..   .  . .    .  . ...  .                .     .   . ..  .       . .  .      .        .....
. .    ...  . ...       ..          ... .    . .         .       .  .  .. .     .     ..     .    .   .     . . .  . .    ..             .  .. .. ..          .   ..
.      .   ....    ..   .      ..   ...  ..   .   ..  . .     ..      .      .       ..       .            ..    .  .  .   .  . ..    ..    . . ...    .     ..   ..
. .. . .            ...   . .     .  ... ..  .  .      .    . .      .... . ..               ..    . ...    ..      . . .         . .  .  ..        .    . .  .    .
.    . .  ..   . ....     .  .  .    ..     ...   .  .    .. .       .   .    . .   .     .  .    .    . .     . .  ..   ...   .    . . .. .   .    ..  ..  ..     .
.    .    .     . ..   .  .    .. ...  . .  .              . .   .. .   ...   .        .        ...   .  . ...   .    .  . .    .. .  .  ..     .      . .     . . .
. ..     .                .     .    . .     .    ..       .   . . ...                ..   .         .  . .   .    .. .   .   .. .   . . ..  . .     .     .. ..  ..
. .    ..  .   .  . .  .   ..  ...   .. .    . ..   ....    .  .      . .   . .    . .  .... .   . . .. .  .   ..       .    ..     .      ..  . .       .   . ..  .
.    ..  .   .   . ...   ..  .       .      .      .  . .....   .        .    .   . ...   ..                 .  .        ... ...  .     ..  ..     .  ..    .   .  .
.  .         .      .   .  .. ..     .. ..     .. .. ...  .                . ...  .    . . .    .     ....  .        .     ..   .   .      .     .   .           ...
.  .  .    ...       .    .     .. . ....    .  ..       . . . .           . . . .  . ..    .... .   .      .   .  .       .    .   ..   .      .           .  .....
.   .  .  . . ..     .   ..       ...         ..   . . .  .     ..       .  . .        .  ..  . .  .   ...  ..        .             .  ..  . .      . .     .   .  .
.   . ...        .          ....     ... . .  ..   ..            .         . ...    .  .   . . ...  .   .                      ..      .. . .    .  .       .....  .
. ..  . ...     .  .   .    .    . .    ..  .    .... ..          ..    .   ...  . .          .   . . .       .  . .  .    .  .  .. .  .   . .      ..  .      .  ..
.     .   ..  . ..  .  .    . ...         .  .   .     .    .. .   .    .  .      .    . .. ...     .  . ..  .           .    ..    . .    . .... .     ..  . .    .
...     .  .          .  .    .      .  .    ..  . .  ....          .. ..       .   . ..            .     . .  ..           . .   . . . ..   . .  ..      ...      .
.     . ...  .      .      . .     ..     .... .      .      ..       .   .  . .. .. ..     ..  .   ..     .         .  ...     .. .. .  .     .        ...  . .   .
. .     .          .      ...  ..  ..   ..   .    . ..   .   .    . .    .   ... .     .  .  .  ..      ..     ..           .   .   .   . ...     . . . .       .  .
.    . . .            . .. ..    .         .  .   .    .      .   . .      ..    .....  ..               . .  .       ..    .   .        .  ..   .   ...  . .. .. ..
.  ..     .   .  .  .        .        .       .   .  ...  .      .   . .      .    .  . .. .   ..    .     . .    ......         .. .    .  . ..  . .   .. ...  .  .
. .      .     .      ...     .      . . .   . . .        . . .    .      .   .... .    . ..   .       .   .. . . ...  . .. ..... .      .    .  .        ..  .    .
..   .         ... ..   .       . . ..  .  . .. ..             ...  . . . .            . ...  .. . . .    .     .     .        ..   .   ..     . ..    . ..    .   .
.   .     . .  . . .  .. .  .  . .  .     ..     ... .            .  . .      .     .   .             .   . .         .  .... . . ...    .  .     . . .   .        .
.      ..                ..       .    ....       . ...    ..    .     .  ...   ..  . .   ..    .        .        .. . ..   .   ..    .. ..  ....     .        .   .
.    . .    . ...   . .   . .    .    . ..   .  .  .     .  .  ..  .     . . ... .. .  . . .  ..  .  .   .    .      .  ...  .    .  .        .   .  .   .  .    . .
.    .     ..   . ..      ..  .  .   . .   .. ..   .          .    .   .. .   .    ..   .. .  .  .    .  . . .          .. ...     ...  . .. .   .. . . .       . ..
...     .. . ..    .   ...  .  . ..  .  .    .. ...  .   .        .  . .  .      ..  .    .       .    .   .  .       .     .  ... ..     ..    .   .        . .   .
.... ..    .   .. . ..    .       .    ..  . .  .      . .       .  .  . ..        .  .  .  . .    .  ...  ..    ..    . ..   .    . .       .   ....    .. .. ..  .
. . . .  .. .. . .  ...  .  . ..        .   . .   .  .      .  .      ..  ..        . ..    . . .       ..   .   ..       . .          .          ...  .  .    ..  .
.    .    .  .       ...   .. ..  .   .     .  .   .   .    ..            ........  ..   . .   .  .      . .  .       .             .   .   ..    ..  . ..      .  .
.      .     .   . ..   .   .   ...       .     ..   .  ...            .. ..             . .   .      .   ....  .. ...    . ..    .. .. .   . .                  . .
. .      .. .       . ..           .  .        . .    .           .        .. .  .    ..   .    .     .   .   ..  ..     .  ....  . .   ..    .     .  ..  .. ..   .
.    .   ..    ..     . ..  .  ...  .       .... . .  .      .. .   .        . ..  .   ..      . .. .  .    .   .. .      .  ..          .    . ..   .    .  . .  ..
.  .    .        . .     .  . ..   ...   .         .   . . .      . .    .           .      .          .. .    .     .   .  . . .  . ..     ...  .   .  .. ..  ... .
.. .     ...   ..  .        .   . .     .      .      .. ..   . . .    .  .    . .   . ...    .  ..    . . ..   . . ..  ..       ..    .    .     ...  .   . .    ..
.   . .  ....  .  .    .        ..  ...   .  .    . .    .    ..  .   ..    ...    .  ..   .       .  .   .. .   . .        .      .  .. . ..              .   .   .
.  .   . .   ..  .. ... . .   .   .. . .       ..   ..      .  .     .  ..    . . . .                .   .. .    .           . ..   .    .  .  . .      .   ..   . .
.  . .    .        .       .   .  .. .       .. . .   .   .. ...   .   .  .  . .  . .  .. ..       ..  . .         . .   . .     ..      .      ..    .          . .
.     ....  .   . .       ...     .             .. ..   .       .. .   .       . ..  .. .         ..  .    . .   .    ..   .     ..  . ...  .   ..  .              .
.           .   . .   ..    .  . .. .   ..   .  ....  .    .   .       .      .   . . .   . .     ..    .  ..   .       ..               .  .   . . ....  . .    . .
.    .  ..   ....        . .        ..    .  .     .     . ..   .      . . .     ....   ..  .. . .    ...   ..  ..  .   .        ..  .     .  .   . .    . .      ..
. .     .. .    . ...        . .  . .   .        . .   . ..  .            . .    .    . . .. . . .. ..        .. ...  .   .       .  .            . .   .      . ...
. .       .   .   . .    .. .      .    . .... . .    ..    . ...   .   .. .   .       ..   ..    ..   ..  .   .      .   . .     .    ....       .. .   .       ...
.   .   . . .     .  ... .        .  ..   . ..    .     .     . ..     ..        .    .   . .... . .           . . .      .    .    .     ..    ...    . .  ...    .
..           .  .... . . .    . .   ...    .      ..     ...   .. ..    .  .. ..  ..     .     ..      ...  .  ..  .  .  .     .  .   ..  .  .     .. .. . .  . . ..
. .  ...   ..   .  . .  .  .  .      .      .  ..   ...   .   .. .        ..     .     ....      .. . . .. ..  .    .  ...   ..    .. .    .      .  .   .    .  . .
.    . ... .. .         ...  .  .. . ..  . .  . . .     ... . ..    . ..  .     .    .   .           . .  .  .   . .  . .  .      ..    ..     . .  .. . . .       .
..  .         . . ..  .        .  . .   .  . . ..   ..     .... . . .   .    . . . .    .  .          .. ..   . ... .   . .    .     .   .    .  ..   .  .  ..  .. .
...          ..  .      .        . .. .     .    ..   .  . ..   .  .   .        .  .    .  .   .    .   . ..     .     ..   ...   . .   . ..        .  .   .  .    .
..         . .      .    .   .      .....             .... .          .. . .     .    . . . .  . . .  .          .     .. .     .  ..   .   .    ..    .  .   .    .
.     ... ...   .    .    .       .      .  ..    .     .    .      ...   .        .. .        .    . .  .              .   .   .. .     .        ... ..        .  .
.           .     .            .      . .  .  .    .     .           .            ..  .   . ... ... .  .  ..  .   .  ..    .   .  .  .    .   .. ..     ..   .    ..
.     ..            . .. ..   ....  . .. . .   .   .  .  .    .  ... .   .. . .    . .   . .    .  . .  . .  . .  .. .  . ..      . .         ..  .           .    .
.     . . .   . . .    .        ... .   .    ..   ...   .  .. .        . .    .... . .. ..   . . .  .    .....  . . . ...     ...  .   .  . .   . .   . ..    ..   .
..  . . .                .  .  ..  .   .    . .    .  .    .         .    . .  . ...  ..  .     .   .    .. . .    .   ..   . .      .      .  .... ......  ..   ...
.  . ...    .....   .. .     .    .     .     .... .    ..  .          .        .  ..     . ..  .  .. .  .     .       . .             . .    ...     .     . .   ..
. . .  .  ....     . . . ..   . .   .   .       . .  .   . .     . . .  ..       .    .   .   . . ..     . .. .  .  .  . ....    .. . . .. ..       ..    . .    . .
.    ...     .     .     ...   .  ....   .     .    . ...    . .. .      . . .  .   .    .      ..     . . .... . .         .  .  .  ..                  . .   .   .
.    .. . . .  . ..     . .  .     ..      . ...      .   .  .      ......  .  ..  ..  ....       ..      .    . .   .  ...  . .  .   .     ... .  ... .   .  .    .
.   ...   ....       .. .          .    ....  .     ..        ..    . ..          ..     ....         .       .     .. . .     .      . .     .. ..  .    . .. .   .
..  .     . ..  .  .     .  ...        .  ... ..      . .   .  . .  .     .   .   ...    .          ..     . . .  .. .    ...     . .        .    ..   .   . .    ..
..     .  .  .     ..       . .     . . .  .      . .     .     . .          . .    .      . ..  .. ..      . .. ..    .   .  . ..  . .  .  .... . ..    ...   ..  .
.    ...     .  ...   .     .  ...  ..    .  .          .  . ..  .    . ..   .      . ..  .     . .  . ..   ..  .. .    . .  ..     .            .       ...  ..   .
.  . .    .. ..      .....        . . . .   .  .   . .  ..   .  . .....   . ... . ..          . .    .          .     .      ....   . .        ... .    .    . .   .
.       .. .   .  .. .  .       .       . .   . ..     ..  .. . .  .. ...  ....    . ..  ...       .      .  .   . .  .     . .. .    .  .   .. ...      .  . .   ..
.     .  . ..     .  .   . .     .  .      . .    . . .  . ...      . .  .      .      .    .  .       .    ...  ..  .          .    ..    .     .  .      ... ..  .
.          .         ..   .   .     . .  .    ... .        .    .  .  . . . .. ...    .    .    .  .    ..  .         .. . .  ..   .    ..       . .   . ..        .
.. ..  ..    .    .        .  .   .       .   .  . .  .     .       . .      . . ..     . .  .     .    .      .     .  ..      . .   .     ..  .  .  . .. .   .   .
..        .   .. .  . ....  ..  .  ...         .   ...   .. .   ....     .            .       . .   .... .  . .  .    .  ..                 .. .   .   . . ... . . .
.      .  .    .. . ..        ..               .. . . .     .   . . .    .          ..    .. .    ..       .           .   .   .. .   .. .     .             . . ...
. ..  . .     . . .         .  ..   ..  .  ..  .  .    . .        ..      .. .  ..  .   ..  ....   ..   ..  ...  ..       ...     ... ...     ..      .  .    .  ...
.  .. .   .    .      .... ... .   . .. .   . .. .       ..  . .     .   .     .    ..     .   .            .          .  .. .  ..          .  .  .    .   ..  ..  .
. . .      .                  . . ...       .  . .     . ... .       .  . ..     .     . ..      .  .  ..    . .      . .... ..   .       .       .  . ..  .       .
. .  . ..  .   . .   .  . .  ..  .        .     .      ....  . .  .   .     .   .      ...   ..    . ..  .    .    .   . .     .    ..    .. .. .    . . .      .  .
..     . . ..   .   . .  .   . . .. .  ..    ..    .     ..    ...  .    ..  ..    .    ..  ..  .         .     .  .. . .  .  .    .          ......    ..     .  ..
.    .  . .        . .            .   ..      .  .... ..  .     .   ..      .              .   .  .         .  .    . .  .  .   .   . .....     .   .     .        .
..  .. .     .     ..      .  .     .. . .      ..  ..        .     ..  ..   .   ..   ..   .. .  .      . .  .   ..       .    .  ..  .     . . .       ...  .  .  .
.   .   ..     ..   .                   .. .  .       .  ..   .       ...        .       .    ..   .  .  . .  .  .       . . ..   . .  ..      . ..  .    .      . .
.   .  .   ..  . .  .  .  .     ...  . .          .   .      .            ..     .     . . ..      .     .... . ... .   .        ..     .     .. .    .  .  .    ...
. .. .....   .     .       .     .         .   ..   .  .      ..    . ..      ...           . .     ....     . .   ...       .  ..     . .        . . ..   .       .
.     .  . .     . .       ..   .. .      ...    ....       ..  .      ..   .  ..      .    .  ..    . . .        .     ...  . .... .       .. . .  .  .  ..     . .
...     .      .     ..      .    .         .. ..   . .  . ..     . . ..   ..  . ....  . ..  . .       .    ....   .  .         .    ..       .  .  .   ..    .  ...
.   .     .   .     .     .   . .       ..    .     .  .     .   .    ..    .    .  . ..  ...  .     . . .  .  .    . . ... . .  ..       . . .           . .      .
. .  .  .   . .. . . . . .. . . .   .. .      .  . .  ....  .. .  ..     .. .    . . ..  ..   .. .    ..   . .     .       ... ..   .  .. ...    ...   .  . .   .. .
.      .      .  . . .  .  .  .  .            ...     . ...  .  .   .   . .              .        .   .  .      . ..  .    .....   .         .. .    .      .   .  .
. ..  ..    ..    .      .   .            .   ..          .     ... . . .  ...  ....    . ..  .   .     .     .. .    ..  . .  ..  .    .  . .   .    ..   .  . .  .
.   ... .     .     .  ..    ..   .      .    .          .   .......  .  .. . .  .    .     ... ...        . ..   .   .   .. ..     ..  .  .        .    .     .   .
. .  .   .    .. . ..  ...  .   .  ... .     .  .   .   .           .  ..    .   . .  .   ..   .      .  ..  ..    . .....   .       .  . .   .   .   .. .  .. . ...
. .   .               .    .   .   .  .     .  .. .... .     . .     .  . .. .   .  .  .    .  ..   .. .   .      .  .  ..    ..       ....   .      .. .   . .... .
..    .. . .      .  .    .          .... .  ..  .  .   .. . .    .    .  ...   .                 ..    .  .     .    .. .  .     . .  ... ..  . .  . .  . ...     .
.      . .  .   .   ..      ....  . ..      .    .   .            .   .  .    .  ...  .   .    .     .       . .      ...       ..... .  . .. . .. .        ..  .  .
..              ..    ...  .  .   . .  .  ..  .   .   . ..   ..      .   ..     .  . .  .   .  ..   ..      .  . .   ..              ....  .     . . ...        .  .
.. .     . .   .    .  .           ... . .  .    .   . .    .  .    .     ..          .  ..    .     .   .        .             .  .      .. .      . .     .   .  .
.      .  .  ...  .     ....  ..  .  .   . .  .  .      .  ..   .   .     .   .   .  . .     .     ..   . . ..    .   .     .        ..      . .       .. . .    . .
. . ..      ..      . .  . .    . . .   . .  .      . .   .   .     . .    .   .  .   .            ..  ..  .     ... .      ...    . .     .     .    ..  . ..     .
. . ...     . .. . .  .. .   .....    ..  . .      .. .   ...      ..    ...          . ...  .     .   ..  .      .        ..        . ..     .        ..  ..      .
..  .  . .    .  . ...     . . .       . .     ...    ..         .     ..  .    .. .  .   . .  ..       .. .    .. .          .      . .    . .     .. ..         ..
...   .    ..    ...   . ..    ..   . ..  .      .      .    ..      .    .   .. .          .   ... .. . . .  . .   . . .   .     .   .   .      .     ...   ..    .
.  .  . .  ..      .  . .. .       .  . .  . .  .   .  ..        .               .        .     .   ..  . ..  .. ..  ..     ... ..    .          .      .  .....  ..
.       ..    . .  . ..  .        .         . .   . . ...     ... .. ..   . . ..  .. .  .     .   . .  .    ..        ..        ..   .  . ..    .. . .  ..  .     ..
.     . . ..   .  . . . .. .. .      .  .  ....           .  .     .   .             ..    .    .   ..... . ..  .    . .  .         .      ..       .   ... ..   . .
. ..                .         . .         .              .   .   .   .  .   ..     ..   .. ... .. ..   .   . .. .  . .   . ..       .    ..             ..     .....
.  .   ..  .         .. ..   .. . . .  .             . . .     . ..  .       .  .  .   .       .       .    . .   ..  . .. .    .    .   .         ... ..  ...  . ..
...   .         .   ..   ..  . ...   .. .   ..    ... .    .         ...    .     .               .    . .  .      .  .      ..  ....  .     ... .    . .  . . . . .
.  .          .. . .    .       . ..  .  .            . .....         .  .       .    ..    . .    .     .   . . .   .   .  .. .   ..           . . . .    ...  .. .
..        .   .   .. ..... .  .   .  .       ..   ....   ..        ..  ..    . . .  . .   .  .     .   ..     .    .. .    .  ..  .    .          .         ..  . ..
..   .     ... ... .  .   . .    .... ..  . .  . ..   ... . . .       . .    ...   .  .   .           . .       ....          .. ..    .    . . . . .    .     .   .
..... ..   ..  . . . .  ..               .    ..   .    .         .  .  .   ..      ..    .  . .. ..  . . ..                .  ..  ... .  ..     .    . . ..  .    .
.     .         .       .    .      . . .  . . ..     ..    . .   ..      .         . .     .  .  ..  ..     .. . . .. ...  . .  .  ..          .  .  . .    ..  . .
..         . . .. .       .     . .. ....      .. ...     ..   .  . .  . .   .  . .   . .         .    .  .                ..        ...... .  .    .     ..... .. .
.. ... . . .  . .    .      .. ..   ..       .        .  ..         .    .  . .  ... .    .   . .            .      ..  .   .       .. .              ..   .    .  .
.   . .    .   .           .         . ....   .  .  . ...      ..   .  .  .  .   .     ..  .  .   ..       .    .      . .  ..      ..  .   .   .. .  . .  .. .. . .
.       .       .... .. .. .        .  .  . . ...     .  .      ....      . .   .  ..      .  ..     . . ...   .   .  .  . . . . .    .    .    .       .   .  .   .
.        ..    .. .  ... .           .     .   .  .    .  .          . ..  .  . .    . ...   .     . ..  ... .   .  .    .   .      .  .      .  .. . .  .       . .
..  .      ..   .    . .  .  ..  .   . .   .   . .   . . .   .   . .     .  .  . .           .         .   .... .    . .  ...  ..... .        . .. .  .     .      .
. ....       ... .  .. .   ....      .....       .     .     .    .   .     .  .   .           ..  ..   .       .      . ..   .   .          .  .     ...       .. .
...  .. .  .      ..           . . . .     .. .  .  .  ..    ..    .  .  .   . . . .      ..       .   . . .   . .   ...    .  .    .  .   .  . ..       ..     .  .
..    .  . .    .    ..  ..      .... .     .  . .        .  . .      ..   .      .   . ..    ..     .  .  . ..  .       .             .. .  .. .. . ..   .  .     .
.      .     . .    .     .    .... .. .  ....       . . .     ...    .   .     .    ... .         .  ..   .          .    .  .      ..  .    . ..      ..  .. ... .
..  .      .     . . ..         .      .  . ...   .    .   . .   . .   .   .  . .         ...  . ..  ...  .   .      ..  .  .... . .  .    . . ...    . .. .     ...
.. .  .      ..   .   ....   . ..  ...     .   . .. .    ..            ... ..      .. ...   .     .. ..    .  .                 .   ..     ...  .   . . .  . . ..  .
.  . .  ..           ..     .    .. . .. .           .  .           . .  .. .. .  ..  .   . ..    ..      ..       .  .      .   .  .. ..   .     . ..       .  . ..
.            ..  ... .            ..      . ....       .. .. ...      ..  ...    .. .    .  .     ..     .   .       . ..     ...      ..  .. .         . .   .    .
. .   ..       . . .          . .. .. .   ..... .   ..           . .       ..  .  .... ..        . ..        . .       . .        .     .  .               . . .   .
...   .  .     .       .   .. .             . .     .  ..      . .      .  .   .      ..   ..          ..     . . .       .     ..      .   . . .. .  .  ... .. .. .
.    . .   .     ..   .   .     ..  ... . .  . .  .  . .      .       ..              ..  . .  .       ..  ..    .  ...    . .    . ..  ..   .      .  .     ..  . .
.    .  .   .  ... .. .         .  .  . .  ..  ..   ...  ..  ..  .. .  .  ..         ...    ...       .     . ... ... .. ..     . ...     .  .  ..   . .   .....  ..
.   .       .        ..          .       .  ..      .              ...    .    .   ..    .. .  ..     .    .   . . . .   . .  ....  . . .  .  ...    . .   . .     .
..   ..  .       .  .  .   .     .          .    .   .   .  .  .    . .   . ..... ... . .  .    ....            .  .  .   ..    .     .. .    . .    .   .      . ..
.. .  .  ..   ..  .    .  .     .   .. .  . .   .  .r   ...        . ..    .   . . . . . ..   .    . .   . ..     .  .     . .. .   .          . .    .     . .  ...
..    .....      .. .       .  . .    . ... .   .  .  . .. .  ...   ..     .   ..   ..     .    .       ..  .     . ..    ..    .  ... . .  . .   .   .. .  . .    .
.. .        ... .      . . .. . .  ..  .   . .    .   .   .      . . . . .   ... . .  .      .  ...   ... ..      .    .   .    ...  ...        . .  .    . .  .   .
. .  .      .  . ...   .    ..      .    .  . .. ..    . ...   . ..      ...      .        .   . . .  .   .    .   .    .    .      . .     .. ... .   .   .   .   .
...   .  ....       . ... ...           ... .      .    .   . . .           . .. .  .   .    .. .       .  . .   . . . .... .     .       . ...    .         ...   .
....................................................................................................................................................................
