.....................................................................................................................................................................
..   .. .   . ...     .   . . .  .    ..    .   .       .. .        .    .   .....     .    . ..    ..  .. . ..  ..   ..... .   .   . .  ...                     .  .
.    .   .     .   .   . ..  .      ..  .  . ... .     .  . ..   .    .  . . ..      .   .    .       .. .         .   ...        ...   . . .     .     ..       .. .
. .           .. ..   ..    ..   . . .  . .       . .  ... .  .  . . .    ..   ..     .             .   .  .    .      .      . .    .    ..     . .  ..  . .. ...  .
.  . .   . ..  ...     .    . . .     . ... . ..   . .     . ..  .. ..    . .  .               .. . .    . .  .    ...   . .. .             .              .  .     .
.  .    .... ..      . . .. . .        ..  . .     .    ..  .     .. .    ..     . .. .    .           . ..         ....            ..    .       .  . .  ..       ..
..      .  ....  .  ...  .  ...  ..  .  ... ..  .            .. .   .      .        .  .   .  ...   .  ...  ....   .     .. .  .  .    .  .   .. .   .  .     .    ..
.. . .    . ...  .. .   ..    . .    .. .    . .  .   .   ... .     .           ..     .    .  ...   ..  .   ..       .  .          ..  .        ..         .  ..   .
. . .  . . . ..   . . .   .  ...  .....  .       .  ..  .. .  ..  .  .   ..    .     ...... ..  ..                 ..   ..   . .    . . ...   .                    ..
.    .             .. .  . . .     . ..   ..  .  .  . .   .   . .  ...       ..   .       ..       .    .   .      . . ..        .. .  ..  .  ....   . .   .     . ..
. . .   ..         ..         . .   .  .     ...    ..      . .  ..  . . . ..   ..   .   ..    .    .    ...   . .  .. ..    .        .      .  .. . .     . .    . .
. ...  .  ...           ...      ..  . . .. .      ..   .  .    . . .  .. .     . ..    .      .    .  .      . .  . .  .   .    .  ..  .    .. ...   .  .   .  .  ..
.. .    .  .. .   .  .  . .     .. .     .   .       .. ... .           .     .  . . ....  . .. .   .     ... .    ..  . ..  . .        ... .      . .  .         . .
.    ..         .      .    . .  ... .  .   .  .  .      ..    .. ..   .    . . .     . .  .        .   ...      .. .       .. .. .  .  .   .     .       ..  . .  ..
.. . .. .      .   ..  ..   . .  .     ..  .      .   .  .      .      .     .         .     . .    .       .   .      . .      . .  .... . ..                . .   .
. ...   . ...   ..    ..  . .  .  .. .    . .      .       . .   ..   .  . .       .   ..  .     .       .  . ..  ... ...   .. ...   .           .       .. .. . .. .
.              .  ..   .                . .     .   ..     ..      . ...    .       ....    ... ...    . ..   .. .      ..    ...      .  ..         . .     .  .  ..
.    . . .                  .  . .    ..   .   .  ..  .  .  ..  .. .          .   . ... .   ..  .. ... .. . . ..      .   . .  ...  .  .   . . .  .   . .    .      .
..    . ..     .        .  ..       .   ...         .  ...  ...     .  .. ..       .  . .  .      ..   ..    ...    .  .   .          .      ..  .   .  .  .   .    .
.. . .  .        .       .   . .     . .         . .  .       .     .      .    . .    . .. ..  ..   .        .  ..            ..    .  ...    ..  .      .     ..  .
. .     .         . ..  .      .      .     ... ..... .  .. .         . ..   . .. .   . .        .  ......   .  .  ... . . .     . ....  .  .   . ... ...   ... .. ..
...   .  .  . . .  .  .     ..  . .     ..   .  .  .    . .  . .    .   . . ...    .. .       .     .. .  .      .  ...      .  . ...         .    ..   .     .  .  .
.  ... ...  .    .  . .   . . .     .. .   . . .             .      ..    .   .   .. .. . .  ..  . .  .  ..  . . ..   .           .  .     .. .       .           . .
.     .  ..     .  .    ..        .     ... .....  .   ..   ..      . ..    . .      .  . ...        .        .      ...  .     .   .   . . .     .    .    .  ..   .
.  .    .   . .     . .     .  .  . .     .   ..   ..    . ...  . . ... . .  .  ..          .. .  .  . ..    .    .   . .                 .        ..        ..  . ..
. . . .  ..   .       . .      .  .  .. . . . .           .    .    .    .  . .  .   .    ..        .    .   .            .. . .        .     .. . .     ..... .   ..
.            .  .   ..  ..       .  ...       .   .. .        .. .    .         . . .                 ..      .  ..     .  . . .  . .     .    . ..  .    . .      ..
..  . ...    .  .    .          .. ... .  .   . ..  .   ..   .......    ..    ..      .    .   ..  . ..   ..   .      . .            .          ..    . .   ...    ..
.  . .. .       ... .  .       .  .. ..  .  . .            . .    .  .... .        .                    ...     .   .. ...    .     ..  . ..          .           . .
..                   . ...  .  .  . .  .  .  .    ... ..    .   .. .     .         . .       .   ....  . .   .    ....  .. . . . .         .... . . ....  .  .      .
..    .   . ..  .  ..  .     ..  ...      ...    .. .....      ..  .       .    .    . .   ...   .  .     .      ..  .. .      ... .    .  .  .     .   .           .
. .     .   .    .   ..            ..             .  .  .     .  ... .  . .   .   .    .     . .  .                 .  .     .. .      . . .    ..  .. . . .    .   .
..  .     .    .  .. .   .            ...      .   ..  .     . . .  .     . .  ..       .  . . .  .       .   .    .       ..      ..     . ....... . . .  .     .  .
.. .  . . . ... .       .  . . . .  .   ...       .  .    .      .       .  .          .... . ..   .     .          .         ..       .. .. ..  ...     .. .   .. ..
..... .    .   .     .      . .   .  .    . .  . .     .   . . .. ..    . . ...          .  . ..   .        .         ..   ... .. . . ..   .  .  .. . .. .     .    .
... . .     .  .  .  . .     .    . .. .  .            .....  . .. .           . ..     .  .    .           .  . . .       . ..  ..     .         ..          .     .
.....       .  .. . .    .    . ..... ..    .          .  ... ..   .. .   .   . .   .   .  . .... .  ..  .   .  .  .      ..   .       .  ..  .    . . .  .   .  .. .
..        ..   .          .   .   ..  .  .         .  .    ...  .  . .   .        ...  .        .  .  . ..    . . .           ..   ..     ...     . .     .. . .   ..
..  . .        ..  .      . ... ... .          ... ..  .            .     .   .     .  ..  .    .  . . . .  . ...  . .        . .     .      .  ...            . . ..
. .  . .. .       . . .  .  . . . ..   .     .     ..     . .       .. .  ..   .            .     . .   .. ..    .. . .    . .   .  .    .        . .  .  .         .
. . .  .     ..    ..           ..    .       ...  ..    .. ... .. .   .   ...           . ..       . .  ...           .. .    .  .  . . .. . .. .. .. ..  .  .   . .
...      .  .  .    .    .    .   .  . .  .    .      .  ..     .    .. .    . .  . .    . . .     .        .    .  .  .    .  ..      ..  .  ..   .    .   ...     .
.. ..         . ..      ..     .     ...      .       .    .  ..        .    ...  ...     .     ...  .    .             ..   . . .   .   . ..  ..   ....  . ...    ..
... . ..  ...  ..  .      .        . .  .    .  .. .. .    . ..   .     . .               .   .  .       ..  .  .   ..  ..      .. .   . . .       . . .    .      ..
.                .. ..  .  .. ...   . .   ...  ...   .   . ..         ..   .      .  . . .  ....   .  ... .   .   .....     .   .   .     .. .    ..               ..
.  .    .           ..      .   .    . . .....  ... ..    ... .. . . .     .       . ..   . .  ..   .  .  .. .  . ..  ..             .. .    .        ..     .. ..  .
. .            .    . ..  ..    .   ..   ..  .  . .      . . . .  . . .  .  ..   .  . . .. . .    .   .   .      .      .  .   .... .      .  . .      .  .. .   .  .
.       .  .  . .... .     .   . .  . . . . . .  .. .  .    . ..  .     ...    . . .    .          .. .. .      .  .          .  . ..     .  .  ..   .     ..  .   ..
.   .   . .  .   . . .       .   . . .        .     .   . .   ..       . . ....    .        . ...  .    ..    . . .          .   .     .  .  .  .    ..        .  . .
. . .   .          . .     ..        ..   .... . ..  ..   .     . . .  ...  . ...     .           . ...    .. ..  . .    .      ....    .. .....     ..             .
..    . . ..      .. .    .      .  .  ..   .   .    .   ... .       .    .     .             ..    .  . .    .  .  .. ..   .  .  . . .        ..  .    .. .  . .....
..  .     . ..   . ..       .  .    ...  .   .    .        .  ..     .  .     .    .  .   .   .         .  .   . .      .  .    .  . .       ..  ..   ..  ...   .   .
. .   ...  .. .   . .           .     . . ..   .     .  .    . .   ..  .  .   .. .     .    .   .  .     .  ..  .   .              .. . .. .  .                     .
. .   .  .  ... .          .   .    .   . . ....    .  .  . .    .  .  ..   .    .       ...  .              . .. ..  ...   . .    ..   .... .  . .   .. .   ...    .
. .   .    .   .  .  .. . .    .         . ..  .    . ..        . ..       . . . .         .   . .  . ...    ..     .. ..  . .      . . .  .   .      . .. . .      .
.  .             .  . . . . ..    .    .    .    ....    ... .      .  .  .     ....   ..   .    .        . .     ...         . .    .  . . . ... ..     .       .. .
. .   ...  ..   . .        ..   ..         .    ..      ..  .  . . ..  .     .     . .. . .    . . .    .      .   .. .       .   .  .. .    .  .    .    . ..  .   .
. .     .     .  . . ........    . ..         . ..     .  .   .....     ..    ..        .       . .         .         .    . ..    .    . ... .. . .  .   .  .  .   .
.                  . .. .  ..    .    .   .  ..      ...      ...   .  .  .  . . .  . .    .    .     .       .   ..  .       . ..    .   .. .  .   ..  ... . .   . .
.    ... ... .  ... .      .          .  .     ... .  . . .         . ..          .   .      .. .....  ..    .. .                 .  .  .. .   .. .    .    ... .   .
.  . .  .     .. .   .     .       .   . .. ..        X  ..    . ..   .         ...    .      .     .    .       . .. ..      .  .. . ..      . .    .  . .      .  .
.        . ...    . . . .        .      .  . ..  ..  .      . . .  .  .. ..  ...   . .      .   .   . ..   .  .     .. .... ...   .    .. . .  .          .  .     ..
.       .  ..   . ..   .   .                ... .  .   ..       .  .  . ..      . . .. .      .   .           ..  .. .    . . .  . .       . . ... ...             ..
.  . .  .            .  ......   .       ..  ..  ... . .... ..    .     .. .     ..         . .  .  .            .       ..   .       ..     .   . .    . .         .
..       .  .   . . . .  ..  ...     . .  .        .  .  .     ..     .. . . .        ..      .         ..  .    .. .          .. ....  .  .  . .          .     .. .
.   ....       .  . .   ..     .     .     ..    ......  ..   .. .  .   .        .   .   . .  .  .    . ..       .  .. . ...     .   .      .     ...         . .   .
..   .  ..  ..         .   . .. .         .. .    . .   .         .   .  . ..    . .     ..   .  .     .. ..     . . . .  ...         .   .    ..         . .   .   .
. .     . .   ..   . .      .....  .  .        .       ..  . .   ..... .    .    .     .   .      . ..  .  . .  .   . . .      .        ...             .      .   ..
....  ..  . . .   . .             .      .   ..    .      .                .        .  .. .   ..   .       ..   . .            .  .  . ...   .        .          . ..
..   .  . .         .   .    ...   .  .  ....  .   .  .   .       . ..     . ..       .   .        . .   ..  .  .   .      .  ..   ..        . . .       .  ..    . .
.   ...        ...  .  .   .      ..    .  ..     ...  ..      . . .    . .    ..  ..   .   ..  .     .  .    .    .          .   .    ..    .  . .  .         .  . .
.     ..  .   .   .       .  .       .   .       ....  .   ..        ....   . ...  .  .   .     .....  ..   .     . . .    .. .         .  .  .   ..  ..    . .  .. .
.   ... . .        ......      .  .    ..         . .    .     ..  .          . . .         .  .  . .      .    ...      .         . .  . . ..     .        ... ..  .
. .      .   .   ..      .  .    . .         . . .          .        . . . .. .    ...           . ..        .  ..       .     . .    .  .    .             ..      .
...    . .  . ..     .    . .    ..  . .      ...   .  .  .  .  .  .  .     .  . .  .  .    .. .  .       .  .     .    ..   .  .   . .   . . .       .      .   .. .
.     . .   .  .. .   . .  .  .   ..   .   .     .  . .   ..  . ..  . ..    . ...     .  ..  . . .   .  .     ...       ..    .    ..  . ....   ..          .    .  .
..   ... ..  .  .  .        .   ..        .    .   .       . ..    ..  . .. ..       . .. . .  ... ....    .   . .    .      .              .   .    .  ..     .. . .
.  .   .       .     . .  ..  .  . . .. .  .          ..          .   .            . ..   .. .  . .   .    .  . .    . ... .. . .        .   . ..      . ..  .. .   .
. . .   ..    . ..  .  . .  ...  . .. ...  .   ..    . .  .  .     .    . .     .           .   .  . .   .     ..   .    . . ..    .  .        .  .     .    .   .  .
. . ..    .  ...  .. ... . .      ..  .  .   . ..  ..      .  .  .   . . ...         . .    .             ..  . .    ..       . ..      . .     . .             .   .
.      .    .. .    .     .   ...  ..  . .....             .       .     ...    .... .  . .. . ...   .         . ... ...       ...     . .     ..   ..          . ...
.  . .  . .  . . .   . . .. .. ..   ..  .      .        . .. . .  .     ...   .. ...   ..  .  .  .     .   . .    . .  .    .   .....  . ..  ..    . .   .    .    ..
.   . .    ..     .     .. .   .    . . . .   . .  .         .  .        ..  ..  .            .     .. .  . .  .          .    ..      ..  ....       .  . . .   . ..
. .              .    .        . . .    .  ..   .  .  .  .  .     .   .   .         .     .. .    .    .  . .    . .     .       ..   ..  .   . . .  .. ..  ..   .  .
.     . . . .      .          . . .. .. .     .     .      .  ..   .. .  .   .         .        .      . .  .  .  .           .   .      .. . . .         .. .  ..  .
.   .      .   .  .   .  .. . . . . ..   .    .. ...  .      .  . .  ... ..      . .. .. ...  .  . ..   .     .. .         .      . .  ... .  .   ..    .. ..  ..   .
.   .    .    .. .   .. .. .  .. . . .. .       ..     .  ..               ....   . . .. .        . .  .   . ..  .  .. ..  .         .  ..     .. ....   . ..   .   .
.    ..  .         .  .   .   ..  . .. .      .       ...   .    .. ... .  ..          .   ..   .     . .     . ...  .     .  .        .  ..     ....  .  .     ..  .
.     ...    .. .          . .   .    .     .  .  .        .  ...     .. . .  .   .. . .     . .  .. .    .     ..      .. .  .  .   .   .    .  .    .. .   .      .
..   .       . .  .   .   .      ..  . .. .  .           .   .      .    .  .  .  .      .  .. ..      .          .     .    .    . .     .   .  . . .   ..  .     ..
.   .  ..    .    . . .      . .     .    .. . .  . ... .    . . . .  ..  .     .              .     .    . .  .                   . . .    .   ...  . . ..  ..  .  .
..  .  .  ...   .  ..  . . .... . . ..   .    .   .  .   ..     .. .       . . . .           . ....  ..      . . . .    .  .  .   . . ...     .  . ...   ..  .. .   .
.   .. .. .  . ..  .  . .  .. ...  ... . .        .       .  .   ... . ..           .      ..  .  .  .   .     .    .   . .  .      .    .   ..  ...        .. . .  .
.     .    . . . .     ..     ... .   .      .  .  .   ...      .    ..  . .  .    . ...  ..  . .     .      .    .  .  .   .     .   . ...    . . . .. ...   . . . .
.     .    .   ..  .  .       . .  . .       . .     . . .    .... . .     .    ..  .        .. .  ..  ..      .... .       .          .        ..     .      . .....
.  .    . .    ...     . .  .          .           .   . .   .  .  .    . .      .. .      .        .    . . .  .   .. . .  .  .     ..             .  ..  . . ..   .
.  .           .  .     .       .   .   ..          ...    .  ..     .   ...    . ...    .     . .. . ..        ..   .           .  .  . .. .  .  .   .   ..        .
...   .     .  .  . .  . . . .    . .. . .   .    .. .    .   . ..    .     ..   .   .   ..    ...       . .  .     .   .. .     .    .     . .     . .. .     .. ...
. . . .  .. ..   .... . .        ...   ..... .  . .            .   ..    .  .    .  .  .  . .     .  ...      .. ..   .     ..  . .  . .      . .  .   . .      .   .
.. .  ...    ..      ..     .   ..    .  .  ..  .    ...    .  .  .. .   .      .. ..   .        .     . .        .           . .. .    . .   . .    .     . .      .
.  .  . . .    .   .  . . .        .    .    . . .  .     . ..  . .  ..   .       .  . . .  .  ...     .         .  ..  .    .   . ... .    ..   .    .            ..
.     .     .    .     .   .    .    . ..  .    ...   ..     . .   . . . . .    .. . . .  .  .          . ..     .         ...  ..   .   .... .  .       .    .    ..
.        ..           .        .   . .      ...      .. .      .     .    .      .      .      .    .   .  .   .  .          .. .    .   ...  . .. ..       .. . .. .
. .  ...                   . .. .  . .        .       .          .      ..  ..      ..  .     . .   .  .   .. . . .    . . .  . .  . . .      . . .        . ....  ..
.  . ...... ..   .     .        .   ..    ....    . .  ...  .       .           .  .            ..  ..  . .   .  .  . .  . . .  .    . .      .   .     . .    . .. .
..  ....  .                .       . . .     .   .   . .   .             . ..  . .       ..           ..  .   .   .      .  .   .  .   . . ..   . . . . .  . . . . ..
. . . .     .      .         .       .    .  .  .     .. .   ... .    ..   ..     . ..       .    .     .  ..    . ..      .       .  .....   ..       .       . . ..
. ...  .    .  .  .  . . .      . . ..   .  .  .    .        . .     ...   .        .    .  . ..      .   .   .  .    ..  .  .     .     .  .  .. .    .    ..      .
.         . .   .       .  . . .    . . .  .      .   .   .  . .  .  . .. ....   . .  ..     ...  ...     ..    . .  . .    ..  ...  . .  . . . .       ..   . .    .
. .  ...     . .  .... . .        .   .   .  .    ..      ....   . .      ..    . .         .    . . .   . .      .. . ..          .  .   .    . .   ..     .  .    .
.  . .  .  .     . .   .  .  .  .    .   ..  . ..  ..   ... .  . ..   .    . .   .      . . ...   . ....       .  . .   .      .... . .   . ....                  . .
..    .  .  .    . .   ..... ..  . . ... .  .   .  .     ..     .       .    .     .   .   ..    ..     . ...  .     ..    ..  .   ..  .  . .  .      .  .    . .   .
. .     .      .     .   . .  .    ..  ..   .  .                .   .  .        ..   .         . .    .   .        .    .            ..  .     ..  ..         . . ...
.  . .  . .         .   .    .. . ...   .       .. .     .       . .. .    . . ..   .         .  . .  ..  .      .        . .   . . ..  . ..       ...  .  .     .  .
. .         . .  .  .  .   .       .  .      .     .. . .   .      . ...  .       . .  .     .    .               ...     .     . ..   ...    .   .. . .. ... . ... .
. .       .   .       .   .           .  .     . . . .   .        .   ..      .    .    .   . .    . . .    .   .   .          .      ..    . ..    . .   . .       .
.....    .  .      ..  .        . . . .        .               ...  .          . .  .    .     . . .             .          .     .  .  ..        .  ..   ..    .   .
.      ...  .. ...   .      .  . ...         .      ..  ..    ..         .          . ..       . .  .. .  ......      .   ...   .  .  ...    .    ..   ..   ..    ...
. .  . .. . ..       . ..   .. ...  ..     ..  .. ..   ..  . .  .. .. .   ...  .  . .  .      .   .  ..    ...    .  .    .   ..   ..   ..  .   ..   . .   .  . . ...
. . .     ..     .     . .    .         . .        .             .      ..      . .                . .   . .    ..    . .       .  .  .        .      . .          ..
. .  .. ..  .        ..   .   ..  . .        .    .. . .     . .        .     .  .     .  .  .   ..  ..  .. .       . ...   ....  . .       .  .   . .   .   .   .  .
. ..       .  .  .. ..      .        .     .    . .       ..     .. . .     . . .   ..   .   ..  ..  .. ..  .     .                    .. .      .  .   ... .    .  .
.          .. ..   . ....  ..   . .       .  ....      .. . .  .         ..     ..    ..     ... .    . .   . . ..  .  ..    ...  .  .  .   ..   ..         ..      .
.     .  .   ..  ..      . .   ...  .  .  ..    .  ..   ..   . . .   .  .  . . ..   .         . .. .           .  ..          ... ..   . .   .    ..       .. .  .  .
.  . ..    ..       ..  .    .     .   .. . .   .. .      ..   ...  .                .  .     .  .   .     . . .  . .  ...... . ..    .       ...     .           ...
.       .        .   .   .     .  . . .       ..  .  .      ..                .  ...     .     ... . .  .     . ....  .      .  .  .     .  .       .  ..    .  . ...
..     . .      . .  .               .    . .   ....   .   .  .   . . ....     ..  ... . .   . .        . .  ..  .     .  .  . ..         .. .  . . .             ...
.  . .   .    .  ...       . .   .   .      ..  ..    ..      ... ..     ..       .  .    ..  . .      .   .. . .             .  .       .      . . . ...     . .  ..
.. .   .   .    ..  ..  .  . .  .  ..   ... .  .   .            . ..      .  . .  .. ...      .     .  .  ..   .. ... .        .       .   .           .. .         .
. . ...  .   . ... .  ..     .              . ...    .  .. .     ..    .   . .  ..   .  .    .     .   ...      ..   .     .   .. .    ..   .. . ..          . .    .
.. . .  . ..  . .. .  ..  ..   .    ... ..  . ..... .   ...  .   .  .    ..     . . ....     .        ....   .. .. ..     ...       .     ..      .     .  .   ..   .
. . .      ..    .. .     .    ..  . .    .        . .     .   .   .  .    ...    . . .     .  . ..  .   .          ...    .   . ..     .  .     .   .. ..     .  . .
.    . .     .  .     . ... .     ..   ..   .   .... .           ..     .. .   ..  .           . .     .     ...    .. .   ...  ..   .     ..     .. ... .  ..  . . .
.    .   .        .    .. .  .      . .   .....         .    . . .      ...  .  .   .  .  .  . . .   . .     .     .    .   ...        .. . .   .      .           ..
....   .... ..  .    .          .   .   ..   ..  . . ...  .     .  ..     .   .          .        .      ....    .  .    ..      ..   .. .     . .  .. .   .       ..
.   .   .    ..    . .  .. .  .                   ...   .          .  . .   ..           . .  . ... ..         .. ..   .     .  .    .  .  . ..      .  .        .  .
.     .   .  .         .    .    ..    .     ..     .. .         ..   .. ..  .. .  .. .    .   . ..  ..r.       .   .  .  .  .     . .   . .  .   .   ..   ...  .   .
.    .  ...            ..   .     . .     . . .  . .   .     ..    ..        . .         .. . .  .. . .  ..  .      . .    . .    .    ..  ..      ..       .  .  . .
..   .   .     .  .    ... .  .. .    ..        ...     .     . . ..    .      .  ..  ..    . ..  .  .              .       .        ...  . ..   . ..  ..     ..   ..
.  ..     . . .       ..     .     . .. ..   . . .   .   .         ..     ..  .    .         .     .        ..  .. .  . .     .  .. .  .   .  .          ..       . .
..      . .....      .  ..  . ....   ..   .  ....   .    ..  .  ... . .  ...   . .. .       .    . .    ..   ..          .   .    .    ..       .  .      .      .. .
.     .   . .. .. ..  .   ..  . ..  .      .  .      .    .   .           ..  . ..   .    .  .    .   ...  . .    .      ..  .                     ... . .. ..  ... .
.  .    .. ..  ..  . .  . ..    .   ..      .          . ..  .       .. ..  . .     ... ...    ..         ..    . ... ..          ... .  .     .  ..     .. .  . .. .
.      .       . .....       ...   .    .     .. .  ..... .      .. . .      .   . .   .   ...   .        . .      .     .  . . ..  ... .   . .    .     .. .  .  . .
..  .   .             . . . ..  ..  .       . ..  .   .  .    .         .. ..      .   . ..   .  . ..       ... .   ..  ..      ...    .  ..        ...       .... ..
..   .. ...  . ..   .      .. .                .     .... .           .  . .. ..  .     .  .    ..      ...   .    .  .  .        . . .       ..   .. .  . . .    . .
.  .   ..  ...  . .   . .    .....  .    ..        . . .     . ..  . . .  ..  . .... .. ....         ..       .    .. . ..     . .     ... . .    ...   .   . ..    .
..    . . ...   ..     . .       . ..          .. . ....       .      .          ... . . . .         .    ..       ..    .   .    . . ...   . ..     ...    .  .    .
.  ..     .     ..   . ....       .    ..     .  .     .     . . ..   ...  ..            ...   .            . ... .  .      .   ..  .   ..    .  ..       . . . .. ..
.  .    .  ..   .  . . .  .   .    . .              .   .  .  .       ..      .     .    .   . ...   . . .       . .  . ..      ..   . ..      .    ...     ..      .
. ..   . . ... . .. .  ..      .     .             ....     .  . .  .  .                 .... .       ..  .      ..        .     . ..      .     .. .   .        .. .
.          .  .  .  . .      ...    . ... ..  ..          .. .. ..    .      .     . .    . . .  . .      ..  ..  .   ..  .     .     . . .. .    .      .     ......
.. .    ...  .   ...  ....      .       .     .  ..  ..     . . .      .      .. .               . .. .       ...  .....  .....   .   .    . ..  .   .. .   . .     .
.    ...... ..     .  . .  .   ... ... .  .  .      . . ..   .   .    .. ..  .      . . . .  ..  .   .  ..  . ...  .      .    .   . .      .       ..  ...       ...
. .  .....    ......     . ..     .   . . ..    .   .     . .  ... .  .           .   ..        .  .              . . . .    . .  .   . .             ..   . ..     .
... ..    .       .    . .   ..  . ...           .. . ..  .   .  . . .    .    .  . .   ...  .       .   ..  .   .     ..       . . ..  . .  .. ... ..      ..    ...
.  .. ...    .. .  . . ..     .               ..     .    .     .  .   .     . .     .   .    .  . .     .  .     . .       .    .  .. ..  . . . .   .   .    . ..  .
..              .     . .  . .    .. . .     .    .  .      .    .   .  .. .        .     .      . .  ....       . . . . ...  ..  .  . .    .     . .   . .    ..  ..
. .   .     .    . .    . .             .    ..  .  .      . .     ...     ..   .  ...   ..     ..    . .    .  .     . .     .   ...  .  .    .  .  . ..    .   ....
.    . . .      ...   . .     .     ...   .                .          .   .... .. .  ..   .    .        . .. .    .          . .....         ..          .  .    .  .
. .... .. .   .. .  .  .          ....  .   .    . .  .        . .    .   ... ...   .      .   .. ..   .        .. .  ..  .         .                               .
..         .    .. .     . .     . .. .     .. ..          .    . .... .. .   .  .   .  .   .     .  .    .    .   ..   ..   ...        .     .  ...  .   ...     . .
..  .  .         . .   .  . ... ...        . .  . ..  .    .  ...   .              .    . ....  ..     .     .      .   . . .. .  .     ..       .            . ..  .
..   . .. .          . .    .....  .      .   .  ..  . .      . ..   .     . ..      ..  .       ..          ..   . ..      .. ..         ..... . .    .  .   ..   ..
.....................................................................................................................................................................
