......................................................................................................................................................................
.. ..     . .  .          . .. ...   .   ..    ..    ...   .. . .  .      .   . . ..   .    ... . .      .  .. ... .           .    .  ..      .   .       .     .   .
. .. .    . .. .    . .    ..    . .     .  .   .    .  .          .   . ..     .      .          .      .   .      . .    .  .   . .  .      .   .  .. .   .    ..  .
.   ..  .. ...     ..            . .  .     .       . .         ..  . ...       .   .. . . .   .     .. ..   .. . . .  . ..   .  .     .        .   .  ... .  .      .
.. .  .   . ..      .    . . ..    .   . ..        .   . . .        .      ...       . .    .  .. .   ..    .   .   . .   .    .       . . ..   .   . .  .     .  .. .
. ..        .  .   .. ..    ..     ..    .  .. .   ..    . . .   . . .   .      .   ..   ..   .  .  . . . ....  . . . .  .  . .    .   .. . .   .   .  .  ...   . .  .
.  ... ...     .        ..   .       .   . .. .      ..           . .  .            .  .. .   . .  . ..  .  ....  .    .    . . .  .  .       ...        . . .   .. ..
...        ..   . .   .    .  ...    .     .        . .       . ..  .      . ... .    .  ..  . .    .   .   .  .      .   .. .   ..   ..           ....  .  .        .
.   .  .  .   .       ..  ..   . . . ... . . .. . . ..                 ...       .   . . ..   ....         .  .   .. .                . ..                  .  .  . ..
. .      .   .     .  .    .. .. .       . ... .  ..       ... .  ..          ..  . ..     .  .   ..  .   ..  . ...  . .    ..  . ..             .         . .   . . .
.. .  .   .   . ...   . ..    .     . .  . .  .... . ..    .  . .      ..      .  .    .  .      .     .     .  .. .     . ... ....  .   .  .     ... ..   . ..  .   .
. .. .  . .   . ...    .    . .. ...        ..  . . .   .   .. .    .      . ..  .   .   .   ..   .     ..  .   .    ..  .   .  ..  . .   .   .   ..        . ... .  .
.       .      .   .... . . .  . .  .    . .   ..  ..   ..      .  .  .  ..    ...   ...   .  .  . . . . ..  . .   . .     . ..       ....  .    . ..  .  ... .      .
.    .      .     ..  ...      ... ..   . .....       . .    . .      .      .    .     .     .    .. .  ... ...  ...  . .. .    .         ..    .    . . . .    .  ..
...   . .  .   .   .  ...    ...     .   ..              .       . ..  .  ..   . .          .  ....   . . ... .. ..      .     . .. .       .  .         .   .      ..
.  .    .    ... .  . . ...   . .  .    .. . .. .  ..   .   ..   .... .     ..        . .     .     .      .  ...   .   .  .....   .   ..   ....  .      ..  .   . . .
.  .  .          .  . .  .  .     .     .  . . ...            ..       . .  .. . .  .            . .    ..      .     .    . . .  . .     .. . ..         ..    . .  .
.  .   .  ..     .          .    ..   . .....      .. ...      .  . ..  .      .        . . ..  .     .   .   . . .. .      .  . ..    ..  .. .    .  ..  ..  .   ....
.   ..       .. ..   .  ..     ...    ..  .     . .  .   ..  . .    . .     .  . .   ... ..     .    . . .. .. .  .. .  .. .  . .    ... .. .    .   .    .  . .. . ..
..   ...    . ..  .    . ...  .    . ..               ...          .  ....   ....      .  ... .  . .  .   .. .    ...... .    ..  .     . .   .  ..               .  .
.     .     .   ..    . .. . . .      . .   .   . ..    .  .... .   ..       ..   ...  .    ..           .   .   .   ..  .   .   .     . .  ..  .   .      .   ..    .
.   .. .     ..   . .      . . ...... . .  . ..   .    .   ...    .   .    .... ..      .            . .. .    .  ..    .   .      .        ...  . .    ..   . ..    .
..  ...    ..     .  .  .   .. ... .      .         . .    . .   . .  ..     .    .   . .     . .. .  . . .   . .     . . .  .  . . .        ..      .   . . .   . ...
.      .            . .   ..    .  .      .     . .    .       .     . .      . ..   .   . .       .   ...  . .      . .  . . .   .        ..  .    .. .        .    .
. . .   .     .. .  ..   ..     .  ..  ..  . .. .     .  .           .   .  ..      .   . .    ... .    .       .     ... . ....   ....   .  .     .   ..       . .  .
.    .          ..     .      .  . .. .   . .   .  . . .    ..     .   . .    . ... .       ...         .  .       ..   .  .  . ...      .  .      .  .   .      .....
.. .... . ....      .         .      .   . ..  .. . ..    .        .     .  .   . . .  ..  .    . ..  .     .     .  . ....   . ..              . .  . ..  .  . .    .
.          .  ...  .  ...   . . .  . .  .   ..     ....   . . . .    .      . .       .         .         .  .  .    .  ..    .        .    . . . .  ..  .  .   . .. .
.  . .      .       ...    ....      .    ..  . ..... ...  .      .   .     ... .      .  .        .      .  .    ..   . ..       ..    .. .         ... .  .  .     .
.      . .   ..          ...  .    . .  . .    ..     .     .  ..         .   .. . .  .. .       .  .   ..      ...    .    .    .  ..  .         .  .. ....     .. ..
.. . ..  .  . .  .       ..  .. . . .    . .  .  .      ..  .  . .  . . ...        .   ..   .     .... ...  .   .     .      .       . . . .     .  . .. .  .        .
. . . .  . .  . ..   .  .   . ..  .     .     ...       .  .              .   ..      .   .      . .. .  .        .     . .    ... .     .  .  .      .    ..   .... .
.  .  .    ..   .   .     .  .   .. ..     .  . ..    .     . . .. .       .  .      .   .  .              .   ...    . .. . . .     . .. .  ..  ..   ...  .    .    .
.   .     .   . .  .  ..  ... . . .  .  ..  .   .   .. .    ...             .  . .....           .  ... . .             .     .     .  ..            ..        . ..  .
.   .    .   . .  ..                 ..    . .    ..        ..      ...           ..    .       .. .   . .  .         ..            .    . ..      .  .. ....   ..   .
. ..      .    . ..    .     .      .  .   .    ..    .    .     . . .. .. . .. ..     .. ..     .. .. .   .    ..  ..     .    .  ..     . .              ....    . .
.     ... ... .  .   . .       .  .   . . .      .      .  .. . .   .  .     .   .. .. .. .      .    .  .  .  .  ..    .     .  . ..     .. . . .      . .    . ... .
..     .   .    .   .    .     .       ..   . .   .  .     .       . . . .  ...   .    . .  ..   .      .      .  .  . .     . ..             ..        . .. . . ... .
. .   ...   .  .          . ..   . .       .... .   ..  .   ..    .   . .  .  .      .       .     . . . ..   ..    .    .     .   . ..    ... ..  .... . .   .    . .
...    .    .. .  .    .  ....                  .  .  .  .     .    .    .     .   . .  ..  ..       .  .   .  . . .        ..  .      .    .    . ..  ..   .     .  .
.            ..       .  . .   ...        .  ...  ..    . .      . .  .            ..  .     ..   .   .. .   .   .  .  . .. .. .  .  . .      . ..   . . .  .. . . ...
.. .     . .        ..     .. ..  .      .   .. . .          .  .  ...   ..  .  .  .     .        ...  .      .     .      ..   ..  .        .  .. ...  .  .  .   .  .
. ..       ..            ..   .. . .  .  .   .    ..   .    ..   .   .         .  .  .. .    ..   ...       .  . .  .. .   . .. .. . .  ..... . .   ..    .    ..    .
.  .    ..    .   .  .     . .  .   ...       . .    .      .    . .    .    .   ...     .     .  .          . .    ....           . . .     .  . .   .  .     .     .
. ..       .   .       .   .       .       .    .  .     ...  . .   .   . ..   . ...  .    ..     ..        .         ..   ...  .   ....     .   . .  ..  ..        ..
..  . .        ... .    .  . .     . .....  .   . . .          .. . . .   .  ..   .    .. .     .    .    .         .         .     . . .   ..         . .   .     ...
.. . .  . . ..  ..          . .  ..  ..  .    .   .   ..    . ..     .         .       .  ..     .     .    .  .  .  . .  .  . .    . .          ..       . . .      .
. ..     .       .  ..         . . ... . .    .   ... .      ... . .  .. .       . .   ...        .       ..        . .     .. ..  .  .     .   .  ..       ...   .. .
.  .  .   ...   .    .  ..      .              .   ..  . .  .    .   .   .       .   . .            ..          .  . .  .           . .  .  .. .      .    ... ..   ..
.  .  . ..    .         .       ..        ... .  ...      ..  .     . .    .     .       ..    ..  . .   ...    .  .        .   .    . .    ..     .. .   . .    . ...
. . ..      .    .   .     .. . . . .  ..   .  . . ..     .         .  . .   .      ...        .   .   .     .      . .  ..   . .    ...              .  . ..     ....
. . .      .    . .          . . ..    .  .. ..         .    .         ..           . ..                              . .   .    .   ..     .   .  .   . ..    .   . .
.  .         .  . .. . .  . . . ..  . . .       .  .              .   .         . . ...       . .  ...           .    .     .   ...              ..      .           .
..  ...   .    . .   .     .      ...    .    ..   .  . . .    .   .    . .  ..              .   .     .  .    .       .   .    .  ..    .    .          .   .    .  .
...           .       ...          . .. .                 .   . .    .     .. .     . ..  ..        ...      . .. ..   .       .. .... .    .    .       .  .        .
.. .  ..   .  . . ..   .      ..  .     . .   .       . . .         .....   .  . ... ..     .          ..   ..        ..... ....   ..    . .     . .   ...  ..   . . .
.      .    ..  .. .        . .   . ..   ..      .  ...   .  . .  .    .      .   . . ..  . . .      . .    ..      .       . .           . ... .  .     .        . ..
. .   .  ..   ..  .   ...   ..   ... . .    .   . ... .     .     . ..   .  .  .    .   .   .    .     .   . ... .  .     .   .   .     .  . . .. . .. .... .        .
.   ..   .    .   .   . .. . .        . .. . .      .  . . ..  ..  .  ..          . ....  .. .           .  .  ..  ..    .      ..   .       . . .    .. .    . .    .
.          . ..      ..   .   .  .. .  ..   .. .     ...  .   .      .  .      ..       .   .  .  . . . .  .      .    .     . ..       . .      .  . ...    .     . .
..  .   .   .         . .   . . ..        .    .      . . ..    ..  ... .            .  .       .  . .  .. .. .  ...         .     ..    .      .  .   .    ...   ....
..     .     .  .  .              .. . .  . ..  . .     . . .   . .    .  .          . . . .        ..  .  .. .... .   .  .   ..   . ..  .. . .    ..   .  .  .     ..
.            .    .. . ....      .   .    .  ...     .  . . .  .     .     .     ..  .   . .. .   ..       .    .    .  ..     ... .  ..  ..  .     ..   . ..  .   . .
.      ..  . ...             ...           ... . .    . . .    .     . . .            .  . .. .       ....   .. ..  .             ..   . .   . ...       .   . . . . .
.  .   .  ...   . ....  ..   .    ...     ..   . . .        .   . .    .    .    .. ...     .     ..    .  .... .  ..    .     .  .      .       .     . .  .. .  .  .
. ..   ..            .   .    . .         ....       ..  ..     ..  ....      ..  .    .   . . . . ..  .    .    ... .  .   ..  . ..       ....              ..    . .
.   .      .   .           .  . . .    ..   .        . . ..   . .  . .  . .     ...  ..    ..   . . .   .   ...    .     ...   .  .  .       ..        .           ...
.  ..  .            .   . .   ..   . ... .....   .    . ..        .  . .. ..        .       . ..   . ..     . .          .   ... .          ..           .. .        .
. .. .. . ... . ...    ..  . .  .  .  .        . ..  .     .    .  .  .  . .  .   .         .     ..     . ..       .    . .          .   .    . .       .          ..
..   .    ..      .  .   .   .. .  .   .      .  ..  .   .  . .    .  . ..         . ..    . ...    ..   .  .      .           ..          . .  . ..  ..     . .   . .
.  .     .. . .    . .   ... ...           . .     .  ..   .    .   .     .. .   . .          ..      .    . .  . .   ..  .   .  .  .. .    .     .  .  . . ..   .  ..
. .   ..  ...   ... ..   .  .  .  .. .  .  .   . . ..  .    .. .    .     . .      .  .      .    .. .. . .  .      . .....  .  .            .  ..      .. . . .   ...
.  . .     . ..       . .   .  . . .  .    ...     .    .     .   .. .   .   . .   ..  .      .  .  . .   .        .    . .      ...    .     .  .  .        .    .  .
.. ..  ..     ...  . .    . .. .   .    ...              .   .    .     .     . .  ..    .           .    . .   .    ...   ..    .    .  .    .     .  . . .    ..   .
.   .     ..                ..   . ..   .         .  .  .      .    .  .   ...      .  .     .   . .        .     .       ...  .   .  .   .  .  . .     .     .      .
..            ..  .     . .  . .  .   ..   .   ....   .   .. ..   .. ..         .  .  .   .     .  .   .     .       ...  ..... .  . . . ...  ..  ..    .  ... .  .  .
....   . .. .  ..  . .         ..    .       .                   .  .      .    ...  .. .   . . .  . .  .  .       .   . . .         .   .     ...  .    ..    . . . .
.         .               . .    .    ..  .     .    .  . . .. . .      .      .   . .              .   .       . .     ...  .  .. .  .  . .  .   ..            . ....
.. . ..  ..  .    .             ..      .. .  . ..             .     .   . .         ..     ...  ..   .   ..  . .  ..    .      . ..    .  ... .       .... .    .   .
.  .    .....  ..  ..      .... . .     .     ..    . .  ..   .. .      ...  .....     ... . .    .   .. . ..         ..  ..      .       . ..   ..      . .  .    . .
....     ..     .      . .       .   .   .  .. .   . ......  .. .  .        .          .            ...  ....     .   . ...      .  .. . .                 ... .    ..
.  ..   . .  .    .   .     .. ..         .     .....  ..  .   . .    .. .         . . .         . .. . .    ..     .   .  .. .             .       .        .  .   ..
. .    .  ....      .    .  .. .  .     . .   .  .   . ..   .            . . . .           . .   . ..  ..     .       . .   ..   . .  .  . .  . .. .      .   ..     .
.  . ..     .     .   .    .    ..  .  . ..  .. . ...  .. ..     .     . .     .   . .     ..    .. .    .   .  . ..    . . .   . .... .     .  . .      . .   .  .  .
..             ... .         .   . .   .    ..     .  .. . .. . ..  .  ..  ..     .  ...    ...      .  . .      . . .  . .    .. . .         .      . .. .   .      .
.            .        .     . . . . . .      ...    .       ... .. .    ..  ... . .    . . .. .       .  ....  .     ... ..       ..     . . ..        .... .  .  . ..
.   ..   .   .  .  ..    ..    .. ...... .    . .       . .      . . ..           .         . .      .              .. .. .. .       .  .    ..  ...  ..     .  .   ..
.       . ...  .                 .    .   .. . .     .        .    .   . ..   .  . .   . .  .  ..    .           .           ..      . . . .       .  .  .. .    ..  .
..  .   .    ...      . ..        .            .  . .  . .. ...  .  . .       ....   ..    .. .       .. .   .. ..  . .         .  ..          ..   .    .     ..    .
.   .    .  .          . .    ..  .    .. ..   .... .  .        ... .   .              ..      .  . . . .  .   .    . .. . ... .   .  .   .. .  .  .. .   .     ..  ..
.  .  . .      .     .  ..     . .         ... ...   ..           .        .     .     .   .        .. ..  . ..     .       .. .. .   .  .      .    ... ..         ..
...  . . .                 .  ..   .      ....  .     .. .    . . ....      .    ..       .       .  ..             ....       .   .                  .  .   . .     .
..  . ...   .       ...   . .  .     .      .   .  . .. . ... . .   ..  ..  . .  .      ..    .  .  .   ..  .  . . .        .  .     .         .   .     . .  ..     .
.   . ..  . .    . ......          .. .       .     ..   .. .  .   .   .. .   ..   . .   ..   . ..     . .  ...    .               . . .        .. .  .  ...     ..  .
. . .  ..      .  .. . .  .. . .     .     .    .  . ..   .       . ..   .. .   . .. .        .  ..   ..       .    .  .    .. ..        .   .. . . ..       ... ..  .
. ..     .. .           . .   .. .   ..  .  .   . .  .  .    .   .      . . . ..       .  .  . .   .. . .  .  .     . .  .   .         .            .. .    ...     ..
...  .  .     .    .    .     .   . . . .  .    ..  .  ..    .           . . .....  ....     .    .. .  .   . .   .    .     ...         . ... . .   .....    ..   . .
.. . .     . . .   ...      .       .. ..       .  ..       ....     .      .     .   .    .   .         . .   ...  .             .     .  .  ..  . . .      ..     ..
. .     . ..           . . ..   ..     . .   .          ...        .          .. . .. ...    . .   . . .     . . ....  .  . .  . . .         .. .   .. . .        .  .
.     ..       .         ..    .  .   ..   .     .  ..         .   . .  ...  .           .   .  ..    .    . . . .   . .   . . .  .   .  . ..  .. ..   .   . .  .    .
.  .   . .  .  .       .       ...  .. ..  .       ......     .     .   .. ....         .    ...    . .    ...       .       . ..  .    .  . . ..  .    .        ..  .
. ..    . .  . .      .          .    . .....     .  .   .. .      .. .    .  .        .  .. .    .   .... ..  .    ... . .      . .  .  ..      ... .       .  .    .
.  .     .  .  .  .   . ..      .   .  . .   .  .  .       .  .    .  ..       ..    .  .      . . ..        ..    ...  .    .  ...   .               . .  .    .    .
.  .     .        .    .   .      .      . .    . ..    . ..     .. ... .. ..     .   . .     ...  ..  . .  . .   .  .. ..  .   .  .       ..         ..      ....   .
.. ...  . . .   .   ...  .     . .     .  .    . ..   . . . .   ..  . ..    ..      .. .   .  .    .         .  ...   ..            .. . .      ..   .  ..     .     .
. ..         ..    .        .       .          .    .     . .     ....   .    .. . .   . ..      .  . ...   .   .   . .   .  .       .    .....  ..          .  .    .
..  .   .. . .   .    ...   . .   .      .        .          .  .. .  . .  .        . ...        .    .   . .    .. .    .     .  ..       . . .      .....  .       .
... . .    .  .     . ... .. .       .. . .. .. . ..   . .. . . . . .  . .      .   . .     .    .    .  . .         ...   .  ..  .  ...             .           ... .
.   .            .  .      .  .    .    ..       ..   . .....     .        . .    ..   ..         .    .  ..   . ...    ....   ...   .. .      .    .  .         ... .
...  . .  ..       .  .   . .. ....  ....    .  .        .        .       . . ..    ..   .   ..  .. .    .  ..  .        .  .      .  ..    ...   .     . .    . .   .
.         .            .  . .          . .. .   . ...   .        . .    ..  .. .. .      . . .    . .     .   .  ... .. . .    .      ..    .  .              .    . .
.      .  .  .  .    .    .  .    .    .  .  .          ... . . ..   .  .    .    .   . . ...             .  .   . .   ..  .. .    ..  .          . .  .     .     . .
.    .             .      ....    .  . ... . ...   .         .. ..   . ..    .    .  . .         ..  ..     .. .  . .    .   ...   ..        .   .  .. . .    .      .
.. ..    .    .  ..         . .     .     . .   . . .  .  .. .     .   .  .    .    .  .  .   .  . . . ..  ....        .  . .    .   .  .    ... ..    .  . .      ...
. .       .      ..   ..      .   ..        .      . .   .  .   . . ..  ..      ..     .   ...     .    .     . .  ..   . ..     ...    . .....   ...     .     .    .
.. . . .. . ....    ..            .  .         .    .  . .    . ...    .  . .   ...     .   ... ...   .   .  .   .      .  . .  .       ..  .   ...  .  .       .    .
.     ..   .. .. .  ..  . .  . .     .....   .       .    .  ....      .  ...    .     ...     ...  . .     ...    ..  .     .         . .  ..  .  ..   ... .  .     .
..  ... ..  .   .  . ..  .           .            .  . ..    .   .    ..    .   .    . . ...         ..    . . .   .      . .   .  ...    . .  . .  . .       .    . .
..  .     .. .  .         . ..  ..     ...       ...     .   ..     ..      . ....       . ..    .  .  ..    .     ..    ..    . .        .   .... ...      .   .   ..
..       . ..  .  ... ..    .    .           . . . . ..  .   .    .               .  .  .  ...       . .    .  ..  . ..      .             .    ..  .    .. .   .    .
. ..   .   .      ... .     ..   .                     .    ..  .     . ..    .      ..     ..     ..  .. ..  .   .   .  ..  .  .. . ... .  . .  .    .  . ......  . .
.   ... .       . . . .. .    .     ..       .          ..   .        .  . .    ..   . . . . ..   .    .        .  .       ..  . .          ..      ..  . ..       ...
.. .....  ..   .  ..    .      .      .  .        . .      .. ...          .. .. .    .   r     .. . ..           .  .  .     . ..   .    .  .   .  . . ..  ..     . .
. .  .      ..         ..   .  . .    . . .      .   .          .  .   .  .  . .    .    . .    .   ..    ..    . ..  ... . .    .  .    .         .       .. . ..  ..
.   ..                . .    .    .    .       .    .  .     .. .. .    .   ..           .         .    .    ...     ... .      . .   .. .  . .         .   .       ..
...    ..    . . ..      . .  . .    .   .  ..     .  ..     . ..      .      . .  ...      ..... .           .  .     .  .    . .    .  .  .   .           ...   .. .
.  .  .  ..  .    ...    . .   .. .    ..  ..      ..  .         . . .  . .  .        .   . ...              .. . . .   .    . . . ..      .  . .     .  .. . ...    .
.  .. .  .. . ...  . .     ....     .  .     .   .     . . .   .  .  . ..   .  ...  . .    .  .      .......    ....      .. .  .     .      . .    .    .  ..  ...  .
... .       .        ..                              .     ..   .   .  .        .   .    .    . ...  ....  . .     . ... . .    . .     .  .   .   . . .    .   .   ..
..   .. .   ..  .  . .     .  .      . . .   ..  ....  .     ..  .    . . .  .. . .. ...  .         .  .  ..     ..       ..  . .. .  ... ... ..     .     .. .  . . .
.  .      . .    ... ... .  .   .   .   .   . .     . . . .  .   ....   .    ..  . .. . .  .  .   . . . .    . . . ..   .         ...  ... .     .         ...  .... .
.   .        . .. .                ..     .. ..   .. .   ..... .  ..   . .       .           .    .  .. .  . .     . .   ..  .. .. . . .             .  .    .     . .
.       .              . . ..  . .  .      . .      ..   .  .      .        ..     ... .      . .   . .       . . .     .  ..         . . . ...        . .    .      .
.        .    ..  ...  .     .     . . . ..  ..    .     ..    .  ..     .        ..    ..      .           . .    .   .          . .   .      . .     ..  .    .  ...
. . ... . .   .            .  . .. . .    .   . .   .. . . .   .   .   .  .   ...       .  .   .  .  .   .. .  . ..   .   .   .  . . .. .       .. .... . . . .. .   .
...  .    ...    .  . . .. .   .. .   ..     .. ..  . .   .   .   .     ...    ....     .      .  .  . ...   .   .             . .. .    .. .      ...  .      .  ....
. .    .   ..        . .       .  .     .  .. .    .. . .  .         ..     .   ..    .   . .  .    .   .      . .    .     .        .    .   .         ..         . .
.       .. . .      . .  . . .......  . ..  .               . .            .. .. ..   .  .     .  .  .     ..           ..  ..  ..   . .. . ..  .  . .         .   . .
.   .  .  . ..  . .    . .     ..      ...        .   ....   ...     ..          .. . .    .   ....  ... .  .  . .  .    .    .       ... . .  ..  ...        ..  .  .
.  ..     .   .   .  . ...   .   . . ..     .  . .  .  . . .. .        .    . .               .   ....    ...  .  . ..     .. .       .       ..       . ..     .... .
.   .  . .  . ..    ..     . .  . .  .    . ..  .  .  ..        ...    ...  .   . .     .       ..  ..     .  ....... X.        .  .  . .  .   . . .  . .       . .  .
. .  .      ..     .  . .  ..        .     .  . .     ..   .   .....       .       .    ..    ..    .. . ..      . ..    .   .              .   ..       .  ..  . .  .
.    ...     .. . ..     .    .      .  .... .  .    ...    . .    .. .. . .    .       .         ..         . .  ...    . .    .    . ... .. .     .     . . .  . . .
. .   .    ...     .             .           .. .        .  .     ..   .    ...     ..      .    . .       ..    .    .     .   .  .          .  .        .        . .
..  .  .... . ..  .     .     .  .....  .  .       ..  .   .      .  ...  .  ..   . .  .  .  . .     ..    . ..    .       .. . .     .. .    .   ..   ..            .
.  . . . ..   .           ..    .   .  .     . ... .  . .  . .    . .      . ..  . ..               .    .   .    ..  .. .        .  .         .  .        ..... .   .
. . .  ..   .  . . .. .  .     .    .   .     .  .   ...   . .   .. .   .   .    .    . ..    .     .        .   .       . ... .           .            ..   . . .  ..
.. ..  . .  .    ..  .     . .  . . .     ..   ...  .. .               .        .    .   .    . .  .   .. .          . ... ....  . .       . .    ..    . .     . .  .
.   .  ..      .. .    . ... ...   .  .         .  . ...   ..      . . . ..    .  .    .       . .   .  .   . ..   .  .            .      . .  ..       ....  .      .
.  . ... . ..      . .. .  .        . .     .  .  . .    ..  .    .   . .    ..    . .  .      ..   .  .    ..      .... . .               ...         .       .     .
.  . .  .   ..  ..   .   .  ..       .          ..   .    . ..    .         .         . .  .   . .. .   .  .  .        ..     . .           .. .        .. ... .  . ..
.. .  .   .       . ... .....   .  .  .   ..  .   .  ..     . ...              .  . .  . .       . .. .. .   .     .  .....  .     ...     ..    ..      .    ...    .
...  .. . . ....       . . . .  ..   . .      .     .   .     ..      ..  .    . .      ...    .   .      . .   ... ..          ..     .. . .   .  . . .          .  .
.  .     ...         .     . ..   .    ... . ...   . . .       .    .  ...   ..  . .  . .  ..      .    .     .   ..  .  .   .     . .  .   ..    . .   ......       .
.   . .  ....   . ..    . . .  ... .      .       . .       ...       ..             ..  . . . .  .   .        . .  .     . . ..     .   ..   ..  . . ..  .   .     ..
.   ..   . .      ..    .    .  ..  . .  .. .. .. ..     ..  ..                    .      ..    . .  .. .     .    . .   .   .     .  .          .      .     ..    ..
.  .  .        .   .. .   .   . .  . .  . .    .  .   ...  ... .    .      .  .    .. . .            ..     ..   .  .   .       ... .    .      . .    ..  .    . .  .
.. ...  ..   ... .   .  .   . . . . . ...     ..    ..    ..      .. .    ..    . .   ..  .    ....     .   ..  .   . . ..    . .  . .. .. . .    .     .  .     . . .
.  .  .   .    .  . .  .    ..     ..       . . . .   ..    .  .   .    . .. . .      .. ..  .       ..       .       .   . .    .. ..  . .  .       ...     . ...   .
.  .  .  ... . .  .     . .  .  .....    . ..    ..  .. .   ..  .     .  ... .   .     .    . . .  .      . .     .      .   .      . .  .     .         . .       . .
.    .               ..   . ..   ...    . ...   .. .      .. ..    .. .     .. .           . .. . .            . .  .    ..   .  .      .  .  .....   ...    . .   ...
.. . .      . .    .           ... .    ... .  ..  .  .       .  .    .    .   .  . ..        .. .          .  ...  .        .    .        .  .    .      .   .  .  ..
.. .....        .  .     .. ....              . . ...  .    .   .      ..             .  . .  .  .    . ..  .  . .   . . .            ..  .  .  .   . .    ...       .
.  .     ..         .  ..  . ..        . .  . .  . ..  .        .    .   .   ...          .. .     ..         ...  .. .    .  ..   .   .       ..  ..  . ..  ..      .
.     .  .                    . ...... . . .    . .        .. .   . .      .    ..      .       . ...    .    ..    .         ..    .      ..    .  .   ..   .     ...
......................................................................................................................................................................
