.......................................................................................................................................................................
... . . .     .. .           . .     .  .   .   .   .  .  ...  .          . .. .     . .. . .. .. .    . .  . ..       .   . . .  . .  .       . .. .    ..  .  ....  .
. .  .  .. . .   .  .....   .   ..  ...    . . . ... ..          . .     .      . . ..  . .          .   .. .   ..    ...    . .   . .  .             .   .     .  .  .
. .      ..  .    .  .... .      . . . .      .     .  ... .      . ..        .     ...   .   ....  .    .      .         . ..     ..   ...        .        .. .   . ..
. . ... .. .     .. .   .   ...   . . . . .       . . .   .. . .. .     . . . . . . .         .   .   .  .  .       . . ..     . .       .... . . .      ..   .  .   ..
.  .  .     ..   . ....    .         . . .. .          . ..      . ..   . . . ..  .  ..     .         ... . .   ...        .  ..  . .. .     .  .. . .  ..  .    ...  .
.      . .... ..       .    ...      .        ..  .    .  .     . .   ..       ..  .    .  .       . ..    .    ...          .     .    .    .   . . .   .    .. .    .
. .  .   . ..   .    .  .   .. .     . .           .   .  .   .     ...      . .  .       . .         .  .    .  ..  ... .  . .    ..   .   ..  .   .  .   .    .     .
..      .  .   .          ..  .. ..        ....      .            . . . .      ..   . ..  ..    ..   ..      ..    ..  .   .   .        .  .. .  ...       ..  .   .  .
.        . .        .                .               .  .. .   ..              . . .. .  . ...     ..   ...   .. .   . .      . .. .  ... .    .      .  .. .    . .. .
. . .   .   ...        .      .. .       .           . ..           .  ..    .     .      .. .    .      . ..    .            ..  .   ... . .    ..           .. . .  .
.   ......  .        .  .           .  . . .  . .    ..  ... .   .         .    .      .  . .             .     .   . . ..    . .  ..     .      .  .. . .         .  .
.. .     . .                    . .     ..    . . .  ...    .  .  .  . . ..  .    .    ..       ...    .   .   .  .  . . .    . ..    .              . .    ...     . .
.   .   ....     .... .    . .    ....                      .      .  ..  ...    .  ..   .  .      .............  .  .   ..        . .  .....    . .. . .  . .   .  . .
...     .        ....     .. . . .. ....    ..    .. ..   .           .  ..   ..     .      ..           ..   .       .     .  .. .         .. . ..  .....  .   ..   ..
...  .   ..    . .             . . ..       .  .   .    ..     . .          . . ..   . .    . .      . .  ... . .  .     .   ..    .             .     .    ..        .
. ..   .      ..    . .   .  .      ....   ..  .    ..              .  .   .     . . . . .           .      ..  . .    ..    ... .  .  .    ..     .. .    .   . ..   .
. .  ...   .  .  .   .        .         . .  .  . .. .. .         .     . .  .  ..  ...         .... .  .  .    .. .   .   .  ..     . . . ..      .   . .  . .   ..  .
...  .    ....                 ...   ...  .   .  . ..    ...  ..     .    ..  ..            .. .    .            . .. ...  .    .  . .  . .       .         .   . . . .
..   .. .. .       .      ...         .     .X  ..       ..   .   ..  .   .  .. ..     ..    .     .    ...   . . .   .   .     .    .  .....  .  .      .           ..
.       . . ...       ... .     . . .    .   .      .   .....   .   ..       .         .     .     . .  . ..           ..        .    .     ....  . .   .    .     .  .
.     .  . .... .  .  ....   .   .   .   . .  .  .       .     .  . ...         . . .   .     .  .  .   . ..           .      ..      .. .   ... .       .         .  .
.       .     .            . .   ...      .      .  .        ..   ..  .    ..   ...  .  .            .         .....        . .   .  .    . .  .      ... .  .       ..
.     . .               ..... .  .    ....  .  ..    .. .   ..  . ...   .  .   .  .  .. .. . .   .  .. .              .         ..     . .  ..  .   ...  .  .. . . . ..
.         ..     ..   .  .....       .   .   ..          ...  . . .  . ...  ..  .. ..      .  . ...             .  .     .           .......  .   .    ...  .      .  .
.     ...     ....       ..    . ..  .  .    ...     ..    ...        .  . ..   .     .            .   .       .  ..             .  . . . . ..  .    .          . .   .
.  .  .  .  .   .  ...   .  ..          .. .                .     . .   ..  ..              ... .  .        . . ..  . . .       .. .        .   ... .  .    ...     . .
. .     ... .  .     .. .     ..          ..      .   ..      .       .... . ... . . .   .  .  . .    .   . .     . .    .   .   . .    . .    .    ..    ...       . .
.    . . .. .        ..  .    . .          .    ..   ...  ..   . . ... .. .. ..  .. ..  .      . .      . .    ..     . .   . .  . .. .       .         ..      .     .
..       .   . . . . .    .  .  .            .          .. . .  ..           ..     . .  . .  .   ..  ...   ..     .  .    . .. ..     .     .    .    . .  .   . ... .
..         . . . ...   .   .  .       ..  .      ....   ..  ..  .   .     . .  .. ..  .         ..  .  . .    .. ..  .  ..    ..     .  ..     . .  .      .       .. .
.  ....   ..     . .  . .   ...     . .    .   ..   .    ...  .      .  .. .    ..     ..  .     .. .   .    . .  .        . . .    .   ..  . .     .  .   .  .   .. ..
.         .    ...  .         ...        .      . ..  . . ....       .  .  .     . ..   .      ..     ...          ....     . .   .   ..       .   .. . .. .  . ..    .
.      .       .   .      .      .  .       . .  .    ..  .           ....   ..        ...   ...           .     .  ...      ..   .. .     ..    ..      . ...  .  ....
..  .. .    . .       .   .        ..   .        . .     .  ...  .    ..      ..  .     .   .    ..    ..  .   .. .. .    .  .. . ..     . ..  ... .    .        ..   .
. .       .     .    .   .  .   . .  .   .   .    . . ...     .   .  ..     . .. ... . .   ..     ..            .   .     .    . .. .   .  .         .     .     ..  ..
..   .   ..    .      . .  .    .  .. . ... ..    .    .          .  ... . . .    .. ...     . . .     . .. .      .    .. .   ..     ....    .       . . ..   .     ..
.      . .      .  . ...   .  . .     ..  .      .   ..     .   .  ...           .    .       .          .  .  .    ..   .   .   . .  ..  . .. ...     . .    .   . . .
.. .         .  . . .  .   . .     .. .   ... . .    .. . .      . .      . . .  ..  .  . . .   .   .  . .    .    .  . .  .      . . .    .         . .              .
.. . ..        ..  .   .         .  . ..        .   . .  . . .   .. .  . .  .   .   .    ...   ..  ... .  .  . .  .  ...  ..  .   .. ..      .  .  .   ...  .   .   . .
.      ... .. ..  . ....     ..  . .  .    .. . .  .        . . ..       .    .  .. .   ..   .   .   .. ....  .     .         .  . ..  ..     .    .   ... .  ..      .
.. ...       ..   .       .     .                .     .   .   . . . .. .     .    ... ...  . ..  ..        .              .        . .          ..   .. ..  ..    . ..
.      .   ..    .  . ..   .                ..   .        .. .      .  . .     .   . .    .      .      .        .    .  . . . . .. .  .   ..   ..    .   ..   ..     .
.       ..  .  .   .   .    .    . .....  .     . .  .. .. .      . ...  ..   . .  . .  ... .. .   .     .    .  ..        .     ..   . ..  .      .        ..    .   .
.            .   . ...    .      . . .    . .   .   .   .    .      .   .     . .      .              ...   .     .      ...  .. . . .   .      .. .......   .     .  .
.    .  .  .        . . ...  .  .  ...  ...  .            . .   .     ..     .    .       ..   .    .. ..   .   .     .  .      ..    .  .  .. .   .      .     ..   ..
.  ..      . . ... .    .  .  .  .  ..   .       ..   .  .. .  .  ... .      .   .   .            .  .        .. .    ..    . .   ..         ..    .     ..     .     .
..  ..      . . ...  .    . ..  .            .     .   .    ..         . .   ..     .     . . . .. .      .   ..   .    .  ..   .. .      .  . .    .  . . .    .   ...
.  .  . .           . .  . . . .  . . .  .    .  .  .    ..              .         . . . .          ..    . .... . .      .   ..   .. .      .. ..   ..   .  .  .  .. .
... ..  . .        .   .   . .   . ..     . ..          .       .   .     .  .   ..              .   .. . . .    .  .      .  . . ..           .                  .   .
.      ...  .. ..  .  .  ..     .   . .    .. .   .      . . . . ..    ..    .         . ...  ..  ....        .  . ..   .  ..  .. ..  ..    .  .   .  ..     .    . . .
. .       .     .   .. .. .  . . . . .   . ..           . . .       .  .... .   ..   . .....  .     ..    .   . .   . . .  .  .  .        . . . .. .  ... . . .       .
.  .    . .. ..  .   . .       ..       . .     .   ... .   .  ..     . ....    .    ..    .  .    .    .  ..        ..      .  .  ..    .  .    .... ..  .   .  .  ...
..  .   .. ...  ... .   .                     .. .    .  .   .  .  . .  .  . .    ....  .   .    . . .  .. . ..   . . . ... ..    .   .     .     ....      . .      ..
.    .. .  .  .   .   ... ....         .  .     .  ..     ... .  . . ..   ....     .        . .          .   .  .  .    .  ..     . .     .     . . .    .. .. ...   ..
.. . .     .  .   ..  ..          .  ... .. . .. . .  ..  .   ..     ...   . .. .... .    .   .   ..    . .  .       .     .     . ..     ... .   ..        . ....... .
. ..     ..          .   .. .    .    .     .   . ..   . .    .   . .   .    .           . . .... . ...    .         . .  .           .  .. .   .   . .  .  .        ..
...     . . .    ..     .  .  . .   .  .    .  .   .. .. .  ..      .    .    .....       ..      ..      .      . .          .      .....  .     .  ..    .    .  .  .
.   . .     ....   . ....   . ...     .  .         . .    .  .. .   . ..         . .  ..   .. .     .         .  .    . . .. .    . .             .     .   .   . ... .
... ..   ... .  .   .           . .     .  .  .  . ... . . .    .  .. .. .       . ..    .    ..    . . .  .   .     . ..     . .  .   ..         .  . .   . .   .. ...
.  .. . .    .     . . ... .. .. .      ...  .   .. ...  .   ..     . ... . .   ..    . .     . .  . . . ..  .    .   .  ..  .. . .   ..        .            ..     . .
. ..  .    .    .      ..  .    . . . .  ..  .        .  .        .    .  .   . .    .     .   .      .  .. .. .     .  ..  ..   . . .     .. .. .    .     ..  ..    .
.    .   ..   ..   .   .       .          ... ..   . .    ... .   ...  .  .   .. . .    . .    .  .   ..    .   ..        .      . .   . ..          ..   .      ..  ..
.     . .     .   .   .    . . .      .   ...     ..  .    .  . ...       . .     .. ...     . .      .. ...      ..   .   .  ..  ... . .. .     . . . .   .. . ..  . .
. .     . . . .. . . .   .   .    ..  .  ..  .     .         . . ...      .          .  . .  . .. .       .      .... . ...... .   ..      .      .           .       .
. .  .   .      ..   . ..  ..       .          .    .    .   .     ....  ...  . ....       .      . .   .  .              ..  .  ..       .  .      .     . .      .  .
..        .  .  ..   ..        . .  .     ..  .. .  .    .   .  . . .     . ..  . . .    .         .     .             .   . .           .      ...      .  .   .     .
.      ..   .     .   . ...                  .   . ...      .          ..   .  ...  . .        . .  ..  .      .      .  .   . . .  . ... .     .... ...        .. . ..
..  .   ..  . ..   .. .. .     . . . .             .  .    .      .     . .   ..   .   ..     .    . . .     .  .. ..   .. .  .   . .   . .  . .... ...  ..   ...    ..
.    .   . . ...      .  .        .   .      .   ..    ..  .. .  .   .. .  .    .  .             . .. ..... .       . .  .    . .  ..   ..   . . . .    . ..       .  .
.         .  .         .   . .. .    .   ..  . .    .        .   .     ..  .   ..           . . . . .   .     . . ..  .   .   . .    ....       .    .   ..  .        .
..  ..       ..    .. .     . ...  .... .  .. ...   .. ..   . .  .   .  . .. . ...   .    .    .  .   .   .    .  . .  .   ..   .. . ..              .    . .. .    . .
. .        .  .  ..   ..  . . .    .   . .  ..    .. . . .. . ..  . .      .....  . . .  .. .  ....     . .      .      . .... ...    .   .       .  .  .   .   .     .
.   .   . . ..   .        .     . .    . .      . .   .    .. .        . .. .      ..   .     . .  . . ...  .      .  . .     .      .. .. .. .  ..  .      .. .  ... .
.     .  ..  .    .  .  .    .  .    ..       . ...  ..     . .    . .         .          .      .  .          .   ....         .      . . .     ..              .   ..
. . .     .   . .    ..  .  ..  .. ...         . .  .          .   . . . . ..      .     .  ..  .  .    .  .   .  ..      .   ..  ..  .    . ..      . ...    .      ..
.. ... .             ..    . . ...    .. .  . . .     . ..... .                 .       . .  .    . ..  .  ..  .. .       .   ..  .. ... . .   . . .   ..    .   .    .
.  . .          .           ...   . .  ... .  .. .   ...  .       . .   .    .    ..  ...    .  .  . .    .     .      .          .    ...      . .   .       ...  . ..
..   ..   ..   .  . .     . ..   . ..       . ...  .      .   ..    .  .   ..       . .  .    .   ..  .  . .      . . .  ..      .      ..     ..  . ..    . . .      .
. ..    ....   ..   ..   .. .  .    .         .   . .    .    . ..     .  ..  .          .        .  .  .           . ..   .  ..   ... ..         .         .  .    . .
. .   ..   .  ..    ..    .. ..     .. ..    .               ...   . .  .  .. .   .   .   .         ....   ..      .        .. . . ....       .         .   .         .
....   . .......   ..   ...   ..    .   .  .   ... ..  ...      .    .  ..   .       .    .    .. .    ...   ..     .       .. .     . . .   .  .     . .  .  .       .
.  ..   .     . .      .       . ..      .    .        .  .  .  ..    ... ..     .. ..    . .    .. . . .  .  ...  .       ..  ..   .  .    ...       .. .    .   .   .
. ..          .    ...     . ... .    .   .  .    . .    .. . . .    ..  .           ...     .  .            .  .  .    .      .  . .  .  .   ..   . .   .     .      .
.   .         . .  .   ...  .    .  . ..        .   .        . ...   .     ....    ... . .      .   .    ..  .  .....  . ...     .   .   . ..  .     .  .  ..        ..
..   . . .     . .  .. .  .. .  .         .    .  .   .       .      .    .. .. .    .    .          .  .   ... . .     ..  . ...   .  .   ..  .  .. .          ..    .
..        ....    ..  .      .  .  . .  .. .    ....                .     .... .  .  .    . . ..      . .         ... . . ..   .     . .  .    .         ...  . ... . .
.  ...    ..       .  .     .  . .  .  .  ..    .  ..          ..  ...      ....        . ..   .     .  ..   .  .    ..  .    . .      .. ...     ..  . . .    . ..   .
.     .  ..       .   .      .     . .      ..   .. ...  .    .        . ..    .   .  .     . .    .       ...      .    .     . ...   .  .  .     . . .. .  .   .    .
. .   ...  . ....  .   .              .       . .  ..  ..  .  .   ....    . .   . ..    .         . . . .   . .        .    ...  .  ....              .  .   .     .  .
.  .       .  .   ... .           . . ..     . .   .    . .. .  .   .    .      .   .    .   . .     ..  .  ...  . .  . .  ...   ..       .     .     . ...  . .     ..
... ...       ..   .  .  .. .  ..   .     .  ... ..  .  . .    .           .    .     .     .            .   . .   . ..    ..   . .    ..     . .  . .  .  .      .   .
.   .      ..  .     .     ....   . . .  .... . .   .     ...   ..    ..      . .  .  ..  ..             ..  . .        .   .   .. ....   . ..  ... . ... . . ... .   .
.  . ...   ..        . .     ..         .    ..     . .    ...    .. .  . .    .    ..    ..     . .  .    .  . .      . .. . .  .  .    .               ...          .
.     . ..     ..  .    ... ... ..   .. .       .. . .    .  .        .    .     .   .   . .   ..  .   ....    ...     ..   . .     .  ..   .. .... . .     . .. .    .
.. .      .      .  .   .   ...   ...        .       .  .    ..   .  . ..   . ...  .  ..   .     .  . ..  ..  ..  . .     . . .   .   .  .      ... .   .    ...  .   .
.  .     ..  . . ..           .   .. .   .    ...  .  . .   .  .      ..  .. ... ..   .. .    .  . .  .. .  .     .  .  . .   .    .   .  .  .   ..  .               ..
. .   .. .    . .    ..         .  .         .    . .      .      .   .      .  .    .    . .    . . .  .  ..    ..   .. .    .    ..          .  .   .  .. .    .  ...
.          ..  ..  .              .    .             .    . ...      ... ..    ...   .  .      ..  .          ..           .                 .....     . . .   .     ..
..   ..  .  ..  ...   .   .     .      ..  ..    . .     . .       ..    .   .    .       .     ..    ...   .          .    . .  .  .          ..    .   .  .      .. .
.    ..         .     . . .      .    ...    .     .    . .   .     .        ..  .  . ...  .    .   ... ...  .  ..     .    ... . .      ..   .    .    .    . .      .
.. .    ..  ..        ..       ..   .  .      .  .   .     ..            ..  ..  .     .   .. . .. .     .       ..     . ...   ..        ..  . .    ...  .       ..  .
..     .       ..  ..      ..    .    . .  .    . . .     .  .  ..  .   . .   .  . ..    . .  .     .   . ...  .  . ...  . .  .    . .   .    . . .  .    ..  .  .  ...
.    .  . .    ...        .    .       ..   ..       .   .   .  ..   .   ... .. .. .  .  .  ...      .   . ..    .     .  .          ..    . . ..     .  . .  . . ..  .
..      .. . .  .. .. .. ..   .                 .  .. . .   .  .      .     .  .  .    .       . ..  . .      .  .  .   ..      . .         ..   .    .    ..  .  . . .
. .   .   .  .         ..  ..   .    .  . ....  . ..      . .    . .. .  ..           ..   .. .   .   . .  .  . . . . .  . .   ..     .  ...   ... ..     .   .    . ..
.      ..     . .    .    .  .     .    ..   .  .             .    .  .   ..  .....  ..     .   ..   .  . ..    .  .  .   .          . .    ..  ...  .   .   .      . .
. ....    .   . .. .   .  . ...  .    . .  .  .... .  . .  .  .   .     .  .   . . .  .. .        . ..  ..   .  . . . .     . .  .     . .   .  . .. .       ..      ..
.   . . .  .. .          .   ..     ... .   ..             .         .  ..    . . .  .   .  ..            .   .     .    .    . ..  . .  .    .    ..    .            .
..      ... .    .. .  .. . ... .   .  .               . . ..     ...     ..   .  .        .           ...      .       . .. .. .    .   . ..   .    . ..     ..      .
.  . ..     ..    ..  .     .. .     .. .  ..    .   . .  ....  .  .   . ..       .   .         .  .    .   .  .     .     ..   . ..    ... . ..   .  .   .    .   . ..
.  ..             .  ..  .        .   .   .         .     .  ..    .  .       .  .. . ..   . ..    ..  .             .     .       .   .     . .    .. .           .  .
.  .. .              .  .    .  ..                .  .       .   . .. .. .     .     . .  ..    . ..  .        .        .   .. .      ....     .. .. . .. ..  .     . .
.  . . ..   .      .    ... .  . .... .  . .. .      . .  . .    .     . .  .   ..   .   .... ..          .   ..            .. .. .      ..  .. .  .   . .   .   .  . .
.   ... ..     ...    .          ...   .    .   ..  . .    . .    ..         ..   .   .            .     ..  .                ..    .   . . .. ..  .            . .   .
.  ..     .         . . .  .       . .   . .      .   .  ..    .  .   . .    ..    .  . . . ..  .    . .     ..  . .... .  .  .  ..       .   . . . .  .  .      .. ...
. ..      .. .     . ... . .. .  .  .  . .       .    . ..   .     .  . .          . .    ...      .  .  . .   ..    .  . .       .. .       ... . .  ..  .  ....     .
..   .     . .   .   ..   .   . .   .   . . . . ... ... ..      .     .    .   .        . .   .. ..         .     .  .. .    .   . .  .  ..       .. .   .    . .  . ..
.   ..  .   .   .     .  . .           .  .. . . .   .      ...       .       .      . . . .   .  ..      .  . . .                   . ... . . ...   .  . .  ...    . .
.    .. .  .   .    . . ...      . .. . . .    .   .     ..    .  ..   .. . .    . . .      . .  . .   .   .  .     . . .             .         .  .   ..  .  .  .    .
.   .  .    .    .      ...      . .   .         ... ..   . .  ...  .. .. . .  .  .        ...  .. .      .             .     .              .     .     .  ...  .    .
.    .  ... . .    ......    . . ...      . .  .         ..  .       ..    .  .  .  .     .   .  ..  .   .       .  .      .  .   ..  . .   ..  .    . .    .         .
. .     . . .     . .    ..  .      .   . .... .      ... .     .  .   .  .  .       .. . ..    .   . . .   .     .  ..   . .... .   ..  .       .     .  .. .. ..   ..
..     ..   .. . . ..          ..         .          .. ..   ..   .       .. . .   .  .           .  .     . ..    ..  .   . ...     . ..  .    .....      .   ..     .
..     .    ..     ..      .  .   . ....           .   . ..   .   .  . . . .      .   .     ..  ..  .    . ... . .     .  .   .          ....     .  .. .  . . .   . ..
.  .    .   .. . . ..       .   .    ..  .  .. . .         .     .  ...       ...  . .   .  ..  . .   .             .   .     ..  .    ..    .. . .   ..     .        .
..   . . .  .      . .    .             .         .. .  .   . ..       .       ..    .    .   .     .. ..    .   .  .  ..   .    .   .    .    ..     ..   .  .   .  ..
.      .  .        ..     . . ...      . .   .   .   .   .              . .   .         .  ...         ..   .        . . .   .. .       . . . .      . .         .    .
..    .   .     .        .   .    .        . .     .      .  ..     ..    .... . .       . .   .           .   .   .. . .          .  . .         .    .       . .   ..
. .  .   ..  .          .... ...       .    ..    ..   . ..        ....  .. .   .. .           .         . .  .. . .      .  ..   .    .. .   . .....   ... ... .   . .
.     . .  . . . .      .  .       ...  ..        . .  . .     . ..      ..          ..   .  .     ..       .  .    .  . ..             .. . .  ..       .    ..      .
.  .. .. ...   .. .       ..         .. .    . .     ..   . .. .      . .       ...   . ..  ..  ...    . .           ...   .  ..         .      ..    .  .     . .    .
.  .  .     .    ..      .     .   ...      .   .   .   .   .       ..        ...     .    .  .     .   . ..    ..   . ..         .. ...  .. ..    .      ..  . ..    .
.   . .   ..   ... .  ..   ....  .     ..     .. .  .  .    ..    .   .  .  ..  ...   .. .      . . . ..           .  .     .....    .  .  . ..     . . .    ...      .
. .  .   .         .   .   .   ..          . ..  . .   .        ..  ..         .   .. ..  .   .. ..  .  .      ...    .  ..  .. ..  .. .. . .  . .  . .    .  ..  .....
.    .  .  .      ..  .    .   .       .    .            . . ..           .     .  . .  .     .  ..  .     . .   .    ...   .       .   .. .  ..     . ..  .         ..
..    . ... .     ....      . .     . .    .  . ...    . .      ... .       .. .    . .  ... . .       .  . . . .  .    .    .   .  .         ..      .    .   .   .  .
.  . .   . .            .   .  ..   .   .  . .   .     .                 . .  .   . .    . .         ...   . .  .       . . ....    ..  .      .    .. .         . ....
.     ...      . .  ..    . .   . . . . .  .      .      . . .    .          .  ..    .       ..   .       ..  .    .  . .    .    ..        .        .      ...    ...
. . .       . ....    .   .   . ..       .. .       .     ..     ..  .....  ...     . ....  . .     ..  .     .    .    .     ....  . .  .        ..   .     .  .  .  .
..  .     ...     .   . ...        .    . .. .       .  ..     .   .  ..      .  .       ..      ..  .     .    ...   .    .  .     .. .    .      . . .        .  . ..
.  .     .     . .. . .  .  .    .    .        . .  . ..      .. . .    . .. .  ..  ...    ..  .  .  ... . .  ..     .    . . . ..   ..     ....   .       . ...   .  .
...   .    .   .  .        ..  .    .     . .  .... .  .       .  .  . .  .        ..     .. .. ..   ..         ....     .      .  .   ..   .    ..       . .  . .   ..
..   .. .   .   .   ..     .  . . .   .. .  .       ..   .              . .        .     .      . .  .   .. .   .    .      .          .   .  .  .    .  ...   .      .
.  ..  .  ...    .       . .  .       ... ...  . .... .  .. ..     .     .  .  .       .  .. .  ..     ..       .. . .    .. ... . .   .   .   ... .      . ..   .  ...
.  .    ..       .  .             ..    .. . .      . . .         .  ...    ... .   .        .     .   .       .  ..      .   .         .      .   .    .  ..       . .
..         .  .       ..    ..      .  .  . . .      ... ..  ...   ... ..    . .     .         .  ..   . .  .   . ..           . ...    .        r..       .     . .  .
..    .      . ...  .. .  . . ...   . .      .  .    .    .  .  .   .     . .  .    .   .   . ..       . .   . .   .      ..    . .   ..  .    .  ....      ...  . .  .
.       . .      ..    . .  .      . .. ..     .      ..  .  .   . .   ..   ...      ..     ...   .    .   .  .. .   ...     .      .       . . .   .  .       .   .. .
.    .          . .  .  ... .   .    . ..   . .   ..   .   .   ..   . .    . .    . .          ...  .     .   .    .  .... ..        .  .        ... . .    ..  .. .  .
. .          .       . .  ...  .        .        .  ... .. . .   .. .. ..  ..  ..       .       .   .  .   ...      .    ...   .... .  .     .  .        .      ...   .
.  . .       .. . .. .              . ...   .     .        ..   . .     ..      .   .     . .    .      ..  .    . .  ...  . .   ..  . . ..   .     . .   .   . ..    .
. ..     .   . ..     . .....   . .  ..   .     .. ..   . . .  ...    .      .     .     .        .. ..   .   ..      ..    .  .           .  .      ..  .   .  .   ...
.      .     . .  . .. ..   . . . .  . .       .    .   .  .      . ..       . . . ....  .. .    .. .  .. .     .  .  . .  . ...      .  .. .       .  .      .  . .  .
. ..   ..  .  ..  .  .   .. .      . .       .        ..   .           .     .    ....       .   .   .  ..  .     . .   .     .     . . . .  .  ..   ..... ..... ......
.   ..          ...    . . ..  .   . ... . .         .        .  .       .   .    .     .  ... ..    ..    .  ..  ..  .      .  .. ..  .  . .  .. .    . .         .. .
.         ..  ...   ..    .     .  .. ... .          .  .     .  ..   .  .  ..     ....         .   ....  ..   .   .  ..      ..  .  ... .     .   .   .   .. .   ... .
..    .     ...    . .   ..           ...    .. ..    .  ..  .  .  ..        .    .    .     . ...    . .    .  .     .. . .. . .   .  . .  . ..      .  .    .. .  . .
.       .   ...     ..   .      .          .   . .  ....   . .       ..  ...    ..     .           ..      . .     .   . . .... . .  ..        ..  .  . .  .  .       .
.                  .  .  .   .    .. .        .       . . .  .    . .   .   ..  ..     ..       .   .        .. .    .....  . ..    . .    .  ...         .. ..   .  ..
.    .   ..    .. ...   ..       . .       .  .        . ... . .. .  .    .         .      .      . . . .  .      . ..  . .  .       . . . ..   . .. ....          .. .
. .             ..   .      .      . .   .   .  .   ... .    .      ..         .  .      . .  .    .   .  ...  ..  ....   .  . .   . .    .   . .         .. .        .
..        .   .   .    .   .          . ..  .  ..  . ...           . .. . . ...  .      .        . .                        ..    . .  .  ......   . .. .  .. .  .  ...
.  ..   ...    ..  ..        . . ...  .      .. .    ..           ..    .       .  . . .. .    . .   .        .   .                  .... .         .  .   .  ..    ...
. .   .         .  ..  .         ..  .  .  ... .    .      ..  .   . .     .         .... .     .      .             .        .   .        . .   . .        ..   ..   .
...      ..    .   .  ..  .    .   .   . .  .  ..   .     . .       ..     . .  ..     . .    .  .      .   . .   . .   ...       . .    .   . . .    .  . .          .
.......................................................................................................................................................................
