........................................................................................................................................................................
.     .       .  .  .    .. .      .             .     ..   .         ..        .      . .  .  . .  .            ...   ..  .   .        .  .  .    ..   .   .   .      .
.   .   .  ....          .   . .     . . .    .   .     ..      .       .   .  .       .     .   .  . .   . .      ..    .. .. ..  .. .  .  .  . ..     .  . ...  . .. .
..     ..     . .     .  . .... .   .. .      .      .   ..    .. .  .   .   .  ..   .  .  . .. .  . . . ...  ..  .  ... . . . .  ..          .    . .  .      ..  ... .
. .  .  ...    .   . . .  ..     . .  . ..           . .   .  .  .. . . ..   .          .   .. .      ...   . .    .      .    .. ...          . ...      ... ..  ..   .
. .     . ...             ..     .  ..    .        .        . .      . .   .   . ..      . ...  ..     .   .   .... .. .  .    .  .  . .   . ..   .     .  .          ..
.        .. ..   .  .     . .  ..   ... .      . .          .            . ..    .     ...     .      ..        ..         ....   .      .     .. . . ..               .
..     .  . .  .      ... . . . . .  .  ..    .    .     . .   .      ...  ..   . .    .   .. ..  . .     ..  . ..  . ..  ....       .   .. .  . .. . .     ..  ..     .
.      .     . .   .  ...      . .. ..       .    . .. ..   .    .    .   ..         .   .       ..   .        . ...  . .      . ... . .    .    .  .. .   .  ....   . .
..   ..       .   ..  .  .    .  . . .  . ..   . .    ..   ..     .     . .      .         .  .      .     .         .. .  .   ..  ..   .        .  ...  ......    .  ..
.  .  .  .   .. ....  .          .   .     .      .   .        ....       .     . .   .         .       .. .. .    ..  .   ..   ...     .   ...   ..  . .    .  .    . .
. .  . .  .     ...  ..     .  .              .           .    . .     .   .       . .    .    .  .  . . ..     .         ..  .      .   . .    ..     .  .  ..  ...   .
.     .  .     .  .  ...        .  . . .   .       ..    .       . .    .     ..  . . .   . ...  .    .     . ..   .  .. .   ..  .  .   . . .   . .   . . . .  . .     .
. .  . .             ..   .     .      .        .    .   .  ..       ..      .. . ..      . .   .   .    .   . .      ..  . .  . . ..  . .            .     ..    . .. .
...     .   ..    .       ....  .     ....    . .  .     . .   .    .    .       ..   ..  ...  .   .  ..    .. . ..  ..  .    .     .   .  .   ..  ..     .           ..
..          ..     . ..        .. ..  . .   .  .  . .    . ...     ..   . .  .     .  .  .    .            .   ..   .   .    . .        .  .  ..            .  .  ..  ..
.    .      . .  ... .. .  .     .  . .  ... .. . .   ..    . .    ..  .   .  .  .     ..  ..     .  ...   . .  .   .   .              .   . ..   .  .  .   . .   . . ..
.      ..   .     .  . .. .  .   .       .  .           .  .      .   ..  .                ..  r.       .  .  .    ...   .    .  .    .  ..    . .  . .      ..   .    .
.  .  ..  .  . ..   .  ..   .. .  .        ..    ..   . ..     .          . .  .   . .. . ....      . .  ..  .    . ... .  .  . ..  . ....          .  .           . ...
.     .. .  .  .   .    . .   .  .        . .     .  .  . .     ..   .... .  .    .   .    . . .       .   . .    .   . ..   ....  .     ....    .   .   .. ... . .    .
. . . .. .  .      .   . ...        . . .   .        .   ..        .  ....    .     .. .     .        .  .    . ..     .   .      ..        .  ..  ..    .. .    .     .
.  ..       .   .   . . . ..        .    .    .   . .  . .        .  .  .    ...   .      ..    .  .   .  .   .    .....       . . ...     .  .   .... . .   .  .      .
..           .  .      ..            ...         .    .   . .  ...   . .  .       .    . . .    .   .     .  . .       ..  . . ... . . ..     .   .  .      ..   .  .. .
.  ...    ..     .. .  .     ..  ....    .         . .  .       .      .        . . .    .      ..            .        .  .    .   .. ..     ..  ... . .      . ..  .. .
. .   ..  .         .   .  . .   ....    . .    .    ...   .       .  .         .      .. ....   .. ... . .  .. .   .    . .  ..         ..     .  .       .   .  . .  .
.   .  ..      .   .    .  . .    .  .. ..  ...          ...       ..  .   .   ..   . . .     .  .  ..   .....    ... . ...     .    . .  .... .... ..    ..  .        .
.      .        .  .         .  ..  ...         ..        .      .      ..  . . .         .        . . ..  .   .  ... ...   ..     .....                  ..  .     .. .
. .. . ..  .  . .  .      ..  .    . ..     ..       ..     . ...     .  .  ..      .   ..      .   .    .   ....       .      .  .  .   . .          . .       .   .  .
..      . .   .. ..   ..         .     .. . . .   .. .. . .   .    .. ......     ...  . .     .  .    X.   ..      . .       .  . ..  .. .  .. .   .    .  ..     . .. .
.      . .   .   ... .. . .        .   .      . . .      .     .     ..  ..  .    .   .. .    .    .  .         .   . ..   . .   ..        . .  .  .      .    . .. .  .
..   ....    .  .. .  .   . .  .   .. . . .       ... .  ..      .   .    .     .   .   ... .  .      .    .   .     . .  . .. .   .  ..   .    .                  .   .
..  ... ..  ..  .   .      . .                   .  . . . . .  .      .        .        . .     .   .   .    .     .    ..     ..   .  .  .   .  ..  ..    .        .  .
...  . .                ..  . . ..       . .  ... .          .. .  . ..  .... . .. ..    ..  .    .      . . .   .  ... . .    . . .  . . .  ...     . ..     . .... . .
.       ..     .   .  .   . .      ...    .         ... . ... . .  . ...  . ..   .      .   . .  ..     .  ..  ...    . ..  . ..   .  .     .  ..  . ..  .          .  .
.      .   .  .     .        . .. .  .    .... .  .. .    .   ...    . .. . .. .   .   .               .    . . .  .   .  .  ..      .  .      . . . .  ... ..        ..
.   .. . .   .  .  . . .. .          ..  .      . .. . .     ...   .  .  .     ... ..        .    ..  .     .    ..  ... ..     ..  .  . .. .      .  .    .. . .   . ..
. .    . .     ....              .      ...          .   .   ..      .      .   .  .        .     . .  .. .          .. .    .           .  ..             ..   .   .  .
..       ..  .   .  .   .  .        ..   . .    .   ..   ..  . .    .   . . .       .   .     ..             .            .        .  .   .   .  .  .    ..   . . .    .
.. ...   . .  .            .       . ..    ..  . .   .   . . .. .   . ..   .  .     .   .  .    .. ... ... .  ..  .      .... ...  .   .   ..             .     . .    .
. .           .    ... .     .      .     . .   .   .   ..  . ..    .       .    ..   .    ..        . ...      .       ...  .   .  ...  .   .    . .    .       ...  ..
.          . . ...           ..     .   . .   .   . .  .       .. ..   . ..    ..  .. . . .. . .  .     .    . .   .. .  . .  .    .  .. .   .    .         . .  .     .
. .   .     .  .      ..   .  .  . .             . .   .        . .. . .. .   .   . .      .    . .  .. .       ...      ..     .     .   .   . . . .   .      .    .. .
.   .. ...     . .            .  . . ....  .   . .. .     .   .. .    .   .  .    .     .         .     .   .... .  .    . ..... . .   ... .     .   . .. .. .      .  .
..  .     .  . .  .      .   .  . .    .    .   .     .  ..      .  .     . .     ... .  ..   .   . .      .    .   ..     .. .  .      ...     . .  ... ..  .  .      .
.     .   ..   .    .   .          . .  .  .    ...  . .    .    ...          . . ..    .. .             .   . .         . .. ...         . ... .          . ...    .  .
..  . ...   . .    . .      .   . .       ..   .  .   .   .  .  .    ..    .     .  .    .      . ..       . .. .. ......  ...    ...  .           . . . . .       .   .
.     .         .    ..  .  .    ..  .     ..  ..       . .    . .   ..          . ..         . .   . . .. ...  .    .    ... ..    .  .      ..  .   . .   .    .   . .
. .    .  .  .. ...    .      .   . ..   ..    .....             ..  .   .      . .. .....  ..         .     .    .  .  . ..        .        .    . ..  .....      .   .
.  .   ...  .        .  .  ..    .   .   . ...  . .  . .  .    .  . .     ..    .. .    .   . ..      .   . ...      .  .    . .  .  .  .      .   .        ..   . .   .
.   ...    .  ..     . .  .   .. ..   ..   .  .    .      ...   .     .   ..        .  ..        .        .  . ..    ..        ...   .      .  .  .  .  .  .  .  .. ....
... . .        .  .  .    .. .   . . .. ..    . .  ..  .    ..      .  ...    ....  ... .. .   .... ..    . . .     .  .   ..  . .     ..             .     .       .  .
.  .       .  . . . .   .   .      . . .    .   .    . . . . .   . .  ..   ...    ..    .   .   .. .     .   .....             . .  . . . .       .  ..    . .         .
.    ..  .    .                    ..       .   . .     ..   .    .     ..   .    .. . . ..      .    .. .       .    ..   .  .  .      .   .   .   .  .   .        .  .
.        ..  ..   .  .   .   .   .  .  .. .    . .   .      .    .    .  .  .    ...    .     . .  . ....       .  .  .    ..   .      ..  .. .       . .         ...  .
.. .. . . .  .  .      . .   . .                        ..   .     .      .....   .       . .       .    . . .           . .. . .   .  .  .  .  . . .           ...    .
. ...    ..   .    ..  ..        ..  .  . ..... ..  ..  .    .  ...   .  .  .    .    .. .     .   .     .       .  ..  . . ..        .        . ..  . .    .  .       .
. .     ...  .   .       .   ..  .            .. . .   . .   . .  .   .    ..  .       .        .   .        . ..   .  ...     ..     .       .   .      ..  ...   ... .
.  .   . . . . ......  . ...             .   .     ..  .   .     .  ..    .    .... .    .  .     . . ..   . .     .       . .          .  ..     . .      . .       . .
....      ..  ..  ..  .. ..  .     ....  . . ..  ....   .  ..    ..   .  . .   .  ..   . .    ..    .            . .    ..          .          .    ..  . .  .  .  .   .
.. ..   ..        ..  .    ..  ....    .  . .. ..   ..     .      .   .  .  ....  .          .       .       ..      . .  ..  .   .  .  .           . .   ..     . ..  .
.  .  .   .       ..  .     . .   .     .  ..   .    ... .        ....    .. . ..              .    . .     .        .   . .  .    .   .     . . .  . .  . ... .       .
. .          .  .    .   .. .. ....   .        ...  ..  .  .    .   .  .. .            . ..  .    .        ... .   .  .  .. .   . ..   .   . .   .  ..  .. .         . .
..       .          .  .   ..      .   .  ..   .    . .    .. .      .     . .  .. . .   .       . . . .             . . ..  . .. ..       ..   .. ......   .      ..  .
. ... .  .   .      .     .  . .    .  .  .    ..  .  .      .          ...  .  .   .  .  . ..   .   ....   .  . ..   . .   ..                         ..       .. . . .
. .  .  .. .   . .  .   .. . .     .   . .  .  ..       . .    ...  ...     . .   .      ...  .   .  .     ...       ..  .     .  .     .   .  ..      ... .....  ..  ..
.  . .   . .  .        .    . . ... .   ..   .           . .   ....        .  .. ...    ..  .. . . .  ...   ..   .  .    .  .   ..  ..  .    .    .    ..        .     .
. .        . .    .                      .....  .  . . .  .   .   .   .   .  .. .. .      ...                  . .     .       .  .     .          ..  .  ..  .        .
....  .    ....  . ..  ...    ..          .  . ..  . .       .   . ... .. . ..   .   ..  .. .   .        ..     .       .      .. . .        .              .   .  .   .
. .  .  . .  . . ..  .    ..      .. .        .     ..    .   .  . .    .  .. .     .        . . .             .       ...       .  . ..         .  .  .   . .  .      .
.  .       . .           ..        .. .  .       .         .   .  .    .. .  . . .    .   . .    .   ...           .. .          ..    .   . . .. . .  .     ..      . .
.          .  .    ..     . .  .    .           ..    ..      ..  ...   .   ..     .. .    .  ..      ..               . . .          .  .. .   ..   .     .  .. .. .  .
..   .       .         .           .  .    .  ... ....   .  .  ...  ..       .     .. .   .    ..     . .   .      .  .  . ..... ..   .       .                  .  .  .
. .. .  .  .   .          . .  . .    .    ..   ...     ...     .    ..      .... . .       .. .. . .     ..   .   .  ..  .    .  .    .  .    . .  .    .     ..    . .
.   ...       .  ..   .. .  ..        ..              ..   .   . ....        .. . .  .  ..   .     . .   .  ...      ...  .   .   .. .  ...    .  .     .     . . .    .
.  .  . .. . . . . ..... .      .     ... .       ..  . .  . .  .  .  . . . . . .  ...  .  .   .   . .  .  .   .     .      .  . .    . .. .. .  ..          .    . . ..
.         .         .     .   ..  ..     .     ...                 . ..   .   .    .. ..     . .    .   . .. .      ..    . ..     .. .   .   .  .     . .   .  .   .. .
..     .   .. .  .. .    .       ..  .  .     .    . .  .   .  . . .      ...  ..    .   . .. .   .        ..  . .    ..    .   .  .   ..        .   .       .  ..   . .
..         .          .     . . . . ..       ..     .       .. .    . .  .   .     ..   .   . .  .   ..         .  ..       .  .. . .       . .   .          . ...    ..
. . ..        ..     .    . ...     .     .   .  .       .   .    .. .  .  .  . ..   .   .   .. .. ..     . .. .     .  .  ..    .     .    . ...   .       . .... . . .
..  .   ..    .      .     ...   ...  ..       .    .    .  .   ..   . .  ..  .   .  .  .       . .    . .  ... .  . . .   ...  .     . .           ..    .  .        ..
...   .         .      ..    ..  .  ...    .... .  .. . .    . .  . .      .   .  . .     .   .    ..     .    .  .    .             .   .        .  . .....           .
..  .. .. .    .   .   ... . .      . . ...  .      .         . . .     . . .  .    . . .    . . . .   . . .   ...  ..    .  .  . ...   ..   . .     .  .   ..      . ..
..  .  .  . . .   .        .        . .        . . ...       .  ..   .      ..       .  .        .  .     .   .           . .     ..    .. ..   .. .  ...   .   .   . ..
.  ..   .                .  .. . . .   .     ..  .  .   .   .       .    . .       ..  ..     .   .   . ..   .   ..  .....  .  . .       ..       .    . .  ..     . . .
.  ..    .        . . .    .        . .        .    ...  .          .      . .  . ..  .. .      .           .    .  . .... .   ... .  . . .    ..   ..       . .  . .. .
... .   ..    .. .   ..          . ..     .     .  .    . .. ..    ..       . .  .. .        . ..           ..  .      .... . .  .  ..  .      ..             . ..     .
.  .     .. .    .   . . .......  .     .   .   .. .     .   ...   ..... . .    .  ...  .      .  ... ..     .   .  ..  .   .    . . ...  . . . . ..     .   .  ...    .
.            .    . .. ...         ...  . .      .      .   ..  .   ..     .  .. .     ... . ..   ..    ..  ...     . .    .  .  ..  ..   . . .. ..     .  .. .        .
....       ... . .   .     . .  .     ... .       . .    ..     .  ..    . ..    . .  .   ...    ..      ......  .. .    ..     ...   ..   .  .     .        .  .     ..
.      ..    .. .  .    . .   .. .      . .     ..  .   .   .       .   .       .. ...    . . ...  ..  .      . ..     .    .     .. .        .. . .   .   .  ..  ... ..
.   .     .               .    .     . ..    .. ..     ...      .       ... .       ..... .   .   .  .    .. . ....  ...              ..         . .  .   .....      ...
.  ..  .     . . ... ...    .   .    . .   .  ...   . .  .  . ...... ... .   .      . ..  .   .      ..  .   . ..  .  ..  .      .  . ....    .           .   . ..     .
.. ..         ..  . ..  .   .  .  .  ....  .  ...    .  .   .   .    .  .  ..  . .       .    ...  .      .  .      .. . .  .   ..      . ..            . . .        . .
.   .     ..       .  . ..   ..            . .    . .  .   . .  .    ...  .             .    . ..  ...    .. . .    .   .       ...   .  .    . .      .. .   . . .   ..
. .. .  .     .  .  . ..  .   .   ..    ..  ..  ..      .    .  .. .  .   .      .. .      .           ..         ..    ..    .      . .  .   .    .      . ..  .  . . .
..  . .       .        .  ...   .   .   .. .   .  .... .   ...  .     ..     .. . .  ..  .   .  ..  .    .  .       .. .         .. .   . .. .   . .     .   ...  .   ..
.   .    .   .   ...       .  ...       .  ..        . ..     ..       .. ..          .  . .               .  ..      .  .  . .  .   .. .       ..    ...  ..     .    .
. .        ....  . .. .         .   ..    ...   .         ..       ...     .   .    .  . .   .        . ... .   .  .       . .  . .. .. . ... .  .   ...  ..       ..  .
. .     ..    .  . ... .. . .   ...  .  ..  .                  ..   .   .  .   .       .    . .       . .     . ..    ..     . ..  . .     ..  .         .      .  .   .
. .     .     . .  .       .     .   . .  ..            .   . .  .  .    .. .        .    . . . .        .. .    .     .   ...  .  .     .. ....    .     ....  . .    .
.   .        .     . .   . .         . .  . .          .  .       .    . .   .  ..   ..  .  . .      .    ..  . .... .       ..   ..   ..   ..     .  . .  .   .    . ..
.  ...  ...  .... .  .  ...   .             .  . .   .   .  .  ..             .   .   . .   . .    .. .   .  ...     . ..  .. . . ..   . .     .  ..       ....  ...   .
.         . ... .    .  ..  .. . . .. .   ..  .    . .  .     ..         .  .... ...      .             .   .      ..     . . .  .   . . .    .   ...     .     ..     .
.. .    . . ...  .  . .   .   . .   .  .  ..      . ..      ..    . .    .  .. .  . ..  .  ....   .  .. ...        .. . .   ..  . ........ . .         ..      .     . .
.    ..      ..   ..     .    .  ..   ..    .        ..      .  .   .     ..     ...       . .    .. . ..  .        .   .  .      .  .  ..  .  . .. . .  ..            .
..    . .  .  . .  . ...   .. .  .      ...           ..  .          .      .. .     .     ..  . .. .          ..         .  . .  .   ..  .. . ...    . ....  .      . .
.. .  ...  ..   ..  ..  . .   .. .   ..     . .. .  .   .  ..  ..  ..   ..   . . ..   .     .     .  ...    .  ..  ... .   . .    ..   . ..  .   .      .         .  . .
.   ...     ...          . .        .   .      .      . .   .        .        ... .  .     ...    . .  . .      ..   . .         .             .  .     . .   ..  . . ..
.     ...   .       .      ..   .. ...   ..     . ...   . .. ..   ..    .  .     ..      . . ..   ...      .   . .....  . .  ..  .  .        . .      .    .   .  .. ...
. ...      .      ..      ..    .... ..    .   .. .   . .  ..   .     .      ...     ..  ..        .      ..   .....     .. .     .  .. . . . .         ..   ..        .
. . .    .    .. . ..      ..    ..     . ..       .  .    .  ... .  .  .  .   .  . ...  .  .         . .    .. .      ..  .....    ...  .. .   .. . .. .  .. . .   . ..
.  .    ... ..  .     . ..      ..    .        ..   .   . .. .  . ..    ..   . .   ... ... .  ..      .  . . .... .  .   .   ..  . . .  .... . .   .            .      .
.      .  .  .  .   .   ..         .  .  .     .  .... ....   .. ...      ..        . .  .     ..  ..   ..    ..    ..       .        .        .. .       .       .    .
...    . .  .         .         . .          ... .  .   .    ...   .  .. .     .    . . ....            . .   .    ....  .  . .    ..     .          .          .    ...
...    . .    .   ..  ..    ..   ..        .    . . .. .  ..       .    .   . . . ..      ..  . . ..  ..           ......   ..             .   .   ..       .          .
.   .        . ....       .     .  .   .     .    .  .  . . .      ...     ...   ...   ..  ..    .  .        ..        ..            . . . ..    .    ..     .   . ..  .
.        .  ... . ..   .     ..     .   .    .  ..   .  .   . ...  .  ..  .  .  . .     .   .    ..   .. .        ...        .    .        . . . .     .  . .          .
.  .  ..   ..       .      .. ..  .  . ..      .     .. .   .    .. .     ..  .  .    .  . . .     .   .  .     . .         .  .    .   . .  .     .    .          . ...
.  .       ..        ..  . .      .  . . .  .  .       . .  . . .  ..  ..  .     .. ..     ...  .   .   ..    ..    .    ...      .  ..    . .  .       .  .    .     ..
.       .             . .   .   .. .. .. .      . . .        ..    .      . .    . ..    .  .     .     . .      ..  . . .....  . .         .    .   . .      ..   ... .
.  ..  .    .   ... . .       . . .   .   . ..    ... ..   .    .. .....         ..     .     .. .                .     .  .         ..   . .. . ..     ..... .        .
. .  .  ...      .  .  .   ..   .     . ...   .  . .            .  . . .     .   .    ..      .    ... .       .        . .   ...  ...  ..  ..   . . .   . .  .    .  ..
..   ...   .    .    .                      .        .  .     . . .        ... .    .     . .  ...       .    .. . . .    .   .  .  . . .  .   .    . .          . . . .
..       .   ..  .  .     . .   .. .       .  .   .    .         . . ..    .  .  .  ..   .   ..   .. .   .   . .  .   .   .. .     .        . . ...          .  .      .
. .     .     .   . . .      .           .      .  .. .. .  . .    . .      . ... . .   .  .      .  .  ..    . .   .      . .      ..    . . ..    .. .  .. ..... .   .
.. ..     .       .         .         .  .    .  .     . .     . .    .   . .   .  . .   ..   .   .   .  .   .. .    .. .   . .. .         .  ..   . ....  ..  .. .... .
. . ..      .  . .     . .     . ..  .  . .          ..  .         .  .  .  ..   .  .  .      .  .   . .    . . . ..  ..   ..  .  .   .. .      .        .. .       . ..
.. .  .. .. .   .   .     .     .     ..     . ..   .                  ..    ..    ..    .           . . .   .  .     .         .    ..   ...    .    . .  ..          .
.    ....  ..  .. .  . .  .  . . . .  . .      ..  .        . ..   .   ... . .  . ..     ...   .    . .  .         .. ..  ...  ..    . ..      ...       .     .   ..  .
. ...     .   . .     .     .. ..    .        .      .          ...  .   .    ..  ..  .    . . ..     .    .      .  .. .  .         .    .   . ..      ..  .      .....
. .    ...   .    .  .      . . .       .    . .. .    . .    .   .        .    .  .  .  .   .  .  . .     ..      ... ..    .      ..     . .    . .  .   .    .   . ..
.     . . .      .    ..  .  ..  .   ..  . ..   . .  .      ..       . .      .   ..    . .     .  ...  .. .  .      .. .     ..       ..        .   .     .   .. .    .
. .. .  .    .  ..  ..   ..    . .     .  ...    .               .  .. .  .. .  . .   ..    .....   . ..  ... .. . ..       .  . .. .  .. .. .    ...     . .  .    . ..
.  .    .  .  .     .     .. ...  .  ..      .   ...      ...        .  .        .        .... ..            . ..       .         . . .. ..     .  ..   .    ..     .  .
. ..  .  .    . .   .    ..    ..   . .   .          .        .   .     .  .  .  .  .   .. .      .        .  ....  . . .  .    .              . .  ..  .. ..      ..  .
.   .  ..      . ..  ... .   .   .     .....  .  .  .   .. .       . .  . .  .     .   .     . .. ...       .        .         ....  .     .            ..     .  ..   .
.   .   .. .   ..  . ..   . .   .      .  .     . .     .  .  ..  ..         ... . ...     .  . .. ..    . ..  .....  ..    .   ..   ...  .       . ...         .    . .
..  .   .    ..    ..  .  .      . .    .     .     ...           .    .  .      ....  ..      .      .  . ..  ..   ..  . .  .  . ..  .   .  .   .....           . .   .
.. . . .  .   .     . .  .  ..  ..   . ..    ..     . .       .     ..     .    ... .   . ... . .   ..      ......       .  .     ....   .    .   .  ..     ... ..  .. .
.       .   . .     .  ..       .      .   .   .    . ..  .       ..      . .     . .  .. ..     .....   . . .   . . .  .   . . .  .  . .  .... ..  ..           .     .
.  .  .   .    .    .        . .   . ..  .      .    ....    ..          . .  .   . . .  ..     ..     .. ..  .       . . ..  .   ..    .  .. .      . .           .   .
..    .  ..   .. ..     ..   .     .  .         .   .     .  .  .         .     . ...     . ...  .. . . ..   .   ...      ..   .. ..   ..           .    .   .  .  . . .
.     ...     .  .        .  ..   .  .  ..  . .   .           . .. ..         .        .     . .    .  .  .        ..   ..     . ..     .           .   .  .    ..     .
.        ...   .  ..        .. .   .. .  .        ....   .    .      . . . . .    . .   .   .  .      .  . .  .. .   .    . . . .                 .   .           . . ..
..   .  .           ..    .  . .. ... .   . .   . .        .    .. .  . . . . .   ..  .  ..     .     ..      . .        ..  .    ... .  ...   .   .. .   .  .    .  ...
..    . ... .      .. .     .   .        .   . .  .  . ..                        ... .    . .    . . ...       . .   ..  ..  ..     .    . . ..         . .   . .    . .
. .  ..  .             .     .   .      ... .   .  . . . .    .   .   .    ..      .   .  .     .  ..   ... ..  ..  .   ...  .. . .  ..     ...  ..           .  .......
.      .  .   .     .      .. . .  . .  . . ...   .         .   .  .     ... ..    . .        .    .  .   .   .. .  .  . .. ...   . .  . .  . .            . . .  .    .
.   .  . .     .   ..   .  . .    ..  ...              .   . .    .  .     . ..   . .    ..  .. ..  ...   .     .          .  . . .. .   .. . . .    . .          ... ..
...    . ....        ..   .  ...    .     .. .  ..      .          .             ..      .       .     .    . .     .    .      . . ..   .  .  . .   ..   ..  .. .    ..
. .    ..    ... . .   .     ..  .    ... . .   .   .  .    .  ...    ..         .           .     .      . .  ..   .    .    . .            ... .   ..   .   .        .
. ..     .       .   ..   ..              .  ..  ...      .. . . .  . . .     .             .    . ..      .      ..  ..  ..  ..   .  .    .. .  .      .  .       .   .
. ..  .  .   .   .    .   . . .  ...  ..   .    .     .    .  .     .. .       ..  .. .  .  ..  .   .    .    .     .   .     .         .          . .          .    . .
.     . .  ..  .. . .. ...    .  ..    . .    .  .     .      .. . .    .     ....   ..   .  ..    .    . .. .       .     . .    .      ...    ...   ...           .  .
.     .  ...   ..       .. .                          .. .  .       ..   ..  .    ..       .              .   ..   . . . ..     .    .  . .     .           ...   ..   .
..              ..   ..  . .      .   .. .. .. . .    .        .  .     .. ... .  .     .  ..   ..  .     . ..      ..           . .   . ..          ....   .  .     . .
.    .  .  .  .. . ..  ..     .     . . .  .     ..    . .            ...     . ... .      .      .     ... . .. . .   .       .  .    ..   .     . .      .  . .. .   .
. .    ... ...    .  ..     . .       ....     .        .. . .  ..     .. .         .. .   ... .    . . .. ..  .          .  .. .  ..      .. . . .       . .  .  . .  .
.   .. . .       .  .    ..  .   .  ..  ..               . .   . .. .    . ...     .       . . .        .         .    ..          .   .. . .  .   .  .. .     .     . .
..  ...     .  .. .  .      .     .. . ..  . .  ..  . .   .    . .       . .. .  .  .. .         .  .  .   .     .     .       .  .      ..    ...      .         .  . .
.  .  .. .     . ...       .  ..  ..    ..       .     ..      . . . .    .     ..   ..  . .  .   ..  ....   .  .  .    . .  .  . ..   .     .       .   .    .   . .. .
. .        .. .. .     . ..     .    ..   ..  .  .  .  .  .     . .. .   .    .. .. . .    .       . .. .. . .        ....   .       .  .    . .   .. . .     . . .    .
.  .  .  ..     .        .   .       .   .. .. .... .    . . . .     ..      .     ... ....  . .       . ..  .   . .   .       .          .    .   . .  . ..           .
.   .. ..      . ...  . . .   ..      .  ... . .     .     .  .. . .       ... .        . . . .. .   ...        . . . .           ...          ...  ..    .          ...
.                         ....   .           . . .    . . .     .  ...   . .  . ..  .          .  .           .    .   . . . .   .. .      .   . . . ..      .        ..
. ...  ..   .. .       . . .. . .... . .  .. .   .  .      . .    .. .    .       .              ..   ... . .        .  . .  . ....  .. ... .  .  .....    .      ..   .
.    . .               .  ... . . .   .     .       .  .         .   ...    ...         .     . . ..             .    .. .... .  . .. .. .. . . ...   .    .          ..
........................................................................................................................................................................
