.........................................................................................................................................................................
.     ..    . ...       .     ..    .  . .    .   ..  .   .    .     . .  .     .     . .           . .  . .      . . .           .  ..             ..   . .      . . . .
.   .    .  .  .. .. .  .  ..      .       . .  .    ...   .    .     ..  .... .      .  .  ..    . .     .  . .  .   . .    .  ...   .         .... ..      .     ...  .
.  .  .       .       .                 .        .  .        .   . .    ..      ..   .   .   . .        .           .   .... ... . .        . .   ...      .   .  .     .
. .       .    ..     .  ..      . .       .    .  ..    . .      .   .  .   .. .         . ..  .   .    . . ...  .. .    . .     .    .     ..       . .   .. ..       .
.     .        ... ..   ..   .      .. ..    ...    .  .     .  ..     ...   .      .   ..  .   ....   .     .        .. . .   .    .. .   ..    .   .    .     . . ... .
. .  ...  .  ..   .. ..    .  ..      . .   ..    .     . .  ..   . .     ..  ..  .  ..   .    . . ...     .   .    .    ..  .  .    .     . ..     .  . ..  .     ..   .
.  ...  .  .       .. .   .   ..     .   .  .. ... ..  . .    .           ..     ..  ...   .   ...  .     .    .   .   .   .  ..     .   ...  ..  . . . . .       .. ....
. ..   .  .  .        . .        .  .     .          .     .  . ..  .           .     .... . . ..  .    ...   .   . .    .      . .. . ..          . ..        .  . ..  .
.  .    . . .  .   ... .  .  .    .  . .               .   ...   .      .   . ..  .  .     .      .  . .. . .    ...    ..  .  . .  . . . .   .      .      .. .    .   .
. .      .   .     .  . ..     .. .              . .. ...     .  ..               .   .      ..  ..   . ..  .. .    .   .      ... . . ...     . .    .    ..   ...     .
.      .        .   .    . .                  . .  .      ...         .  . ... ..     .. .   .  . .  .  . .   .. .    .  .               . . . .     .    .    .  .     .
.     .    .. . .       ..  . .  .       ...   ... . . . .  ..  . .    ..         .....    ..  .       ..    .   .  .  .  .    ..     .  .   . .    .     . .  .  . .  ..
.  . ...  .  .. . .  . .. .  .     .   ..    ....    .  .   .  ..      . .. .. .   . .  ..  .    . .  . .    . .     .  .      .  . ..      ..     .  .       .   .     .
.      .  ..    . .      ...   . .  .  .            .    . ..    . ..  . . . .   . .     .  .              ..  .....    .   . .  .. ..      .   .       ... .      .  ...
.  ....  ..   .   .   ... . . .  .      . . .    .     .        .   .  . .. .    .    .      .. ... . .   .    .     .        .          . .. . .   .. .    .   .. . .. .
.  . .  .    .   . .   .     .     . . .. . ..  .  . .   ..   ... .       ..     .  ..     .         . .   .      .. .      .  . . .     .   ..  .      .   . ..        .
. . .. ...  .  .        . .. .  .  .  ..          .     . .    .. .       .      .. . .   ..        .      .   .. ..   .     . .    ...      .  . . ..   .           .. .
. .              .  ...  .  .    .. . .            .  . .  . . . ..  .       .  . .     .   . ..  .   .   .    ...               . .....     .    .   .      .    . ..  .
.  . ..             .    .  ..  .   .  .      .  .   .. ... .. ..   ...      . . .          .     ....   . .    . .   .      .    .     ..    .    . .   .     .        .
.   . ..  .    .    .   . . .  .          . ...  .   .  .   . ..     .. .   ..           . . .. .  . . ... .  .. .         .    ..  .    . . . .         .   .. . ..   ..
... .          .  ..  ..      ..  ..    . .   .  .     .  ... .      .             .    .                  ..        . . .                    ..    ...    .  .         .
....               .      ....  .      .      . .. .  .      ... ..   .      . .   . .  ..  . .  .   .. .      ..   ... .   .. ..      ..       . ....  . .    .        .
..  .        .  .  .   .    .      . .    .  .     .     .   .      ..  .             .         .    . .. .     .   ..    .    . .       ..   .      .  .    .  .. .  . .
.   .   .      .  .       .     .             . .     ..     ..  . .  .       . . . .. .      .  .  . . ......    . .  ..  .  .. .     .   ..   .    . .    . . .   .   .
.  .    ..        .   .   .    .      .   .  ...   .  .   ..      . .   .             .  ..      . .     .  .            .   .          .   ...   . .    .  ..     .   ..
...    .        ..   .   .        . .   . .    . ..  . . .  .   .. . ..  ..      .     .  .             .. .       .    . .  ...... ... ..       .    .  ..  ....       .
.          .   ...  .                       .    ..   . .    .        .       . . .. . .   . ......    . .     .   .       . .         .      .  .      .   .. .  . .   .
... .  .       .. .      ..  .. . . ..   ..    .   . .  .... .. .  .        .     . . .  ..    .   ..       .. .     . ....  .   ..       . ... . ..  .. ... .  . .   ...
...   ..   ...     .  .     ....   . ..     . ..   .                     .       ....     .         .   .          ..  .  .. . .    .             ..    . .       . .   .
.        . .    ...  .   .  .         .   ..   .    .   ..     . .  .    .. . .                   .  . .   ..  .     . ..   .    .    .   . ..  .....         . .  .    .
..  ...   .        .  ...  .  .   .. . .   .  ..   ... ....    . . ..  .     . .  .      .. . .   . .  .  . .   .      .. ....     .          .   ...     ..   ..  .    .
..  . .    ..  . ..    .  .  .     .            . .     .      .  ....      .               .  .      .  .. . . .   . .   ..      . ..           .. . .    .. .. ...  . .
.   ...   .   ...         ..     .   ..   .. .      .  .  . .  .. ..   .. .  .      .. . .        ...   .       .. ..    . ..       ..     .   .   ..     .  .  .       .
.. .        .     . . . .    .. .  .             . .    .    .    .       .. .                 ...   ..        ..  ..  ..     .          .  ...  .  .    .  . .         .
.   ..    .. ... .  .   ..    .. .     .   .     . .. .     .. .    .   .    ..  .  .  .. ..         . .    .    . . .     .        .    . .     . .      .         ..  .
.        ... .         ...  ..           .....  .  ..   . .  .   .       .  ...   .   .  .    ..     .     .   .   .       ..  .  .   ..    .. . .       .  .  .. .    ..
. .   .  . . .     ..  ..  ...  . .   . .   .   .... .  .  X  .   .  .         .    .         ...      .      . .. .      .  ...    .     .. .  .. ..      ...   . .  ...
.   . .. .     .                .          .  .  .       .  .            .   .     .      .  .   ..  .           ... ..  .       .       ...   . . ..   . ..      .     .
.     ....      .   .      .        ...   ..   .. ..   .   ..  ..  .    .           ...    . .     . . .. . .     ..  .     .     ..    ..  .       ... ..      .       .
.   . .     . .  .  . . .       ...  .  .. ..   . .  .     . .   .. . ...  . .  . . .. .     . ...          .   .     .     ..  .     . .... .         ..   ..       .. .
..      .      ..    . .      .     .  . . . . . .     .   ... .  .     . .    .       . .      . .  . .   .    .. .       .. .. . .    ..  . . .    ...     .     .... .
.  . ..  . . . .   ..         .    .  .. .   .  .    .    . ...      .    .       ..           ..   .   . . .  .. .        ...    .. . ... . .   . .  ..    . .  ..  .  .
. .       . ..        . . .  ..    .   .  .  .. ....   . .       .   . .      .        .. .    ..     .    .        .   ...  .  ...           .   . . . ... ..        ...
... .    .    .  ..        .     ..  ..       . .   .             .  .  ... .   .. . .   . ..    .  .     .     .   .  .   . .       ..      ...     .  .   . ... .   . .
.   .          .   .   ...  . .  .. . . ..    .    ..   ..   . .   .    ..       ..   .. .  .      .. .... .   .    ..   .  .. .     .. . ..    . .   ...    . .   .    .
.  .        .. .    . .     ..  ...    .     . .  ..   . ..  .   ..  .     .   .  ......      . . ..  .     . . ..   .  .   .. .       . . . .  .     ....  ..  .       .
...  ...  ...    .     .     .      .   .   .    ..        .  .....   .   .   .  ...  .   ..       .        .  . .    .  .  .  ......  .. .. .   .. .           ..  ... .
.   . . ...   ..          . .             .. .. ..          . .      .  .  ... ..     .          . ..  . . ...       .                   .  .   .  .   ..  ..  ....     .
.       ..             .     ...            ...  .       .     .... ..  ...     . ..     . .  .     ...   .           .  .     .  ..  ..           .      .   ... .    ..
. .     . .    .       .    .      .  ..   .   .     . . . . .  .         ..  .    . .        .   .             . . .               . ..           ...   .        .. ....
.    . . .     .    .             ..      ..  .  ...     .      . .. . .  .      .      . .         .      .   .    .  .  .  .  . . ..  .  ..         .  .      .. . .  .
..   .. . .   .   .        .  .       ..  .    .  .  .   .           .    ..  ..    . . .. .. .  .   .. .  . ..   .   . ..   . .      .     ...  .. . .   ... ..        .
. ..         .                 .    ...   . . .  .   .         .  .  .   ..     ..    .        .  .     .       . .  . .         .. ... .   .    . . .       ..   . ..  .
. .. .  . .    .  .. ..  . .   ....   .  .   . . ..    .           .      .  . .     .     ..   ..        . . . .  ..   ..   .  . .. . . . . ....    .   . ..   .    .. .
.   .  ..    .  ..      ..    ..   .     . .. .   .  .  ..    ...     ...  .   .         ..         ..     . .   . .   ...  . .      ..           ... .       . .   .   .
.. .   .. . ..       .            . .    .   ..   .     .   .  .     .  .   .... .         .       ...           . .   . ..  ....     .   .   . . .. .  . .           . .
.  ..   ..   .    .... .  ...  .   .. ..    .    .      . ..          ..    . ..         ..     . ..    . .  . . ...     ..        .  .      .       .      .        .  .
.     ...  . .   . .      . .. .. .      .     .. ..  .. ..     .   . . .        . .  .      .  .    .   . .               .. .     . . ..   .  ..  ..   . .     . . . ..
. .          .  .   .  .     ...   .  ..  ..    ..  .   ..          ...     .  ..     .          ..       .        . ..  . ...  . . ..   .    .   ..... .    . ... .  . .
.     ... ...  .. ..  .     .  .      .  . .      .. .  . .     .       .           . ..    .  . ..   .. ..  .. . .  . .   .        .     .....  . .     .    . .      ..
. . ..  .. .       .     . .  .  . .    . ..   .     ..  . .        . .   . .  .     ..     .  . .. . .   .  . .....      .. .. .    ..... .  .    .   ..    .   ...    .
.. .   .. . . ..     . .. .  ... . ...    ..  .      .  . ..       . .  .  . ..         ..        ...   ...  ...      .    . . .            .     .  ..   .  .  .     . .
.    .    . . . .       .  .    .    ..... .   ..          .   .. ..   .. ... .    . . .. ..  .    .      ...  . ..        .     ..   .   .  .  .     . .. .   ... .. . .
.  .           .     ... .  ... .      .. ...     ..            .       ...   .. . .      .    . .      . .     .   .    .  ..    .     ..  .  . .   .  ... .      .  ...
. ..   ...  .    .    . .     ..   .. . .   . . ...  ...    .    .       .    .      .       . ..  ..  .  ...           ..     .  .   .    .   .  . .     .. . .    ... .
.   .  .. .  .      .           .       ....          .    .      ..   . .        .                  .     .   .     .    .  .   .     .. . .    .  .   ... .     .     .
.  .. ..        ..     . .         .   ..   .  . ..   . .   .   ..    ........ .           .      .          . .  .    . ..    ..          .    .  . . . .  . .  .      .
.   .  .      ..    .     .    .         .. . .. . .          . ..  .   . .   .  .       .   ..   . ..  . .       .         . .. .  .. ..   ...... .             .      .
.  . .       ... . ...  .    .    .  .        ..  .... .  .  . ..   .    .     . .  .     . .      .   . .. . .   ..  . . .. ..   ..      ..     ... .    .... .. .     .
.       .    ..      ...     .          .. .  .  .    .  .      .  . .  .      ..   . . .. .   . .    .    . . .   . .  . .  ...      ....... . ..  ...  .    .      .. .
. ..    .  . .       . . ... .                .   .   .   .       . . .. .            . ...   . .   .    ..    .  .    . .      .    .    .   .      ...         ...    .
. .           . .       . . ..  .          ....   .   .. ..     .. .    .         .          ..         .    ..    . . . ...  .           . .. ..       .           .   .
.    . . .   .. ..  ..   . .   .            . ...     .            . ...    . .. .. .            .  . . .  .  . .  .  .   .   ... .. .. ...    .   . .   ...  .....    ..
. .    .       .  .   . .              . .     .      .  . . .. ... . .    . . .     ...   .. .  .  .. .... .        . .     .  . .     .            .  .  . ...        .
..     .    ..         .. .  .    .  .. .      ..  ..    .  .         .  .....      .     .     . ...    .       .  .   ...  . ..      .      .  .    .        . .. .. ..
..   ...       .  . ..     . ...  ....        .         . .. ...    .   .   .   . . . .         ...  .     . ...  . . .. .  .     . .  .  .  .      .        . ..   . . .
.. ..  .  . . ..    .  .  . .    .   .      .       ...    .   . .  .     .  ..   ..           .   .   .  . .          . . .       . .  ..    ..     .. ..  ...  .    . .
... .. .         .  . .     .  ..    .           .      ....    .    ..  ..    .  . . ..   ..  . .    .. .   .    .   .       .    .  .    ...   .              .     ...
. .   . .. . .   .  .  .     . .  ..   . . .. .  .  .    .. .  .. . .        .  .    . . .   .   . ..    .  . ..    ..     ...    ..    .         . .    .    .      .  .
.        .  . .    .  . ..... . .....  .         ..    .   .     .    .   .        .  .    .   ... ... ... .. .               .       ..  .    .    ..  ..    .  . .    .
. . . .  .          .....        ..  .. . .        .   ...    ..       .  .  ..   .  ..      .  . . .       .     .   .. .... ......   .. . ..  ..   .        .. .      .
.   .  .         ..    .        .           ..     .   .        .  . .. ..                  . . .  .         .      . ..  .        .      .         ..               . ..
.     .  .   ..       ...    .        .  .       .  . . .  ...  . . .            .           .  .   . .  .. .   . .  .  . . .  ....  . .          .     ..         .. . .
. ..       ..    ....   ..  ...  .  .      .. .           . ..    .  .  .     . ..       . ...   .  . .       ... .... .  .  ..       . .    .    .  .   ..   . . .   . .
. .   .       .   .    .   .    . ..  .. . .     . .. .        .. . ...  . .    ..  . . .    ..        . ...   .      .   . .       . .   . .... ..     .          .   ..
. .                 .. . .    .     ..  .    ..    ....    .. .          . ..... .         .. ..  ..    . .  ....    ..  .          ..  .  .  .  .           .    .  .. .
. .   .    ....       ..    .  .  .      .  .         .         ..      .  .     .. .   ..   .. .  . . .     .     .         .  ...   .. .     .    . .         . .     .
.     . r ..      .             . .     . .       . .    .    .. .   . .   .... . .    .        . . .  .. .  .      .    .  . .       ...       .  . . .      .      .  .
....   . .. .  .   ...  ....      .    .     . ...   . ..    .  ..  .     . .  ..         . .. .    .  ....    .     ..... . .. .     .  .   ...   .. .        ..  . ....
.  .    ..   ...     . .  .. .   .     .      .  .  .  .       .  . . ..    .  . .   . . ..    .  .. .. .  .  ..    . .   . ...   . . .   . .     ..    .   .. ...   . ..
..   . .      .   .  . . . .        .  ..  . .     . ..   .    .  ...       .   .       ..     .   .  .. ..       .  .  .  .       .  . .  . .... .           . . . .   .
.     .   .      .    . .   .      . .   .    . .  ..     .   . . .     .  ..    .    .  ... ...  ..  .     .   .   .... .       ..  . .  . ..  ..  .. .   . .  ..  .   .
. .    . .   . . . .  .                          .      ..  .. . . .    .  ...   ..      ..    .     .      . . .   .      .    .   .  .  .        .              .  .  .
. .  ..         .    .  .   .  ..       . .  .     ...    . .   .   .  ..      ..   . ..         .   . .. ..    . .. . .  .    .    ..    ..    .. ... ....  ..   . .   .
. . .. .  .     ..     ..     . .    .      ..       .  .. . .  .     . . . .      .      .      ..       . ..  .        ..      ..     .  ...  . .   .    ..          ..
..  .. ..     . .   . . ..   .   . . . .  .  .  . ......   .           .    .  . . .. .   .  ..    .     .       . .  ... ..        .. .  .  ..      .   .       ..     .
.      ..     ..    .   .  .  ..  ..   ..  ..      ..  ..   . .    . ..  .  .          .. ... . .    ..    . ..   . .  .  . . .  .    . . .     .. . . ...         ..  ..
...    . .      . ... . .     .. .     .  ...            .      .      ..    ...   .   ..     .       . ...  . .  . . . .  ...    .     . . . .   .    .           .   ..
. .     .  .. ..     .. ...   .. .    .     . .     . ..  .  ...  .... ..   ..            .      .    .. .. ... ..  .   .      ....  .. .     . .   .    .. . .        ..
.         .    .  . . .. . . ....   .  .      . . .   . .        ....    ..   . .  .    ..     .    .     . . . .   .    .         .     .  ... . . .     ..    .      ..
... . .    ..             . ..  .  .   .  ..  ... .  . .  . .       .    .    .  . ..     .    .    ... .   .  .  .  ..  . .        .  ....  . ..    ....  . .  . . . . .
. ..   ..   .   . .           .  .. .  ..          . .   .  .           . .   . .     . . .  .  .  .    .  .  ....    .     .. .. .      ..     .  .    .    ..  . .    .
.         ..      ..     . . . .. . .    ..    .   .  ..         .     . .. .. .   .        ... . . .. ..       ..   . ..   . .    .    . ..   . . .       ..     ..    .
.   . ..    .     .  ....     . .  ..          ..   . ..    . .. .. .  . . ..  .           ..   . ..      ..   . .   .. .         . .  ..       ..    .    ... . . . . ..
. .  .  .  . . .     .  .     .   .   .. .       .. ... . .    . ..        . . .       .   .   . ..    .  . ..   .     .    .  .....           .     .        . .       .
..  ..  .. . .     . ..  .. .  .      .   .   .. .. .  ...      ..    . . ..  ..      ..  .    .      .   .  . ..  .                .      . .       ..  .    .    .  . .
..  .  .   . .    .  .  . .      .   .   .           . .      ..  . ..     . .    ...      . ..  .     . . . .    ..      ..                ..   .             .     .  .
. ..   ..        .    .                  .  .         ... .   .  . ..       .   .       ..        . ..      .  ...   .   .         ....   ....   .  . .. ... . .        .
.  .          .  .    .    .  .  .  .  .    ...       .    . .    .         .. .         ..    .   .     .           ..         . .  .    .             .   .  .. .   . .
.     .  .   . . .      .  . .. ... .   .. ..  .     .  .  .. .  .     .      .            .   .  .        .    .         . . . .         . ..   .   .  . .   .        ..
. .    . ...  . ..     . .   .  ..   .      .  .   .       .   ..   .     .     ...  ..             .  .. .    . . .   . .  .  . .          .    . .  ..  . .  .    ... .
. ..   .    ..       .    .  ..   .      ....  ... .   ....  .  .... . .  .    ..  .    .  .   . .   ... ..  . . ..  .  .     .     ...... .  .  ..   .    .    .   .   .
. .     .       .  .    .    .     . .. .. ..   .    . .      . ...     ..  .    . .    .    ..  . .  .   .      .   ..       . . . .  ..   .. .....    . . .      . .. .
..  . ....         .    ..  ..       ..        .. .   .   .   . ..  . ..  .... .  ..  .. ..  .  .   ..  . . .. .   .   .        . . .. .    .    .  ..  .             . .
.       . .  .   .   .     . .  .       ..  . .  .      .. . ..  .....     ...  .  . ...             . .. ...    .            .  .     .  .   . .   .    . .      .... ..
. . ..  .   .   .  . .  .     .   ....  .   ..  ..  . .  .   .  ..  .. . . . .      .     .    ...... .   . ..  ..    .  .  .   .   .     .     .           .... . .    .
.  .   .  ...    .    ...       . . . ..   .. .  .   .  . . ....  . . . . ..  .     ..  .     . .. ...  .  ..          ..   . ..  .. .  . .   ...    .. .  .   . . ..  ..
..  .         .    ..     .        .    . ..  . . .   .  . ...   .  .     . . . ..  .  .  .   . .....  ..... ...      ..   ...       ..    ..      . .     ..     .  . ..
. .       .  .           ...  .. .    .  .....   . ...        .    ..   . .  .   . .  .....              .    .      ..    .      ..  ..    .  .        .      . . .   ..
...   .   ...   ..       . . . ...  ..     . . .          ..  .  .       .   .   . .    .      . .  ... . .  ..     .     .    . .      .        .. .   .  .    .   . ...
..      ...    .    .....   . ...  .    .  ..  . .    ..  .    .    . .   . .  .  ...      .  . . . .. .  .   . .   .   ....         .. .   ..       .... ... .         .
. .    ..        .    .   .  ..  .  .  .    ..   ..  .      .. .    ..          .  .. .   .  .    . .       .    .      ..   .  ... ..     .   .     ...  .        .    .
.. .   .    . .          .. . ..   . .  .    . ..   . . .   ..        ... .        ..  . .. .. ..       .  . . .  .   .  .    . . .  ..         ...     ...  . .       ..
.         .  .     .   ..     .  .. . .  .  . .  .....        . ..  .        .      .. .        .              ...  ..     ..         . ..     . .    ..        . .  .  .
... .  .     . .       .     .  ....  . .  ..  .         ..  .  .   .  .  .  . . ...  ..   .  . . .  .   . . ... ..  . .      .       ..  ...  .       .  .      .    . .
.  .. . . .  .        .      .  .  .           .     ...        ...     .   .          ..           ..  .    . ... .     .     ..    ... . .    ..    ..  ... .. .... . .
.  .        ..        ..  .  .     .    .  .    . ..   ..   . . .    .    . ..  . .   .         .. . ..    .  .    . ...      .   .    .. . .       . .        ..  ..   .
. . . ..   .   ...    .     . .. . . .      .   .  .          ..  .  ..  . ..            .  ..  .   ... . .   .  .     .       .  .    . .      .         ..  .     ..  .
.  . .    .   .. ..     .    .    . .    . . .        . .      .. .      .   ...   ..        .     .        .     .. .. ...  ..  .  .    .  ..    .....   . .       . . .
. ..  .   . ..    .. .  .  .   .       .   .  . . .    .   .    .        ..     .           .   . .     ..   . ....  .   .     . . ..  . ...    ...  .   .. .   .    . ..
..    . .... .    .. ... ...  ..          .  .   ....      .. .       . ..  ..       ..   .  . ..  . .  ...      .  .       .  .    . . .       . .. .    .  .. .       .
..    .. . .   .. .. ..  .  .  ..   .             .    ....     .  ...  .  .    .  ....      . .           .    ..     ... .   .  .              .. ... . .    .. ... ...
.      .. ..     .    .       . . .             .       . . . .  ....       .  .       .  .   .        ..     . .  .... ..     .  ...    . . .    ..   .    .    .   .. .
.   .             . .  .    .     .  ..           .     . . . ..  . .  . .      ...     ..        .      .    .  ..           .      .. .           ..   . ..     .   . .
..   .   . . . .   ...  ..  .  .  .    .  . .  . ..    .           .  .    .     . .    .    .    ..  .   . ...  . .            .          .    .. . .  .              ..
. .   .. .     .  .   .    .... . .   ...     .. ......    . .       ..    .      .      ..  .   .     . ....     . . . .        .      .. ..... .  .  ..     .  .     ..
.  .   ..    .     .    . .  .   ... .. . .  .    ..  .   .. .    .. .   .       .  ..  .  . ..      ..  . . . ..  . ... ..  .  .    .. .     .   .             .       .
....   .                  .   .        . . . ....             . .  .     .   ..   .        ..  .      .    ....  . . .  .    .    .  .       .    ..    .    ..         .
.     .  .  ....  .    .. ..    .. ....    ...  .   ..  ..  .   ..  .    .   .    .   .   .  .   .    ..  .  . .. ..         . .         . . .         .         ..     .
.  .. .    ..        .  ..     .    .      .   . . .    .     .  . . .. .       . .    .             .    .. .       .. .      ..       . . .  ..  .  . .  ..   ...   . .
.       .. ..      .  .  .  .   . .  .  . .                 .  ..         .  . ..   . . . ..  .... .  .         ..   .    ..  .     . . ... ..  . ..  ..  .        .  . .
.. .. . ..  .   . .. . ..      .     .     .   .  .       ..    ..   . .          ....      .           .    ..          . . .      . .      . ..  . .           .    . .
.  .. .. ..  .     ..   .. . . .            .. .      ..   . .  . .      .. .. .. ..   ..   .   .. ..  ...   ..   .. .. .   . ...   . .     . . . . ..     .. .  .    . .
.  . . .       ....   ..      ..   .   .     .          .      .       .  .. ..  . . .  ..  . ..  . . .. .   .. . .        .   .  . ..   . ...     .  ..   .    ....  . .
. .   . .. . .     .. . . ..       .   . . . .      .  .     ..             .. .     .    .. .  .  .    .   .   .        .   ....  .  . .       . .  .  ..   . .      . .
.     .  .   ...     ...    .. . ..        ..   . ...      .    .       ..  ..   .. .        .    .        .   .        .     .      .     ..    .      .    ..    .  . .
.     .   ..       .          .        . . ... .  .         .          . . .       .  ..     .     .  ..    . . .   . ..   . .    .. .       .  .   .  .   ..  .     .  .
..         .    ... .  .        . .       ..   .     .. .   .    .           . ... .    .  . .    ..   . . ..    .   .  .. .       ..      .     . .   ..   . . .   .   .
.    ...            . .. .   ..             . .    .      .                .     .       . .   .        ...     ..   .    .  .    .    . .              .. .         . ..
.  .   .  .  ..     ...  ... .. .  . .. .      .  .   ..   .    . .   .        ..   . .   .            ....   .        .     ..   .  ..        ...        .   . .  . .  .
.  .     . .      .  .           .  .       .  .  . .              ... .           .  .  . ..  .   . .    . ..  .    .  .    .....  .         .  . .   . ..    . . . .  .
...  .  ..   .  .    .  . .       ...   .     . ..    .      ..  ... .. . . . . .    .       .    .  ..     ..    . . . .. .      ...   .         . .   .. ..    . ..   .
.      .   .   ....   .    .   ..   ... .    .   .   .  . . .    . .  .      .   ..  .               .   . . .  .    ..  .    . .        .        ..   ..  . .        ...
...  . .     .....          ... .   . ..   .  .       ..   .       . . .  .  .   ....... .  .    ....    ..   .              . ..       .  .         .  .   .   .       .
. .  ...  .. .  ..  ..   ..    .   ..    .   .   .. .      .     .  .          ...    . .. ...   . .... . ..       .      . .   . ...       .  .  . ..     .     ..  . ..
...          .  .  .  ..     .     .   .   .    ..     .  . .   ..        .     ... .  ...    . .  .. .      . ..    .. . . .    . . .  . .  .   .  .  .....  ..        .
. . .  .    ..   .   .      . ..  ..   .      ..   .   . .  ..     .   .                  . ..... .  ..  . .         .     . . .   .. ...  ..      .   . ..   . .       .
.  .     .    ..         ..      .     .. . ... . .    ....   .  . ..  .    .      .        . .    ..  .  .  ..     ...        . .        .  . . . .     ..    .  .   . .
..     .          .   . .  .     . .   .         .. . ..      .  .. .       . .  ..        .  .    .       . ..       .  .   ...  .. . .. . .       .     . ..    ...   .
.  .     .     .   ..  . .  .   ..      .   ..  .       . ...    .    .  . .      ... . ..    . .. ..    .   .     .   . .  .  ..    .  .   .  . .        .   .   ..    .
..  ..         .... .. ..             .               .  .  . .   .     ..   ..      . . .     . ..   ..              ..   ..     .. . .  .  .. .      ..     .         .
.     .                       ..        .. . .    . ..             . .. ...   .            . ..   .   . . . .              .   ..       ..    ..  .     . . ...   .   . .
.   .       ..      .  . .    .....    . .  .   . ..  ..  .  .  . ... .   . .    ....   . ...   .   .      . .  .  .      .    .. .  ...  .  .   . .    .  ..       ..  .
. . .   .   ...     .   . .      ..          .    .   .  .   .     .      . . . . .        ... .     .  . .    ..  . . ..  . ...     .. ...........   .  .   .       . ..
. .             ...   .    .   .         .  .  .. ..   .  .  . .        .           ..     .        ..     .... .. . .   .  ..    .. . .   ..   .  .   .   ...   . .    .
.          .   .     .  .     .. .. . . .. .  . . ... ..  . .  .. .    .   .  .    .   .   .  .   . .    . .  .  .       .     .    .... .   .     .    ..        .     .
.     . .          .. ..       ..        ..   ....  .... . .       . .   . ..  ..  . ..     .  . ..  . .. . .   .   . .         ...      .  .. .  . .    .    .     ... .
.........................................................................................................................................................................
