................
. .    .  .   ..
. ..           .
.  . .      .  .
..      .  ... .
... . ...      .
. .   .  .     .
. X . .. . .  r.
.  .  .    .   .
.  .      .   ..
. ..          ..
.   ..   .  . ..
...   .    .  ..
...    . . ... .
. .. .  .      .
................
