..........................................................................................................................................................................
... ..          ..   ......  .. .. .     .           .      .....  .   .   .        ...    .. .. .  ..          ... .  .. .  .      . .      .  .   .    .        ..  .  .
.   . .     ......    . .  .   ..    . . .     ..      ..    . .. . ..   .      .. .       . .          ..    .   ..    .   .  .. .         . . . .       ....  .. .     .
. . . .     ..        .. .  .  .     ..   .  .    ..     .  ... .  . . . ..  .     .     ..       ..    .  .  .    ...      ..    . .       .   . . .  .    ...  ..     ..
..     . .  . .  ..     .. .  .   . .  .  . .    ..              .     . .    .         . .. ..   . ...   .     .                          .   .   . .  ..     .    ..   .
.      .    .  ..    .  ..  . .  .   ...     .     .. .    .                      .. ..     .  .   .      ..  .  . .. ...            .    . .    ..   .. .. . .   . .    .
.    ... . ..  .. .     . .. ..       . .     . . .            .       .. .       .    . . .  .     .. .. .. . .      . .  .  .  .    ...      .  ...       ..      . . ..
.. .. .     ....   .... . ...       . ...    ...    .       . .       .     .  ...   .  . .                .    .         . .  .   .   .         . .   .   .  .          .
.   .    ..  .    . ..   .      .     ..    .    ...   . .  .   .  ...  .   .    .  .   .    ....  .  .  .. . . .    . .   .        .    . .     .       .     . .   . . .
..   .       .. ..      . .      .    .  .  ..    .. .  .     .      .      ..  ..        .. ..  .        .  . . . ..     ..  .    .    . ..  .  . .  .  .  .    .       .
.. .   .     .    ..   . .  .  . . .    .  . .           . ..        ..    . .. .     .     . .   .   . .   . .            ..    .. .   .  .   .  ..   .  ..   ..    .   .
.  .  .      . .. ....         . ...      .     ..   .  . ..  ..     ..    ...      .      .       .         ..      . .  .      . .    . . ...  .    .  ....  .     .   .
.               . .     ....      .    .   .  .. . .       . .       .     . . . . .     ..    .  . ...     .  .    ... ..    . .      . .  .  . . . .     .       . . . .
.  ..              .   .  . ..  .....  .  ..  .. .  .    ..      .. .. .  ..                  ..     . ... .  ..          .       .   .. .  .       .         .  .. .    .
.   .           ..     .    ..    . .        .       .. .     ..     .. .. .   .  . .....  . .  . ... . ....  .   . .   .   .      . .  ...   .. .   . .   . ..     . .. .
.  .   ..        ...   . ... .  .   .  .   .  . ..   . ..       . .           .   . .             ..          .      . .   ..        ... . ... .. .  .       .   .  . .  .
. .  . . .               ...    ..        .    ...   .  . .  . .        .         .. . ..    . . . .. . .    . .   .     .  ..    .  .        .. .  .....   .        ... .
.....  .  .       ...    .  ..     .      .         .....   . . .    ..    ...   .  ... ...    . .  .    ..  . .    . ....   ...  . .  .     ..      ...      . . .  .. ..
..  .. .    ...    .   .  .   ...      .   .     .  .     .  . ...  .       . . .   . ...     .      .  . .     . ...      .     .. . ....    ...    .        ..       . .
. .   ..   ..      ..     ... ...  ..    . .. .       .      . .  .  .... ... ...                . .. .. ..   .    ..      .    .    .   .. .  .  .       .    .  ..  .. .
.... . . ..     ..      .      .        ..   . ..  ..      .    . .. .        ...  .   ..     .    .  . ..       . .  ..  .     .     .         .     ..       .  ..     .
.          ..   .      . .  ...   . .  .     .       . ..        .  ...     .   . .   .       .         . .    .       ...        .         .        .  ...  . .   ..    .
..  . .  ... . . .  .        ..   .   .  .. . .  ..        .    .  ..  ... .      .   . .. .  .  ..   . ..          .   ..   .         .   .   ... . .   .. ..   . .   . .
..   .           ..  .  . . . .   . .   .   .      .              ... . ..  .   .  . ...   ..  .  . ..   .    ..    .. ...     .        . .      .   .    .        .  . ..
..   .      ....  .     . . ..  .   .     .     .   .. .  . ..  .          . .             . .  .. .  .. .   .   . ..  .        .  .         ..   .    . . ..    ..      .
.       .. . . .  ... .  .  .   .  ....     .   .   .        . .  .. ..      .      .  .         .  ..    .. ....  .  .  . ..       .         .   .   . . .....       . ..
. ... .  .  ..       . . .  ...  .   .    .   .   . . .... .               . . ...    .   .        .  .             .  ...  . ...   .. ..        ...       . ..   ..   . .
.  .. ....  .         .  . .      ..                  .. .   .  ..   .    .  .   .  .    ...   .     .  .       .  .  .  ..     .  .  .      .      ...      .    ....  ..
. ...... ..  .    ..  .. .   .    .  .       .      .    ...     .   .        .        .    .      . ...      .       . . .      .      .       .         . .   .     .. .
.   .    .      ..           .    .       ... ..   .    .   . .       .    ..     .     .        . .        .         .  .. . . ..           ..... .      .       ..     .
.              .. ... .      .    ..  ...  .     . .  . ..       .  .. .       . ..   .. .  . .. . ...   .  .  ... . . . .     .  .    .   .    .  ..  ..     .   . . .  .
.      .   .  .  .    ...   .       ..       .   .   . .     ...              . . . .  . . . . . . ..        .      .    . .  .  .   .  ..      .    .      .        .   .
.  ... .  ..    .               . .     . . . .  . .  ..  . . ..  .  .   ..       .. .. .  .   .    . . .   . ..      ..   ..  ...    .  .          .        ..  . .     .
..       .  ..     . .   ..  .. .  .        .   .  .  .  ..  .    .     . ... . .   .  ..     . .     .        .     .      . .    .    ...  .  .  .    .  . .  .  ...  ..
.       .  .      .   .      .. . ..           .   . . .  . . .      . .  .. .   .    .   .   ... ..    .     .    .     .            ..                  .   ...  .    ..
. .  ..   .    .  ..                .    ..  . . .   ..  . ..   ..   .   .. .  .            . . .       ...    .     .     . . ..    . . . .. .       .   . ..    .      .
.. .             ..   ..   . . .  .  . .  .    ..       .   .   .  .   .   .      ..  .  . ..  .  .  ..  .   .  . . .   ..   .    .   .. ..    . .         .      .  .   .
.    .....    .     . .     .  .  .    ..    .... ... .  .   ..    ... .. ...       . ..   .     .       .   .     .  ..  . ..     .  .   ..   ... . .    . .... .     . .
. .    .    .     .        . .   .  .  . . .. .. . .   .     ..     ...    . . . .       .  . .    .    .           ...   .   ..  .. .     .....    .                 .. .
.     . ... .    .     .... .      .   .     .      ..  .    . ... . ..    . .     ..       .. ...       .        .   .. . .       .    ...   ..  .   ..   .  . . .    ...
.     .    . . .  .                .   ...          . . . . . .      ..  .      ..      .    ..   .   . . .    .           .  . .. ..       .                . . .     . .
....    . .  .          . .   .  .  .....         .  . .        .  .    ..        .     .   . . .    .       ... . .   .   . .            .           . .       . . . .  .
..  .  . ...      .   ..   ..    ..    .        . .... ..             .. .  ..  . .         .       . . .. .. .    .  . ...  .   .  .     .   .      ..  . . .  .        .
..  . . ..        .   . .      .     .      .   . ... ..       .  .   ..  . . ..   .. .  . ..  . . . ..     .          ... ..     . ..  . .  .         .   ...       ..  .
. ... ..        .    ..    .  .      .     .  .           ...    . ......      . .    .         . . . . . ... .. . .. . .    .  .            .   ...   . .     .  .    . .
...   .     .. .                 .     . . ..  . ..    ..  .     .   . .     .   . .        .. .    .          .     . .              ..  . . ..      ...  .   . .    .  .
..  .    .    .   ... .  .   .    .      .   . . ...   .          ..  .   . .     . ..          ... .   .  .     ...  .           ...     .   .    .   .   .   .         .
.    . ..      .   ..   .  . .  ..   . .  . . . .....  .       .     .    .      . . ..   ..            ..            .   . .....  .      . .           .   .  ...  .    .
.. . . . .   . .. ... .   .   .. . .   . ...  . . . ..  .   .  .   .    ..  .  ...    ..    .. ..  ..  . .     . .     .  ....      .     .  . ..     . .  ..   ...   .  .
. .  . . . ..  . .     . . . ..     . . .  .    ..     .  .     ..   ....             ..    .. ..        ..   .   .   .  .         . ... . ... .    . .  ...    .     .  .
. .    .   ... .     ...  .  . ..  .. .   .... .                  .    .  . .         .  . .   ..              .  . . ..   .   ... .    ...                       .      .
.  .  . .   .      ..    .   .. .   . .  .  .           ...      ..   ...    .  . .. . .   .. ... . . .  . ..   .      .    ...  . .   ..    . . ...   .     .  .     .  .
. .   ...        . ... .       ...       .      .  .      .       .. .     ..   . .         ...  .    .    .    ... .     ..      ....       .    .  .  . .            . .
.  ..  .  .    .    .. ... .  ....  .            ..    .. .  . .    .      . .   .  .    . .    ...     ...  ..  ....    .. .    ...   . ..   .  ... ...  . .. .     .  ..
.   .  .  .        .  . .    ..     . .   ...    .     .    . . .  .    .  ..  . .     ..  . .   .   .  . .       .   ...         ..      .  . .  .    . ... .  .  ..    .
..     .    .. .       .. ..    .  . .     .  .  .   .  . .       .. .    ..      . .            . .  .  .  .   .. ..       .              .    .  ..        .. .. ....  .
.  ...  .. . . . ..  .  .         ....   ..   . .        ...   . ..      .... .   .   ..  .     .. .   . .  . ...  ..     .         . . ...   .     ...  .          . .  .
. . .    .  ..  ..   .      ..         .      ..     . .. .... ..    . .   ..   .    . . .  . . ..    .  .     . .   . . .    .. .  . ..      .     .  ..    .    .   .  .
..   .  .  .    .              .  .      .    .        .  .  ..      .   ..                   .  .. .  .   .  .     .      .  .    .     . ..      .      . .  . .. .    .
..    .  ... .     .    ..     .  . ...  .. ..    .            .  .        . .  . .  .. ..    .      ..     . .. ...  .  ...       .  .  ... .  .   .      . .   . . .   .
. ....   .   .. .    ...    ..      .      .. . .. .  . .           .   . .       .. .   .. .     . .      . . .. ...  .. ..  .   .  .  .  . .  .   .     ..    .  .......
.     .. .. ..  ..       .   .    . .   .   .   .    .   ..             . .   .    ....     .. .   . . ..  ..        .  .    . .   .   ..  ..  ..   .  ..       .. . ... .
.    . .     .     ..  ..        .  .. .            .  .    . . .  .         . ..  .  . ....  .  .        ..   . . . .  . ..  .      . .        .  . . ..    .  ....  .  .
. .... .  .      ..  .       .     .  .    .   . .  .    .  . . .  . . ..  . .. .    .           .  ..  ....  . .   ..  ..     ... . .      ..  .    .  .  . .       .....
.    .    .         .  .      .. ...   .. . .. .  ..     .        .  .         . .   ..     . . .   .       . .    ..          .  .    .  .           .  .    .  .     . .
.   .  .   .     ..  .   .  ... . . ....     .        . .     .  .. ..     .. . ....       .   .  .  . . .      ..    ..  .      ..   .   .  . .    .. .       ..   .    .
..      . .    .       .    .      ...    .      .  . ..   . . ..  . ..    ..  .        .. .  . .   .   .   .   .  .       ...   . ...    . .    ..    ..   ...          .
.  .... ..  .         .  .  .  ..      .       .   . .   .  .  .  . .            . ..   .   .      .     ..    .         . .       .. ..                 .     ..   .. . .
.    .  .   ... ...  . .  .       .    ...     .   ..  ..               ... .  . .    . .. ... .   .  .    . .  ..     . .       . ..     . .     .. ..      .. . .   .. .
. ...      . .   . .  . . .   .. .  .      .      .     .     ..     ..  ..  ..    .  . .   .... .            .. .     ...  . . ..   ...      ..   .  ...      ..   .  . .
..   .    ..  .  ..    . .         . . .     ..  . .    ..          .  .   . . ..          ..   .    .. .  . .     . . .  .      ..      .   .   .  .   ...  .         . .
.         .       .  .    . .  .           .     . .. . .    .  .            .         . .     .    .   ..           .     . .  .  .     .    ..  .    .  .      . ..    .
.. ...         .       .     . .   . . ..  .   .   .  . .. .. .. .      ..       . ..   ...  . ..    .  . .      .. . ...    .  ... .. ..  .  . ..      .     .    .  . ..
. .   .        .        . .   .   .... .   ...  .       ..   .           ..    ..  .    ...        ..     ..   ..  ....        .   .  ... .                .    . .  .   .
.....  .   .   .. .. . . ....  ..  ..     ..         . . .  . .  . .  . . .....    .      . .   .   .  .    ..     . . . .  . ...  .    ..   .  .   .   . . ..  ... .. ...
.    .     .. . .    ..            . ..      . .  .    .        .   .  ... .  . .    .          .      .  .  .  . .    .  . .    ... .   ..        . ..     .  ..        .
.. .     .         . . . .                   . .   .  .     . .  .      . . . .    .      .     . ..   ...  .    ..  .     .. .    . .                    ..  . .        .
. .. ..        .    .  .        . ........ .   .  .   .  . . .  ..       . ..  ...      . . ... .       .  .    . .       . .  .  .  .  .   .   .           ...    ..    .
..   .            .  .  .                 .. . ..            .        .    ..     .   . .   .          .  .  . .   .  ..       .    .                      . . .. .      .
.. .   .     .  ..  ..  ..          . ..  . ..   .     .       ... .  ..    .. . .    ..    . . .    ... .   ..          ..    . .       .     .. . .. ..     .      . ...
.   .        ..  . .   . .     . .  ..   . .  .. .. ..   .   . .        .   ..   .  .  ...    .. .   .... .      .. .  .   .            ..    .. .       ..   ..        ..
.          .  ..    ..     .. .   .   .. .   .  .. .    .. .   ..   .        ..    .            .  ..           .     .. .   .         . ..      .       .. . . . ...    .
.            ..          . .   .          .. .       . ..  .       .   .   ... .    . .  .  .    . ... .. . . .  ...     ...   .     . ..  .. . . .  .   .    .    ...   .
..        ..       ..      . . .. .. . .    . .  .     .    .  .. . . . ..  .. ..   .       ..        .. ..     . .   .  .  ..      .        .   .  .. .. . . ..   .     .
..  ..   .. ..  .   ..  . .    .  .. .    .      .        .    .   . ... .   .   .  .  .    .  .  .   . .    .    .        ...    ..    .      .    .   ..      .     .. .
.   . . ..  .    ..  . ..   .  .    .    ......    .. .         .  .    ....    .             ..  .  .   .    .. ..     . . . .    .... .  . . ..   ... .   . .   . .  . .
.    . .  . ..   .       .  .    .   . ..     ..            ...          .   ..      ..   . .  ..          . .       ..   .   . .  ..      .. .      ..  .. .. .  .. .  ..
..  .       .. ..    .. . .      ..   . . .       .    .  .. .   .      .    ..       .     .     .. ........   .... .  .   .  . .      .   .. . . .  .   ... .     ... ..
.            .   .  .   . .       .            .  . .. ..  .    .  . . .  . ...  .  ..  .  .  .       . ... .  .    .. .    .  ...  .         ... ..      . ..   . . . . .
. .   . . ...   .    . . .     .  .  .   ..        . . .  .     ..    .   .   .   .  .       ..         ..        ...          ..   .      .  .             . .     . .. .
.     .   ..     .  . .    . .   ..  ..   . .       ..  .  ..        .  .          ..       .. .. .  ...  .        .        ..      . .   . . . ...    .  .        . .   .
. .   . ...     .  . .  . ..         .   ..   . .. .  . .  .   . .. .  .. .   ..    . .  ..    .    .  .  .  . .  .       . . .    ..    .....     .     ...  . . ..  ....
..   ....  . .  .    .  .     .. . . .  ...        .   ..  .     .   ..   ..   . . .   ..  . .... .   . .   .. .     ..       .  . . ...             ........     .. .  ..
..        . ..  .    . . . . ..     .   . ...      ... .  .   . ..        .   .  . .   .   ..  . .      .. .   .      ..  . .     .    .   ..         . .  .    .   . .  .
.    .  .   . ..   ..         . ...     . ..  .. . ..    .              .     .    ...      .  .  .     .      .         ..  . .  .     ....   ..  .   ..  ..  . ..    . .
..     ..      .. .             ..  .      . ..   . .      . .    .  .   ....     .       ..     .    .      . . .  ..            .       .    . ..... .   .. . . .  .   .
...    ...   . .  .. ..    .  .     . .  .  .  .     . .        ... .  .  .     ..    ..     . .      .  ..    .         .      . .   .  ..   .   .      . .   . .. .    .
.....        .  ..     ...    ..           .    .   . .   .      . .       ..     .. .           .    ... .    . .. .     .  .    . . .      .   .     .   .. ..     .  ..
....  ..   .  . .      . .   ... .     . .. ..     . ..   .   .       ..   ...   .....   .  .         .    .   .  ..     .     ..           .     . . .            .  . ..
.   .  ..  .   .   .  . ...   ...      ..        ...   ..   .   .      . .   .   . .    ..  .. .. ...    ...          .   .       . ..     .   .   .  . ..    .          .
. . .  .     ...   .. . . .     .  .     .  .. .        .. ....               .   ..        .  . .  . .  .  ..   .  ...    . .   . . ... .  .  ...   ..  .     .   ..    .
.  .    .      . .  .. .   . . .  ..    .      . . ..  .  ...   ..     .           .     . ...         . .      .    .    .  ...         ..       . ..           ...   ...
. . ..  .  .. .  .    . .  ... ..  .   ..        .. . ..    .   . .   .   .     .  .. ..   .       . .   .  .. .. ... . . ..      .. .  .    .  ..   ...  ..  .   . ..  ..
. . ..   .   .   .. ...   . ..           ... .    . . ..      .  .  .       . . ..          ..  ...    .      ..       .      .       . .  ...    . .               . ....
. .  . .    .          .. .   ...       .    .   . . ...    ....    .   . . .   . .. . ...        . ....  .  . .   ...  . .  . .          . ..   .     .   .   .     .   .
.   ....      .. .. . .  ..      .       .    .     .  .    .    .  ...  .                            ..                     . .        ... ...     . ..   .. ..      .  .
.  .. .    . . .    .  .      . ..            . ... ..   ..  .  . ...       ..       .     .      . . .           .  .    ...    . ..  . ..     ..         .         .   .
. .           ..  ..  ..    .  .     . ....      ...  .      .  .. ..   .... .     . .       .  .    .  . .   . .      .   ..   .    .     .  .. .. ..  .              ...
.   .  ... ..... . .          .    . ..   . .  ... ..       .  .    .             .    . .. .    .            .     .... .       .   . ..   .    .     ...   ... . .  .  .
.    .     . .. .   ...     .           .        .   ..  ..      . .  ..  ...  .    . .    . .       .    .  . ..... .  .              . . . .   .. .    .    ....   .. ..
..    . .  .  ..     .   . .       .  ..       .  . ..   ..  .. ...  ..     ..  .    .   . . .   . .. ..         .  . .      ..  ..      .      . . .   ..    .. . .   . .
..      .  . ..  .   . .  .        .   ..     ...   ....       .  . .     . ..        .  ..           .    .  . .      .  . .  .  .     .    . .        .     .         ..
...  .  .  .    .  ..  .        .. .  . .   ..   .  .  .  . ..  .     .. ..        .   .  .  ..      .  .  . .  ..   . ...      .   ....  .  ..     .. .          ..    ..
. .          ...  .    ...     ..   .   ..   . . ..        .  .       .    . ...   .. .    ...       .  .     .    .  . .  . .    .  .. .  .   . .    . ... .   .    .. ..
.              .      ...               .   ..    .    . .  .     ..          .  . .                .....        .. .  .     .   .   .. ..  . .                . .  ..  ..
.  .  .   .          . ..   .  .     .    .  .  .. ..  .... .  .  . .     . ..       .    .  .  . .    . .   .   ...  .  ..   .      .. .        .  .    . .       ...   .
.  .   .        ... .      .           .. ..    ..     ...   . .    .    .     . ..  .. .. .       .    . . .       .  .        .  .  .   .      .   .   .   ..      ..  .
. .  .     . .     ..  . .    .      ..    .  .       ..   .        ..     .   .    .   .. .   .  .     . ... .     . .. .. . .  .  ..            .   .   .  ...        ..
. .  ..            . ..       .  .       . . . . .               . . .        .    . .   . .     ....  .  .  .  .  ..  ..        .   .      .   .. .   .   . . .. . .  . .
. .  . . ..    . .       .  .    .  .. ...    .  . ..    .  ..        ..      .   .  .      . .         .  .   . .. ..    .  . ..  .  ... . . .  .  .            . .  .. .
.  .     .  . .  .     .    .     .  . .      . .         . .   ... . . .. ..     .  .  ...     ....      .    ...  .      . ....  ..  .    .X   . .....      .  ......  .
. ...   . ..  .      .  .  .  ..    .   ..     .  .    . .  .       ..  .     .    . ..       ..    .        .... ...  .  .  ..   ..      . .     ..  ..   .    . . ..   .
..              ..    .  ..       .  .       .... .    . . . . . .. .       .     .    .           ..  .  . .. ..   .      . ..       ... .     . ..    .  . .    . .    .
. . .    . .  .  .    .      .               . ..         ..   . .    .    . .     .     ...     ... . ... .   .. .. . .     . . .. . .    . ...       . ....        .   .
.  . . . ..    .           .        ..    .       ..    ..        .  . .      . .    .  ..       ....           .  .    . .   .  ...          .         ..      .  ..    .
.     ...    ..     .   ..  . . ...   .... .. . .. .   ..  .    . . .          .. ..  .   . .   . .           .   .   . ..   .   .  ..   . .      . .        ..  ..  . ...
.    .               .  .. .  . ...   .           ..     .    .    .   .          ..            .    .  .         .     . ...   .      .. .   . .  ..  ....  .  . ..     .
.    .     .     .. . ..  .  . .            .     .    .        . . . ..            ..      . . .  .   .   ..     .              .  .. ..  .   .. .   ..  .    ..   .. . .
.              .  .       . .     ..      . .  .     ...   ...         .     .  . . ...  . .. ....   .    .   ..    .         . .   .  . ..  .    . .    ... .  ...      .
... .   .    .                   .. .  ..         .   ..     .  . ..  . ..      .. .. ..           ..     . .       . ....            ... .. ..     .                .   .
.     . . ..       .. ...     .  .   .      .  .  .                   ... .. ...         .. ..      .  . .   . .  .. .  .    .           . ..    . .                  .  .
.             . .           .  .. ..  .    ..  .         . .  .   .      ..  .  .         . ... .....     .    . .   ....  . .   .      .. .    .... .. ..     . .    .. .
.  .       ..  . . .   .  .     ..  .  . .   ..   .     ..  ..  .      .       ..    . .   . . . .  . . ...   .        .  .   .  .  .    ...  .   .          ..     ..   .
.  .  .    ..         .. . ....     .    ... . .  ..     .. .    . . .    .   ...  .    . .      .  ..   ..      ....  ..     . .       ..    .. .  ..   .       .     . .
.           ....          .            .      .. .      .   . .  .     .     .   .  . .    .. .    .  .. ....  . .     .     . .  .   . .  ...  ....    . .     ....     .
.. .    ..    .  .  . .    .    .  .   . .       . ..   .  .  .    . .    ..   ..    .    .  . ..     .  ... .. ..    .   .          . . .  .  .    . ..   .    .    . ...
. .   . .  .        .... . ..   .   . .  ..  .    .   .        ...    .. .     .    .     . . . .   .    . .     .     . . ..      .   . . ..  .. .     . .   ..  .    . .
.   ..  .   .    ..     .     . .  ...   ...          .       ..    .    .   .  .   ... .    .   ...       .  .. . .. . . ..   . .  . ... .     . . . .    .      . ...  .
.     . ...     .. . .   . .   ..    .      .... . .     .. .  .  .      . . .     ..   .    ....       .  .  .  . . . ..    .    .    . .   .   ...    .  .    .     .  .
.      .   ..          .... .. . ..  .        .       .  . . . .. .. ...        ..      .     ..          .        ..     . .    ...     .     . . . ..  ... .   .   .   .
. . ...  .  .. .    .    .        .    ..     .  .     ..    .    .. . .  . .   .  .        .  .. .  . . . .     .    ..  .      . .    ....       .. ..              .. .
.    .    .    . .    . .    ..  .    ...  .  .     . ... . ..    .   .    .    .... .     .   . .  .   . .  ...     .  .   ..            .   . ..     ..  . ...  .   .  .
.  .. ..   .      .  .  ...  . .    .   ... .. .         .   ..   .      . .      . .. ...     . .    .. . .. .  .   .  .   .  ..        ......  .   .   .              ..
.      .          .      . ..  .        . .    ..  . .   .. . .   ...  .       . . .  . .          .        .  . ...   .     .    . . . .   .  .   ....   . .     .    . .
.  . . .    ...     .     ..   ..   .    .   .      ..  .     ....          ..       .           . .           .     .   ...   ..        .   .   ..  .   .  ..  .   . .  .
..       ..         .  .  .       .   .  . ...    .     . ..   .   ...  .  .  .  .    .  .    .   ..    . . .   .   .  .    .  ...  . .   .    .         .            .. .
..  .   . .   .       .    ...        .     . ..  . .  . .  ..       .             .... .  . .   .   .   ...       ..      .     . .   .         .            .    .. .. .
...  .  . ..   . . .   .   .  .  ..           .        .    . . .  .    ... .  .   . .    . .    .      .   .     ..       ... . .  ..    . .    ..  .  .     ..  . .  ...
...    . ..        .    .  .     . .     . .   . . ..     .   ..  ...              .  .   . .     .   ... .. . .  .      . .      .  .   ... . .   . . . .     .. .     ..
.    .        .   ... .  ... .    . .    ..  .. ... .  . .  ...        .    ..            .. .  ..        . .               . . .           . .. . ..                 .  .
...       .  ...       . ..   . .   .    ..  .  . .     ..        . ... .    .. .  .       ..    .  . .    .         .   . . .   .     .    . .      .  . . ... .  .     .
.. ..... ...       .       ...    .       .  . .. .. .  ..    ..  ..  .    .    .. ..       .  .     .   .    ..  .  . .     .          .  ...         .  .          ... .
.  .  .   .    .    .      .        .    .        .    .  .  .  .   ..    . . .    ... . .        .    ..  . .   ..   . .    . . .   .    .  .  .   .   . .  ..   . .   ..
..       ..     ..      .  . .   .  .  .        ... . .. .      .  ..    .. .  .   ..  .  .    .   .  ..     .  ...     .     .            . ...   . . .  . .      . . ...
. .     . ..      ..  . .  . .. .          .      .         . ..     .    ..              .  .  ...   . .   . ..    ....    ..         .  .     . .     ...    .  . ..  ..
.  ..  .    .  . . . ..  ..   .  . . ..   . ...    .  .    .    .  .     .  .    .    .       ..     .    . . . ... . ..      ..     ..   ...          ..    .  ..     . .
....     .   .     .   .     .  .   .. . .r  ....    .. ..        .....      .   ..  .  . . . .     ..   ..     .       ..  ..   .    .  .    .   .         .   . . ..   .
.   . .... .      .    .        .    ..       .. .     . .   .        .   .     . .. .  .  .  .              .   ..    .. . .    . .. .  .       .   ..  . .   .     .   .
. ...        . .   . .  . ..   .    ..   .   .         .  .  . .  .    .  .   ..     .      .    .      ..    .     .      ..  . . . .  . . .        .        ..  ...  ...
...         . . . .      .      .      .   .. .. ..         .  .    . .    .  . .. .  ...    .  . .         .   .  .   .   . .  .   .  .   .       . .  . .. . .    .    .
. .   ....  .    ...  .     . .   .  ..  .      . .. . .     . .   ..           .       .   . .    .  ..         ..      ..        . . . . ..    .    ..  . ...    .  .  .
.. . .  .. . .  .   .   ....   . ..  .  . .         .    ..     ..          . .          .   .  ..  ..  ..   ..  ..  .                ... .  .  .  .         .       . . .
. .  ..     . .. .  . .   .      ...   .  . .  ..  .  .  .        ....     . ....     .  . .    .        .        . .  .    ...  ..  .     .   . . ..         ..  .   .  .
.      .    . . .  .   .   . .  .   ..   . .     ..     .   .      .      .  .    .   . .  .  ...  .     ...    .    ..         ...      ... .  .  .  .  .  .    .    .  .
.   . . .    . .. ..       . . .   . .      .     ...  .          ..    . . .  .      . . .  . . . .. .  ...   . ..   ... .     ..    .   .. . .  .    ....            . .
.   ..    ..  .       ..    ..   .   . ... ..       .     .   .. . ..  ....  .. .     .    .       .  . .              .  .        . ....   .    . .      .    . .      ..
..... .    .        .  .     . . .....   . .   . . .  ....   . ..   .   ..   .  .   ..      .    .  ..    .. .  .     .    .  . .. .  .        .... ..  . ...            .
. .. .       .. .   . .    . . .       ..        .  .    .   ..     .  ...   ..    .   .  . .   .     .    .  .       .                .  .    . .         .. .  .. .  . .
.  .           .   ...   .   .     .. .       .     .  .  ... .. . . .   .   .. . .    .    .. .          .  .    . .. . .   .  . . ..      .     .. ..     . ...  . ..  .
..........................................................................................................................................................................
