...........................................................................................................................................................................
.     ..        ..     .    ..  .. ..   ..    .. .   ....   .       .. ..       ..   . . .       .   . ... . .  .   ...   ..   .  .  . ..  ....      .. ..  .  ..     .  ..
..... ..    ...  ..... . ..   .   . . . .     . .  ..  .    . .    .       .  ..  .. ....      .     .   .  .  .        ..          .      .      ..    .    .   .   . .. .
. .   .  . .   . ..   .     . .      .       .   .  .    .  . .  . .. .      .  .      .   .  .        ..   . .     .  .   ...  .    ..   .    .            ..  .         .
. .. .  . .      .    ... .       .. ..  .   .  .  . ...  ..   .  .    ..   .  ..  ..   . . ..      ..  .     ..            ...    . ... ...   .    .  . .. .      .  . . .
.  .  .      ... .               .  . ..    .    .     . .....  .. .   . .  .  .   ..      .    .  . .      .   .           .. ..    . ..   ...    ..  .. ... .       .   .
.        .    . ..       .  .. .   .    .  .  ..  .. . ..    . ....       .. .      .... . .   .        ..   ...           .   .        .  .  .          .  .           ...
..    .   .        .        . ..      ..      .    ..  . .    .. . .        .. ......     .   .      .       .     .   . .  .   ...      . ..  ..     .. ......    .. .   .
.     .   .  . .        . ... .   .        .  .. .  .   .    .  .         .    .      .  . .  .   .    .  .         .   . .   .        . .   .. . .   ..       .     .    .
.   ..      . .  ..    ..   . .  ... .     . .   . . .  . .  .         .. . . ..    ...  ..  ...... ..  . . . ..  .     ..    . .. . . .  .     .   ...    . . .       .. .
.  .  .  ...  ....          .  . .      .   . .    . .  .   ..  .  .   .  .  .     .     .... .  . .   ..    . ..   ..       . .   ..  .  .  ...  . .     .         .     .
.      . .   . . ...      .    .         .     .  . . .       . .   ... .   .         .         . .  .        .  .      .  .. . . .. .   . .         .. . ....    .   .   .
.  .   . .  .   .  .   . ....          . . . . ...       . .  ...  . ... .    .  ..     ..      .  .   .  ..    .      .   ...   .           .  .  .  .   .   .. . .   ....
.   .... .  .    .       .. .      ..    ..         .   ..  . . .    .. . .   .  ....   .  .     . . .  .            .    ...   . .    .     .. ..   .  .     .         . .
.   .   ....      .   .  . .        ..    ..  .  .  .. ....  .. ... .  ..          .  . .      .    .       .   .   . .. ... ..  ... ..    . .     .       . .       . . ..
..... .   .      ..         ..  .   ..      .  ...   .       ...        ...  . .     .. .   . . ....   ...  . . .   .     .        .   .   .  .  .  .      ..       ..    .
.    ..    ..        .    .. .  ..     ....   .        . . .        . .  .   . .   . .     . ..  .       ..  .. . .  .  .. .   ..  .  ..      .  .   ...   .  .   .       .
..       . .. .     ..  .. . . ..  .  . .      . ..    .      .  .   . .     .        .       ..     .. ...  ..      .. .. . ..    . ..   .  .      ..          ..      . .
.     . .       ..       . ...  . .  .. ..     ..  . .. . ...  . ..   . ...    ..   ..    .  ..   .             .  .   .         ..   .  .        . .     .    .    .    ..
. .. .    ...   .       . .. ..   .   . .  . . .        ..   . .    . .    .  ..   .   .  .   .         .  .  .  .  .        .     .. ... .        .. . . ..  .   .  .    .
.  . . .  .     . .         . .   ..  .  .   ...  . .     .  .     .   ...    .          .. .  . .. . .     .    .   . .. .  . .  ..    ..    .   .  . .....  .    .. .  ..
.  .   ..       .   .......   .       .        ...        . .  . . ..   . ..  .  .   .      .      ... .  ... .. ... .  . .   . .   .. .   ..     ..   .  .     ...      ..
.. .  .  .     .  ...               . ....      .  .    .  .  ..  . . .     .     . ...     . .    . .     .   ..  .   .   .  . . . .  ..    .  .   ...     .     ..   . ..
. .   . .  .....   .             ........  .   .   .    .. .    .   .. . .  .. ...   .    .  . . .  . .   .   .     ..    .    .   ....    .. .. . ..   .    .   .        .
..    .  .  .     .  ..       .   . .  .   ..  .. ..   . .  .   .  .           .                 .   .    .      . .    . .    .           .    .  ..  .  .      .. .     .
...   ..      .   .  .        .  .  ..   .   .  .  .  .. .  ....  .....  ..  .    .      .  .      .    ..            . ....     .  ..   ..   .   ..    ..   .     ..    ..
.    .  ..     .       .  ... .   .  . . . .           . .. ..     .      .   . . ..   .  ..   ..  ...  .  ..        ..  ...  .       ..      .   .       . . ..  . ....  .
. . . .  .      ..    ..   ..  .. . .   ...   . . . . . .     .   .   ..       . .. .      .  .. .. .   .     . .   .  .       .  .    .. .. .. ..  .. .      .         ...
.   .            .     ..    .  . .     ... .  .    .        .  .  .       . .      .    .      ..    .         . .    . . .     .  .  .   . .   ..  ..  . .       ..     .
.       . .   .    .      . . ..          .            .        .    ..       .. .   ...     .   . .       ...   .... . .   .       .  .   . .  ..    ..  .           . . .
.      ..    .    ... .. ..   ... .        .    .    .  .   ....  .    . . .    ..    .    ..   ..   ...     .       .    . .   .         .  ..  . .  .            .  .   .
.. .  ...  .    . .. .  .. ..  . .  .. .. .   .   .        . .       .    .    ..        .      ..   ...    .      . . .        .  .     .        .      ...  ..  .       .
.           ..  .         . . .. .    . .  ... .    . . . ..  . .       . ..  . .             ... .         . .  .               .   .  ..         . ....  .    .    ..   .
.   .  .   .  . .    ..   .  . .      . .      ..     .   .     .   .     .       .      .   . ....    . ..                ..    .  .. . ..     . . ...     .            ..
.    .     . .   . . .  .    .   . . .  .   . .   . .  . . .. .       .    .   ..    ..  ..     .    . . ...... . .   . .   .. ..    ...       .....  . .       . ....    .
.. . . .. ..    ..   .   . ..        . .  .    .  ..   ...      .   .  ..  .    . .  .  ..     .. ..    . .         .        .  ..  .     .   ..   . . .     ..          ..
.  ..           .   . ..           .  .. .  ...     .   ..    . . ..  .    .       .  .          ...   ..  ..     .    .     .     . ... .. .        .    .   .. ..  .   ..
.  . ..      ... .  .          .      .  .   .   ..... .  . ...  . .  .  .  .  ..       . .        .          .   .              .      .    .        . .   ...  .   .    .
.   . . .. .  .       ....... .      .         ..      ..  . ..    . .       ..  ..  .      ..  ...  . . .  ..  ..          . .   .. . ..      .   .  ..   .         .... .
. .         .  .    .  ..... .    ..  ...      ..   .      ...    .  ..   . ..      .  .....    . ...     ....... .    .   ..  .        . ...   ..  .   ..            .   .
.    .  ....  .   .    .. . .. .   . .  . .  .   . ..     .  .        .         .    .    .    .            .  . . .      .   . . .. .   . .  ..       . .   ..   .  .  ...
..  .. .  ... .    ...  . .                 .  .  .     .    .  . .   .  .  .       .      .       .  .     ..    .      . . .     .       . ..  .  . . .       .. ..   ...
.    .   .     .    ..       .    ...   .   . . ..   .     .   .        ... .. . . .   .  .  .   .    . .  .   ..  .      . ...        .  . ..   .  .       .  .    ..    .
.     . . . ..        ..  . . . .   . .  .                 .. .. .. ..  .. .. ..  .   . .            . ..  .    . .   . .    .....      . .  ..              . ... .      .
.... ..    .        .. .      .    .  .          ..     ..  ..  . .  ...        ..       .          . ..            .  .  .      ...   .  .    ...   .  ...     ..  .. .  .
.   ...      .  .. .                   .  . .    . .  ... .       .. .              ..   .      .. . . ..          .  .      .. .   ...       ..      . . .    .     .  ...
.    .     ....   .  .... .     ..    ..   ..  .     .           .   .   .    . .  .   . ..  ..     . . .  .       .  ....    .            . .      .     .. . .  .  .    .
. ..  .    .     ..        .   .  . ..       . .  .. . ...   . ..       .    . ..   .     ..  .   ....        ..  .   ... .    .             . ... . .    .  . .  ...  . ..
.     .       .  . . .    ..   .. . .  ..        .  ..     .    . ..    .    .  ...       .    ..         ...  ...  .    .       .         .   .  .       ...    .  ..... .
. .   .      . .      .  ..  . .... ..   .    .     .   .    .      .       .   . ....  .  ..  ..   .      .. ..  . . .  .  . .   ..   .       .  .    ..      .. .    ....
... .... . .  .  ..       .       .  . .    ..  ..   .  .  . .            ... .  .     .      .  .    ..  .  .            .  ... . .    . .. .  .   ..     . .    .      ..
. ..  ..  ..            ...     .         .         . .  ..  .   . . .   .. .  .    .     ..  . .  .          .      .  .                  ...    . .  .      .   .  . .  .
..   .. .  ..  ..   .    .      .     ..    .       . ... . .  .     . .  .    ..          .    .    .   .         . ... ... . ... ..  .      .  ..         .   .   ...  ..
. ..      ..                  .    ..       .   . .    .       . .. .  .            .  .    . . . .   .  .   .    ..       .   ..    .   .   . ..   ..  .       ..   .  . .
.    . . . ..    .    . .       .  ..   .. ...  .  .    .        ... .    .          .    .    .  ....                 .        .      .  ...     .. .        . .  . . .  .
. ..  ..    .   .    . .    ...  ..      ...   . ...   .  ...        ... .  . .   . ..   .      .   ..   . .    . ..  .   .. ..    .      .     ...          ..   . . . ...
..   .   .          ..      .. .    ..    .  .    ...  . . ..  . .       .    . .    .  ...  .   . .  .                .  .     .      .     . . .    .  .     ...  ...   .
.  . .   . .    .  .   ..  .. .   .    ..   . ..     .. ..     . .     .  .  . .      ...  ... ...                     .  ..  .     .   .    ..            .      ....    .
.  .   .  .    ..    . ..   .  . .  ...     ....  .      .   .           . ...     .    . .      ... . .....    .     ...    .. . .  .        ....  ..          .     .   .
.  .... .   .. . .     .       .  .  . . .  .   .       .      .   ....  . .  ..     .      .     . .        . ..  ..  .  . .      . .   . .              .      .        .
.  .   .. . ..  .   .      .     ..  .   .  .  . .                .   .  .           . .   .      ..       .  .     .     .. ...              .   .......   .        .   ..
.     .      .   .   .       .. ..      ... . .   .     ... ... .    . ..      ... .                   .....     .  ..    .  .    .      .  .. ..   .   ..             ....
.  ...  .   .  .  .. . .  .   .       .  .      ..    .  . . ..     ..  ..    . .    .         .  .   .     .   . .      . .     .   .  .  . .. .       .  . .     ... .  .
.   .   . .   .  .  ..  ..   ..     . .  .       .   . .       ..   .  .. . . ..    ... .    .  .. .    . .   .  ...    .      .  ....  .   ..     .   ..    . ..    . . ..
.. ..        .   .    .  .  . ... .  ...   . . . .   .        .       ..   .              .      .       . .          . .  . ..   . . . . ..  ...  ..    . .  . ....   .. .
. .  . .   .. .    .  .  .         .        . .  .    .   .    . .    .          .          ..        . .    .       .   .    . .     .       .  ....    ..     . .   .   .
.......  ... . .   . ... . .... .  .  ...    .     .         .   .  . .  ..  .       .   ..  .    .   .   .  .   . .     .  .    .   .  .    .   .  .    .   ..         . .
. .. ..   .    .  . ...  . .  ....  .    . . . ... .   .   .    ..               .      .. ..  ...   ..   ...      ...    . . . . .  ..    .    .  .       .      ..   .  .
.   . .           .    . . .   .        ..     .       .   .     .  .    . . .   .       . . .  .    .    ...           .. .  ..       .   .    . ..    .  .         . ....
.. . .     .    .    . . ..  .    . .  .  ....      ..   .     . ..         .. ..  .  . ..   . ..   .        .  .        . .. .         .   ..   .  .. .      .    ..     .
.... .   .        .           .  . .    . . .   .         . .  . . . .    .   . .  ..   .. . .     . . . .    ..              ..   .   .            ...    ...    .     . .
.. ..  . . . .      .  .    .     .  .   .   .. .  . .     ...   .  .    .       ..  .   .            .        ... .  .  .    . .. .   ... ..   ... .  .     .  . .  ... ..
.    .  ..     .. .       .   ...   ...     ...       .        ..     ..     .    .     .  .        .     .           .    . ... .    . .. .     . .    .   . . ...  .   ..
. ...     . ..  ...      .   .        .   .   ...    .      .. .    .  .  . .    .   .. ..     ..          . .      . .  .      .  .   .  . .   . .   .        .  ..   .. .
.. . ..     ..   . ....  . .    ... . ...  . .        .  ..  .. ..   . . ..      . ....   . .   .    ..  .   .  .   .  . . .  .    ..   .     .         . .     .   .   . .
.    .      .   .  ..     .     . .  . . . . .  .          .. .    ...  .   ..  .  ... ...   . .    . .    .. ..      .   .. ...  . ..  .     ..  .   . .   .       .    ..
..      .            . ..      .   .    .  . .       . ..      .. .  ..  .             ...       .   .   .      .   ..    . . . . .. .   . . .   . . ..      .  .    .. ...
... .. .. ... .     ..  .        .     .     .    .. ..  .              .    .. .  .    ..      .. .. . . .    ..  .   . .   .    ...  .  .         . .   . ..    .   ..  .
.         .  .  . ..         .. .       .   ..  . .   ...              ..   .. .  .     .        ..  .      .  .        . .     ..    .          ..  .   .         .. .   .
.  . .  ...  ... . .   ..  ..        .. ..   .   ....  .      .  . .  .   .   .    .  .   .     .   .  . ...... .      . ..      .    .  ..  ...  . ...   .        .     ..
. ..   ...     .           . .       .     .   ..   . .    . ... . .   .   ..      .   .  .           . . ..     ..        X .. .   ..     . .  .     . .        . . . .  .
.  .  .     ... .  ..      .   ..   .  . .. . .     .          .. ..           .  .   .       . .. .    ..    . . . .     .  .. ...   . .   .  ....  .  .    ..   .  .    .
.       .   ..  .. .      ..     .     ... .            .  .        . . ..... .     .    .    .       ...  .. ... .    .   ....  .  .. .  .     .  .      . .     .  .  . .
. ..    . .     ..    ..     ..   ....    .     .  .  .  .  ..         .    .   .       ..   . .   . . . .          ..         .       . .. .   .  .     ...  .  ...   .  .
. .  .  .  . .. ...   .   ..            .    ..   ...     .  .                    .    . .     .  .. .     .    . . . . .  .  .. .  .       .. .       . .  .        .. . .
. .  .. .  .   . .      . .. . .. ..   ...  .   . . .  .  .  .  .     .   . . ..  .  .        .    ..     . . .   . .       . .          .  .  . . .        .  .    . . . .
.   .        . ..      . .. .    ..   .      . .. .. . . .  ..   ... .  .  .  ... .    .  .   ..    .        .     . .  .   ....   . ... .     .    . .. .   ..     .   . .
. .          .   .            .   . . .   .          . .     .            ....  ....     .       ...   .. .      . . ..        .  . .    . .         ..   ...  .          .
.  . . .    . . .  .      .            . . .  ...  .. ..     .  .  .. . .   .     .. .       ...   .  .   .     .   . . .     .   . ..... .   .  .  .       .  .. .  . ....
.. .  .    .         .....          .  .... . .....  ... ..     .. .  .   . .            . ... .   .      . .. .    .            ... . .   .     .      .  .       .. ..  .
... .              .  ...   . ...  ..   . . .. ....  .   ..      ..   .. . .   .   .    .       ....     .      ..     .     ....             .   .          ..      .  . .
.  ..    ...  .  . .   .  ...              ....  ......      . . . ..  .... .   . .             ..    ..   .    .  .      ... .    .  .   ....     ..  ..   .  .. . .   ...
...   ...          ...     .... .        . ...    .     .     .   .     .      .     .   .    .  . .    .. .      ...  ...   ..  . .        .   . .  . .  ...       .     .
.   .    .   ..  .   ..   .. .. . .  . .     .   . ..  ...   .    . ..    . . .       .    .    . . .   ..     . . .   .     .      . ..   .     ..  ..    . .  .  .   .. .
.  .     . ..    .   ..... ..         .  . .             . .  .   . ..             .  .  ... .. .      .      .        .  ..  . .     .   .  .         . ..   ... . ..    .
. .  ..   ..  .. .     .       .   .   . . .   .. ..     .   ..    .  ...... .... .      ....   . .  .       .   .   .   . ..  .   ..   .        .  .  . ..   .     .   . .
....     . ..     .           .. ..        . . .    . . .   . .  .  . ..  . .     . . .     .   . .  ...  ....  .    .. .       .  .  .        .. .        .       ...... .
.              .    .  . .  .     .    ..     ...    .     . ...      . .  .  .   ..  .    .   . . .  . ..   ...   ... .  ... . . . . . . ..   .  ..       . .  .. .    . .
.  . . ... .     .   . ..    .   .              .   .. .         ..  . ...            . .      . .        .. ..      . .     .      .   .   .         .  ...  ..  ..      .
.    .    .     .   .   ..  .  .   .      . .   .      .     .   .        .  ..  .  . .  ...     .             .   .    . .   .         .   .  .    .. .   ...  .       . .
.        ...   .          . .      .       .    ..    ..   .        .. ..   .         .     ...       . . . .. .  .      ..           ...... .       ..   .      .       ..
...  . .           ..    .     . . .  ..    .. .   ..    . ...    .             .   ..  .  .   .  .         .... .  .       ....       .     .    ..  ...              .. .
.    ..   . ..      .. . .    ..  . .. .  . . .     . .    . .   ..... . . . .    .    .        .   . .    . .        ..    . . . ..    .           .      .   . .      . .
.      .    .          ..       ..      ..  .   .         .  ..     . .  . . .          .. .     .  .         .   .      .   .     .    . ...    . .     .      ..    .   .
...  .      . . . .    .....  . .  .    .       . ... . .   .    .  .     . ....   .        .. . .. .     .     .      . .   .   ....  .   .          .   . .      .   .  .
..   ..   .  .  . ..       ..   .    ....    . ..  .    ......   .     .. .. ...   ..  .   ..  .       .. .      .        . .      .   .   .     . .    . .        . . .  .
. . .   .            ..   ..  .  .. ...     .  .  .  ... ..  . .   .       ..     ..   .. .   ..   . .   .      .       ..    .      . .   .  .        .    .  .  .  ..  ..
......       .    .  . . ..      .  . . ..   .      .      .. .  .. .  . . .  .                   ....  ...       .  . .    .  .. .  .  .   . .       ..    . ...  .  .   .
.              . .. .. ..   . ..     .  . ..   .....    . . . ..    .    .  ... .    .  ..   . .      .   .   . . .  .              ...  . .     ...     . ...    ..     ..
.      ..        ..       .      . .    .   .      .        ..   ...    ..         .  .  .    ..     .   .  .  ..    .  . .    ..      . . .  .   . .               .. . ..
.   .    .   .  .      .   .        .      .. ...   .  . .     .. .     . .. . . ..        ...  . ...       ..       ..   ...  . . .   ..  .  .. ...     ...  .. .        .
.   .      .. ..           .       .. .  .  . .    ... .... .      . . .        .   ....   . ...  .   . . ... . .    .   ..             ...  ...    .  . .  ..   .       ..
.  .      ..... ... .  . . .     .  ..      .  ..  .. .  . .   .     ...  ..   .      ..  .. .            .             .         ... ...  .     .   .  .  .  .           .
..      .  ...   .   . ..       . ... . .   ..  .  .. . .    . .  .     .. . .    .    ...  . ..       .  .   .        .   .   .   . ..    . . .           .          ..  .
. .   ..               .     . . . .   .. . .   . .   ..    ..     . .  .    .             .... .  . .. .              ..      . .       . .  ...   . .    .   ... . ..   .
. .  .. .. .    ..      .                             .  .          .   ..  . . .      . .  .. .. .      ...    ...  .       .   .       .       .     ..  .   . .   ..   .
..  ..  .. ..         .   .       . ..  . ...         . ...   . ...   ..      .   .  ..  ..  .  .   .  .  ... ..  ...     . .. .   .  .    .     .....     .     .. . .  ..
.     ...   . .   . ..      .  ..  . . .  . .             . . .    .    ..     .   ..    .   . . .              .  .        ..  .   . . .    .. ..   .     ..  .   ..    ..
.   ..    . ...  ..     .   . .. .. .      ...         .    . .       .       ...  .    .  .                 .  .   .      . .  .   ...   .. ..   .   .        .       . ..
.   .    . ..  . ..    . . .     .   .               ..     .  .  ..  .   .      . ..   .   . .   .   .. . . .     .    .  .. .  .. .      . . .  ..                .  .  .
.   . ..     ...      . ....   .  ..      .   .    .       . .  .  .  .. .  .       .   .   .          .  . ... .    .  .   .   ..     .       .   . .     .  ... . .     .
..  .. ..  .    .  .  .      . .  .    .    .    .   .  ..  .   .   .         ..   . ..       .   .  .               ..   .     ..   .    ...    ..   .. . ....  .     .  .
.  .   .       .  ..   . ..  .     . ..  .        .      .     . . .        .     .  .     .  ....   .          .     ...   .          ...  ..   ..  ...   . .   .        .
.   .      .  .     . . . ..  . .   ....  .  ..  .  ..  .  ..  .         .. .     .   .  ..  ....   .   .       .. . . .     . .    .     .     . .    .  .. .  ..    . ...
. .    .          .. .    .           .    .   . ..  .   . .  . ..    .      .      . .....  ..  .  .   .   .    . ..    .       .  .   .  ...  .    ..   .   ..   .   .  .
.. .       .   .   .         .. ..    . ...   .  . .. . ..      ...... .. .   ...   ..     ..  .    .. .   .       .        .  . .    ..     . .      .   .   ..  .  .   ..
.  .. . ..   ..    .  .... .  .. . .   .    .       ..       ..   .. ..  ...   ..    ..        . .  .   . ... .    .       ..          .     ..    .                .   ...
.    .     .   .   ....  .           . .          .         ...    .      . .             .      .  .   ..  ..     .    . .   .  . ...     . .   .      .      . ....   ...
..         ..         .   .            ....        .. .   . .    ..  .  . ....   ..    .  .   .       .   . ..     . ... . .   .. .           .  ...  .        ....       .
. ..   . .    .     .  . .   . . .  ..   .  .  . .   . .  .  .             .   .       . .. .. . . . .    .. .     . . ..        .  .  ..   . .  ..                . .   ..
.  . .. .. ..  .      .         .     .. .. . ..  .  .   . ...     .   .    . ..     .. .      ... .. .   .     ...       .       . .  .      ...    ..  .    . ....   . ..
.      . ..   . ...  .   . .    . ...  .      ..       .    .       .   .    . ..  . ..... .. .        .  ..  ..     .      ..  . .    .. .  .. .       .         .  . .  .
. ..       .   .    .     ...   .  .             ..   .    ..  .          .  . ..       .        . . .  .  .   .      .   .  .   .     .   .....  r   .   . .  .     . . ..
.      . ..    ...   . .  . . .  .. . .  . .. ...      . .  .  .     .     .. .      . .. ..      .      . ... .  . ..       .. ....   ..              .  ..    .. .    ...
.   .  . .. .    .. .     .          .   .      .    .       . .       ......    .         . .    . ....  ...  . .       ..    ..     ..    ..   . ..    .  .      .   .. .
. .   . .  .   .      .  .  . ..  .  .     ..     . .  ...   ..    .    .    .           ..  .    ..  . .     .  ..          .  .    .        .  .  ..   ...   .. . .. .  .
..    ...  . . .  . .  .... .... .  .. . . .. . ..   .   . .    ..      .     . .    . .     ..   . .. .    .... .   ...         ..  .    . .. .  .    . .     ...... .   .
.    . .      . .   .     ..   .   . .  .    ..  . ..  .    .     . . .          ..  .  .. . ..   .  . ..       .  .   .      ..        ..   .    . .  ...  ..  . .      ..
.      .        .. .. . .  . ..  .. .      ..  .. .    .  .           .. .  .. .     ..   ...     .    .  ..         .     . .     .          .  .  .     ... .   .      ..
...        ..         ..     ..... .   . ..   .     . . ..  .. ..      .  ..         .     .   .        .   .  .    .. . .      . .     .   . ..      ..        ..  .     .
. .    .  ..  .  .       .. .  ..  . .   ..        ..  .        .    .   ..   .   .   . .          ..      ...  .   .      ....... . .             . ... .    .   ....    .
..  .  ..    . .. .   .  .    .          .      . .    .  .   . . . .    .  ...      .  .      .  .     ..   ..   .. .    .       ... . ...      ..     .          .    . .
. . .  .    .. .           . .         ..  .  ..    .        .       .  ..     .  ... .   . . .  . . . .  . . ...    .            .   .      . . .       .  .     . .     .
.    . . .    .   .  .  . .  .  ...    ...      ...   .      ..  . .    ..   .  .       . .    .    ..    . .         . ..  ..               .    .  ...            .     .
.   . .  ....  .    .    .    ...    .  .      . .    .     .    .    .  .     .  .   .        .   .     . .... .  . .           ..   .  .            ..        . ..... . .
.   .. .     ...  . ..   .   ... ... ....   .    . .       .      . . . ..        ..     .     .. .        .       .   ..   ....     ..   . ..    ..        ... .   ..    .
.  .   . .  . .          ..       .  .. . . ..        . . .  .  .....   .   .        .   ... ...    .  . ....           ..          .  ....           .. .   . . ..    . ..
.      .  . .. ..  .  .    ..        .    .          .   .   . .      .    ..  .    . . .  . . .  .    .   ..   .......            ....  .  .. .    ....  .            ....
.  .   ..  .    .   .  ....    ..   ..  .  .    .. .     .      .            ...      .    .   .....   ..    .       ..    .       ..       .  .  ..   .    .        . .  .
.     . .   .. .       .     ... . . .    .                .  . .       ..  . . .     .     .     .  ..    .   .      .  .. .. .. .    .  . .    .  ...            .. .  ..
.          .. .   .              ...       . ....     .    ..  .     ..   .  . .      .   ....       . ... .       . .. . .  .    .     .   ..  .   ...     . . .  .      .
. ..                .. . .          . . .    .   . .       .     . .. ......   .. .   . .... .  .   .   .. .   . .         .   ...   .       .    . .  .         .  .......
... .   ..   .. . .    . .   .     .  .   .  . .       ...     . ..  . .   . . .     .  ... .    .  .  .. .    ... .   . .                .       .  .       .       . . ..
.  . . . . ..       .. .     ..    . . .          .. .         ..    .  .   .. .  ..  .    . ..        .              .   ........      . .     .     . .      ..      .  .
. . ..   ...  . .    . .   .  .  .   .  ..    ..   ..   .  .  .      . .   .        .   .   ...      .  .    . .. .  .                  . .     .. . .   . .   .  .     . .
. ..    .     ..   .  .  .   .....  ...  . ..      ..  .    .    .           .    . .  ..  ..  ..  .  .  ....  .    . .. .    .      .       .          .   ..   .      ...
..   .       ... .     .    . .     .                  .    . ..           .  ... ... .           .                   .  . .  .. .   . .  . .  . ...    .      .. .  .  . .
. .       . .  . .  . ...              .   .   .     . .       .   .. .    .   ... . .        . ..    ..   .    ..   .    ..      ..   .    ..   .. .           .  .      .
. .    .   .    .  .    .        .        ..   .   .  .     .   .. ...   .. ..  . .      ..  . ... ...  .   .      ..    ..   .   ..   .  .   .       ..  . ..    .  . .  .
.  .  .   .. .    . . .    .      .  .    .  .  ..    ...     ... . ..  .... . .....     ..  .     . . .          . .   .     .            .    ..   ..      . .   . .    .
.   ..           .  ..        . . .  .               .  .          .  .  . .   ..  .....  . ...       ...          .     .     .     ..  . .    .    .   ... .       ...  .
..     .    . .  .      .  .    . .   . .  .     .  . .   ....       . .  . .           .. .  . ...  . .   .            ..      ...    .   ..  ..     .   .     ..   .    .
..  ..  ..   ..  . ..                .  .   .  .  ..  .   .  .        .                  .    ..  .  .    .  .         ..   .       . .. .       .  .. .  .. ...      .   .
. ...  .             . . .      ....     . .  . .      . .    .    .    ..        .    .      .  . .   . . .     . .   . ....  .  . .    ..  ...  .  . .      .  .   .. . .
.     .        . .   .     .       ...    .    .    .    .    .  .   .        .     .                    .       .  .      .    . .    .. . . ..  .    ..        .     . ..
.         .. .     . .   .    .. ..  .. . ..  .   . .    . .   ...   .      . .        ...  ..           . .    . ....  ...        . .         .. .    ..    ..     . .  ..
.  . . ..      .        ..  .  .       .       ..   .     ....     .    .  . . .  .      .    .  .  . ..  ..   ..         ..   .    ..    . .  ....       .         . .....
.   .              ..   .  .   . .    ..       .     . ..          ..        . ..    .    .  .     .. .      .      . . .     .    .  . .  . ..    . .   .  .. . .  ..    .
. .    ..        . ..... ....            ..   .  ..   ..  .          ..    .    ......        ..   ..     ...     .  ..  .... .   ..  .    ..     .  .. .       .  ...    .
.   ..  .      ... .....        ..        .    ..       .  .. ..   . .    ..    .        .   .. . .    ..   . ..      .  .    .  .    .      .    . .        . ... . .  . .
...........................................................................................................................................................................
