............................................................................................................................................................................
..  .         .   . .   .            .   ..  .     . .      .  .   .  . .   ..  .  ... .  ..    . .           .     . ...  .   .   . . .. .  .               ..  . .     ...
..      .. .   .   .. .  .    .  ..   .. .    .  .. .      ..       .  ..         ...  . . .. .       . .   ..     ..              . .    . .    .   .    .    . .   . .   .
. .  .       . .  .  . .     ..       . .   .     .  .        . .     .    . .. . . .. . .      .  .     .  ....     .    ...    .. ...       .      .   .          . .    .
.      . .   .... .       .   .    .. ..   ..     . .  .  ..    ...   .   .      . ..       . ... .  ..  .  .   .  .  .        ..      ..    . . . ..  . .  .   . .    .....
. ..  .. .   ...       ....      .   .   ...     .  .   . . ...   .   .  .    .. .    .  .    .       .       .    . ... .    . ..      .   ...  .. .. ...        .        .
. .  .. . .     .. ..     .     .   ...   . ..  .  .  .     ..     .  . .    ..    ..    ..  .  .   .    ..          . . .   .   .      .. .                           .. ..
..  .     .       ... . . .  .   .  . .  ..       .   .  . .    .           . .. .   ..    .  .   .       . . .      .... .   . .  .  . . .. ...       .... ... ..    .   ..
..         .        .  .. .    . .   .     . .   . ...     ..       ...      .. ..    ..    . .  ...  ..  .                 . .   ...  . .  .  .   ..  .. .    .    .     ..
...        . . ... .         . ..  . ..   .   ..       .   .  .       . .           .   ..      ....    .   . .  .         . . .         . ..  .  .          ...    .  ..  .
..    . . ..  . . ... ..          ... .   ..        .       .     ....     .   .  .....  .  ..  .         . .     . . .  .   .    .  .   . .   . . .  .       .    .. .   ..
.        ..  .   ...  . .        ..  .         .  .   . .    .             . .  .. . .   .. ...      .       .     .  . .    ...       .      . .  .    .  .   . .  .. ... .
. . ..    . .    .            ...           .    .  . .       .   ..    . . . .....     .  .  .         ..... .         .      ..  ..       .  .         .   . .. ..     . .
...    . . .. .. . .      ..       ..     .   ..   . .       .      .  ..   . .  .. ..   ......    . .   ... . .      . ..       ..     ....   .  . .  .   ..  . .  .. .  ..
.   ..    .. .   . ..  .      .      . .   .  . .. .   ..   ..    .. .   ....         .     .  . . .       .. .     .   . .  ...       .. .    ..  ..         . .  .     . .
.  .          ..  ..      .   .. . .  .   ...    . .  ... . .  ..   .      .    .. .. . .    .  ... . .      ..  .        ..      . . .. ..  .  ..   .  .    .. ..    .. . .
. . ..   ..   . ..         .  . ...   .  .   . .  . .. .. ...        .           ..  .  ..     .    .  .  .     .  . .        .    . .. . . .  . . . .  .  .  .  .   .     .
.  ..     .... .   .  ..  .   .    .  ..     .   .       . .        .   .  ..   .  .  .     .. .. .  .   .   .  .. ..     ..       .     .    .       . ..   .  .  ..    . .
....     . ..   ..    ..  .....    .      .   .             .              .       .      .....   ... ..    ..  .      ... .  .    .  .   .   .  .   .  .  . ..... ..   .  .
.        .      .      . ...  . . .         ..  . ...  ..        .  .     .     . ...         .      .  . .   .  .   .     . .        . .   .  ...    ....    .    .. .    .
. .   .    .        . .  ..    .   . .   .. ...  .    .       .       .        . .  ..          ..   .   ..         ..   .  ..  .  ... . .  ...     .       .    .    . .  .
. .    ... .   ..  .    ..  .. .  .   .   .  .  .   . .. ..    .         ..  . .. . ..    . .  . .         .  .             . .. .    .       . . .     ..  ..  .  .....  ..
.    . . .    .     .   .        .. . ..        .  .     .  .  ..  .         . . ...      .       .              .    ..  ..  . . ..  . . .     .. .         .         .   .
.   . ..       . ....   .  ..     .           . .  .    .      . ..  ..     . .    .  .     ...          .    ...  .       ..   .    .    .   ..  .     .. .     .  .  ..  .
.                .  ..   . . . .   .. ...    .. ...     .  . . . ..        . . .  ..      .  . .      .    .     .               .    .. .      . .          .. ..       ...
.    .  . .         .    ..   .    .  .. .  .. .  .  .  .       ...    . .  ..  .  .  .        .    .    ..   .     . ..  ..    ..   .... . ..    ..      ..           .   .
. .        .  . .  .    .. .   ..  .    .  .      .. . .     .       ..   . . .         . ..      .. . . ...    .   .     .  .     .                 ...  .  .    .  . .  ..
.  .  .         .  .   .     . .      .    .    .   ... . ..  ...   .   .   . .   ..           ..    ..  .  .          .    .. .  .   . .          .....            . ...  .
.      .     .  .   .    .     . . .    ...  .. .. .    .     ..     .   . .   . .  .     . . .     . .     .    .   .. ..  . .. .. .......     ..  . ..    .     ..      ..
. . . .   . .  ..... .....   .. ..    .. .          ..      . .  . ..     .  .   .   .   .      .  .  .  .           .   .   .. . .  .     . .. .   .     ..      .     . ..
.    .        ..       .    .  .     . .     .                  .   ..  .    .          . .  .  ... . .   .. .  ... .  .. ..    ..    .   . ..   ..  ..   .    .      .  . .
..   .      .  .. .     .      .        .   ..    . . ..      ..      .    .  .   .     .  .             ..     .  . . . . .     .  ..   .. .   .     ..  .  .   . ...    ..
.. . .    .     .... .       .   ..  .  .. .  .   .    . . ..    .  ..            .     ...       .. ..  . . .   .   .      .    . .. .    .      ...    .. ..    ..    .  .
..    ..     .        .  . ..     .    .             .   ..  . .. .      ..     . .       .    ..      . .   .. ... .    .    .  . ...     . ..   .   .. .      .  .   ..  .
.  ... . .     .    .   ..  .     . .      .. .   . .   . .      .  .    .  .   .      .     .   .    .  . . ..    ...    .        . .          .  ...  . ... . .          .
...      .       .  .  ..        .   .    . . .    .  .   ..    .           .  .  .. . ..  .     ..     .  .   .             ..   . .   . .   . .   . .    .   ...   ..    .
.     .  ..  .  . ....  .     .  ..            . .   .   . ...         ... .             .     .  ..      ..   .   .    .    . ...        .      .   .   ....     .  .     .
.      ..        . ... .  . .   .         .. .      .  . .      ..        .     . .  ..         .  ..       .           .  .        . ..    ....     . . .  . ..   . .     .
. .    .... ..  .  .       ..  . .  ..        . ..         . .      . .  ..         .      .. . .       .. .   ...   .   ...  .        .   .  . . .  .. .  .    .   .      .
.    .      ..... ..  .           . ...     .   ..      .  . .    .. .   .    .   .           ..     ..     .  .   .     ..... ..   . . .  .    ..   .       . . . ...     .
..  .       .  .         ..  .  .   ..  ..    . ...   . .. .  .  .  ... .   . ..  .    ..  .  .  .  . .    .       .. .    ..     . ..    . ..  .  . ..  .    ..  . ..     .
.  ..  .  .  . . ... .      .   ......  .          .   .   .  .        .         . .   .   .   .    .  .. . ..    .     .    . .   .    . .. . .      .     .  .  . .    ...
.   . ..  . .     .   .      .        ...  . ...             . ... ..  .  . .      . .      . .    .. .  .     ..       .  ..   .   .. .    ..  . ...               .    ...
..   .  .   .     .   .   .  ......  .    ..      . .       .  . ..... .         . . ...    .         .  ..   . .  . ...     .      ...        .  . .   ...        .  . .  .
....  .   .  .  ...    ... .    . ..     .   .               .  . .   . .......  . . ..  .     . ..  .  .  .      . . . ...   ..    .. . ..     ..        .  . . . . .  .  .
. .   ..  .   ...   . .    .  .   .       . .            .        ..  .   ..  ..   . ..    . .  ..   .. . .  ..   ... .  .. .  . ..     .  .   .   .   ..    . . ... .   . .
.  .. . .    . .  .  . . .      . ... .  ...  .   . ..  ...  .. ..  ..  .    .     .  . .   .          .  ...               .  ..  .        ...     ...  ..       ..    .. .
. .    . .   .   .     .     .. . .        .  . ..      ..    ..   ..  .   .    ...   . .      .  .          ...    . .   .   .  ..  .   .    .  .  ..          ..  .  .   .
.  . .  . .    .   . .    .    ...       .  ..  .      .     .. ..          .              . . ..  . . .   ..  .   . ..      .        ...  .    . .  .         .          ..
.        . .  .. .   . .   .. .     .             .   . . .  .       .    .    .  . ..    .    .          . . .           .  . . .              ...            . .. . ..  ..
..   ..       .. .    ...     ..  ...   .   ..  ..     .    .  .   .  . .. .  .    .     . .   .  ..   .    .    .. .   .       .  .. .    .           ..   ... .  ... .  ..
.       . . . ..   .   .  ...     .  ... .  ..               . .        .  .  .   .      .   .  . . .. .  . ..         .. ..   ...  . .   ..     .        .   .      . .   .
.    .  . ..           . .   .     .  . . ... .  . ..... .  ..  .. .  ......    . .      .  .  .  .      . . .            .  ..    .     ..   . . ..  .   ... ..   ..      .
.  .  .. ..       .   .      .  . .         .. ..    .  . .     .       ..   .     .     ... . .  .     .    .    .          .    ..   .      .  .  .  ...        ..      ..
. . .  ..   .    ..      .    ..... .      ..   ..          .  . ..   . ..     .      . .   .          ...   .   ..      .   .     ... ..  ..      .      . .    .   .     .
.. .  .    . .    ..  .  .    .      ..  . .       .... .   ..  .   . .     .            ..  ..   .  ..    ...  . .  .        .  .        . .  .. . ...    . . .     ....  .
.    . . ..       . .   .  .         .  .   .    .. ..  ..  ..   . . ..   .     . ..  .  ..    ...  . .. ..       ....        .  .    ...  . ... .     ..                 ..
.    .  ...   . .   .   .  .  .. .  .   .... . .   .  .......   .        . .  .      .    ..  .         .     ...    .  . .    ...   .  .   ..  ..     . . . .   .  .. .  ..
.   .  . ..  .       ..   ..   .    .   . ..          . .      ..      .   .. .    .....  .  . .   .  .. . .                     .     .. .  ..  .. . . .   .   .  .       .
.  ..    . .      ... .                   .   ..   .....  .  .. .       .       . ..   .    ..                .. .    .   . .. .  .. . .... .      ..  . .   ...       ..  .
.        ..    .        .    . ..   .....       .  .  ..       . .   .   .      .. .      .   .. . . .  .  ..    .      .  ..    ....    ... ..  . .       . .... . . .    .
... .    .        .  . .  ...  ..... .  .   .  ..   .  ... ..     .  .. . .  .. .           .   ...     . . .   .  .   .       . ..    .  .  .  .    . ..    . .. ..     . .
.      ... . .  .    .    ..    .    .           .        .  .   ..  ..     .  .   ..   ...   .. .   .  .      ... . .  .        .    . .   .        . .  .......   ..     .
..    ..     . .  . . . .  .. .. .  ..   .    .    .     .        . . .         . .   . .    .  ..  .    .  ...   .  . . . .  . .       .   . . .  .        ..      .  ..  .
.     .        . . .      .      .  ..            .  ..   . .. ...   .    . ...     .    ... .   .         .... .    .   .         .. .      .  .  . ...        .  ..   .. .
.      .   .             .   .. .       ..     . . .  .       .     .        . .   . ..  .   ..     .  . . ... .    .  .. .. .      ....     .      .  ...  .  .      .   ..
.   .  ..          .   . . ..     ...    ..   ..        .... ..     .            .        .. .    .  . .             . .    ... .... .  ..   .  .  .    .. .      .   .    .
...    ..       .. .     ... .. .                .   .      .  . .    ..  .  .  .  . ...   .     .    ..   ..       ..    .    .  . .   .  ..  ..      ..   .  . ..  .    ..
.                    ...   . ..    .    .   . .   ..            .     .    .       ....     . .. . .. . ...   . .  ...   .. .. ...     .  .   .        ..   ..          .. .
. .      . .     .  .     . . .  .     .         .         .    .    . . .   ....     ..  .  ...  ..    .    .    . ..  .     .      .       . . ..   . .     .  .. ........
.   .. . .  .... . .   . .. .    ..  .         .    . .  ..  . ..  ..          .     . ....  ..     .      .              ..  .  .....  .  .   .  .  . .     ..    . .. .. .
.. ..   ..   .   ..     .   ..  . . .    .. ..   .   . .  . . .     .    ... ..  .        .         ...   .. ..       . ..   .  ..          .       .     . ..  .   ... .  .
.         .      .                 .         ..    . .     .. ...   . ..     . .   .  ...  . . .  ..     .   .  .    .. .  .   . .     ..  . .....       .. .     .    .   .
. .   .. ..  ..    .  .   . .       .     ..   ..     .  .. .     .     ..  ..  .. .. .. ..   .    ..        ...         .  .    .      .. .   ...     .  . ..  ..    ...  .
. .    . . .....  .  ...    ...   . .  .    .   .   ..        .       ...        .   .      .. . . .        .     . .  .. .   . .      .       .         .  .   . .        .
.      .  . ..    .  . . .      .    .         .....    .   .         .      .     . .       . ..  .   . .    .  .   ...     .  . ..        .        .     .. .  .. .   .. .
...   . . .   .  . .. .        .   .       ..  .   .     . . .  . . . . ..       .    ..  . .     .  .     ..      ..  .  ..      . .   ..      .      .    ..   ..   ..   .
. .  .... .    .  .    .. .   .        . .   .     .. .  . ..     ..   .         .                  . .  .. .    .      ......   ..      .  .   .     .  . ..  .  .. . . . .
..    .  .. ..       .    . .  ..   .  .      .   .              .  . . .    .  ..    .  .  .     . ..     . .  . . ... .  .           .    .       .       .      ... .   .
.       .    .   . .   .  . . .  .  .       ..   ..      .   . .          ..     .   . ..         . ...   .         .   ....     . .  . . ..   .       .   .  ..    . .    .
...  ..  .       .       ..         .   .          .     .        ..      .       .     .    . .   .   . ..  . .. .     .   . ..     . . ...    ...       ..  ..   .    .. .
. . .    .     .  .  .            ..       .  . .... .  .         . .   . . . .     ...         ..    ...   .  ..                . .         ..  . . ...   ... .. .    .....
. ..   . .  ...  . ..   .  .  . .     ....          .  .. .   . ..        ..      . .    .. .          .  .  . ...     . .     ..         .    . . ..   .    .   .    .    .
..        .. .  ...    ..  .   .  .         .  ..      .   . .   ... .  .  . .    ..  . . . .....  . .  .   . ... .     . .         . . .   ..      .  . .. .. .     .     .
. . .   . ... .   ...  . .    .    .   ..  .      . ..  ...  .. ..  ....   .    ....  .... . . .   .    . . .    . .           . .    .     .   .   .  .         . . .     .
.    .   . . ..  ..              .. ...  ..         .     .  . .. .. .   ..       ..   .  .       .    .. ..  ..        .  .. .  .  .   .  .. ..    .... .   .      ...   ..
.                .. .   ..  . .  . .     .  .      .   .    ...         . ..            ...      ..  .    ..     .   .   .    . .    .  . .    . ... .. .      ..  ..      .
.   ...   .     . ... .  ..  .  .    ... . .            ..  .   .       .             .  .   .  .  . . . ..     .   .  .           ..   .      .   .    .     .  .     .   .
. .      ...     . .  . ..    .   ..    ...      .  ..     .   . .   .   .... . .  .    .    ..                .    . .     .. ..  .   .          . .   .   .  .    . .    .
.           .  ...     .. ..  .. ..  .. .   .    .  . .  ..   .    .. .      .   . .  . .. . .      . . . .        .  .           . .   .    .      ..... .   .. .  ..     .
. .  .  .   . .     .   .          . ... . ....  .   .. .. .    .       .          ..   .       . .     .  ..       ..   .       .. .    . . .  .    .. ..  .  ..  ....    .
. .    . ..  . .     ....   .. ..        .   . .     ..   .. .  ..  .   .     . .  .   .....  .   ..       .      .    .  .. .   . . . ..          .    .  ..  . .. .  . ...
...       . .  .   .      ...       .  .      .. ..      .  . . . . ...    .        . . .  .  .   . . .      .  ..  ... ..      .  .  .    .. ... ... . . .        ..   .. .
..          . . .....  .         . .           ...   . .        ..   .  .       .. .....   .      .      ..  .    ... . .      .    .   ...   . .  ..  .. .  .    .     . ..
.   .      .  .    .         .   ....       .     .  .   .    .    .       .     .  .            .  .  .       ....  .    . . .  . . . . . .  .. .. .. .    .     .  .. .  .
...   ..     . .  . ..               ..     .  . . . .     .   .. .  .   .  .          .       . .   .. ... .  .   .   .  .  ..  ..     . . .      .     . .  .         .  .
.          .  .           ..        .     ..   . ..   ..  . ..          .   ..        . ... ..    .      . .  .   .      .   ..   .  .   ..    .....  ..   .    .     .    .
.      ..     . . ...    .  .  .         . ...   .  . ..  . .      ...        .  ...   . .   .      . .. .          ..   ...   .     .   . .  . .      . ..   .. .  .   . ..
.   .    .   . .  .       .  .  ..  ... . .     .       . ...     .  .   ..           . .   . . ...   .         .  .    ..    ..   .  . .    .  ..       ..       ..   . . .
..       .  .  .  . . .   ....  ..      ..  .. .  . ..    .  .     ... . .        . . .   .   .   .        .  .         ..    .      ....    . . .  .   . . .  .      .. . .
. .         .     .     .    ..   . ..     ..     .    .         ....    .   ..      . . ..  . .. .    .    ..  .      . . . . .. .    .      . ... .  .. .. . . . .       .
. ..                      .     .     .               . .      .     .   .   . . . .         ..  ...  . .   .  ... ..  . . .  .  ..         .  . . .  .    ..    .   .. . ..
.  .. . ... ..  .. . .   .   . . . .   .    .  .. ...        .        .        .  . ..     .. .    .  . .  .      .    .   .  .. .      .   ..      .  . ..    ..  .  .   ..
.   .         .   ... .     ..   ....             .   .       .       .     .   ..   .      .            .  . .     .   . .   .      .  . . .  .          .     .        . .
.   .. . ... . . .     .  .     .. . .. .  .      .         . .    .. .          .      .      .      ..  . ..    .        .  .    .. ..  ..   . . ..  . ..    .    .  . . .
.     . . .. ...    .  .          .....   . ..  . .      .       .     .   .            ...      ....   .         .   ..     ..  ...      .   ..     .     ...     .    .  .
... ..   .          ..   .     .    .. .      .         .  .    ..     .    .  .     .           ..      ...    .  .      .        .   .. ..    .. . .    .. ..       .   ..
.        .   .  ..      . ...    ......  . .    . .     .  .         ..     .  .      .  .     . .   .   .      .      .        .              .  . ...  . .   ..          .
. ..  . .         .    ...       .    .. ..  ..   . . . ..   . . ..        .    . ..  .  ..            ..   .  .             .  . ..            ...      .  .    .   ...  ..
.  .  .  .      .   .          . .. . ..      .       ... ..    .  . .  .        .    .    . .   . .. .  .   .  .. .  .              . .   ... .. . . ... ... .   ..       .
.   .      .   .  . ...     . . ..   .   ..   . .        ... .  .    . .    . .          .  .   ..     .      .    .     .  .  .     . .    .        .  .  . .     .     . .
.      .    .          . .             .    . ..  ..    .. ...  .        ... .. . . . .  ..         .   . ...          .  .  . .   .    ..  . ..     .   . ..  ..     . . ..
.    .. ..         . .       .     .   .....          .   .  . . .. .            . ..                  .... ..    .       .       .. .    .      ...   .   . .         .  ..
. . .      . ... .      .   . .       .. .. ..        . ...   .  ...  ...  . .    . . .       .  ..      ...     . ..               . X..  .               r .   .. .     ..
.    . .    . .. .     ...  . .          .   .    .  . .. . . ... .    ..    ....      ..  ..   . .        ... ..    . .. . . . ...    . .     .        .  ..         . .  .
.    .       ..      .... ..     .              ..  . ..    ..   ... .. .     ..     .      ..    . .  .... . . ...  .       . . ..           ..   ...    .      ....   .  .
..      .    .   .. .   .   ..  ..   .   ...      . ..    . ...   ..   . .  ...     ..  .    . .   ....                 . ...            .      .       .   .  .  .        .
.  .        . .         . .. .       ..  ..  ..  . . .  .      .   .    .. .. .   .       ..   .        .     ..           ..   .   .      .....      .  .  .  ..  .   ..  .
..       ..       .  .   .   .  . .  ..  .   .. .    .   . .... .  .. ... .. ...   .          . .  . .    .     ...    ..  ...  ..  .  . .. . .  ...  . .   .. ..  .  .. . .
...      .   ...    . .                  ..    .     .    . . .       .     .     ..  . .            .. .   .  . .    .      .  .    .....     .   ...  ..   . . . . ..    .
.     .    .....   ...  ..   .          ..    ....      ..   . .   .   . .  ..       ...     ....  .        . . .    .. .   .. . .  ....   . . . .     .     .       .     .
.             .... .         .  .  .    .  ..       ..  . ..  . .    .   .  . . .       . .            . .  .  . ..    ... .    .. . .      .  ..   .   .. .     ..       ..
.  .  .. . . ..        .   . . ..    . . . .      . . .  .   ..   ..  .  .   .   .   .    .   .    .   ..   .  . . . ..           ...  .. .   . .     .   . .....    . ..  .
.  .  ....  ... . ...        .. .....   .  .   . ....  .   . ..    . ..       .       .  ..     .          .   .                   ...     .. ..  .     .          ..    . .
.  ..     . . . .  . . .  ..    . .         ... .   .  .  .    . ..   .  ..  .  .  .        .  ... ..            .         .               . .          .            ..  ...
...   .   .     .     .   ..   . .   .   ... ...  . ...   ....     .    ..    .   .  ..   ..      . .       .     .  .         .  .. . . .  . .  .  . .. ...  .  . .    ....
.    . . ..  . ..         ..    .        . .   .   ..   .   ..      .. .  . .  ..   ..   ..  . .           ..      .        .. . .   ...   .. .  ..         . .        .   .
. .. ..   .  .  ..  . . . .   .  ..   ..           ....    .     ...  .  .       ..  .  .. .    .        .         .        .   .    .   . .     .    .  ..  .   ..  .  .  .
..   .   .      .        ..             ......  .   .  . .   . .  . .. .. . .  .     .. .  .     . .  ..   .    . .     ..  .          . . . . .     .. .    .    . .  .   .
.   . ...     ..   ....   .   .    . .  . . .     .. .               . . .    .  .  .    . ..   ...    .   . . .  .         ..     ..   ..    . .   . . .             .   ..
.       .         .  .  . .         ..         .   ..      .   .    ..    ..   ..  .   .       .       . ... ... .         .   .   ...  .. .    . .  . . .  .        .  ....
...     .. .   .       .           . ... . . . ..  . .       .     .   .  ..   .    . ..    .  .   .   .              .     . . ..   ....             .       .  . .  . . ..
. .     .  .    .   .. .    .       ..  .   ..  . .   .              . .   .   ...   ..   .. . . .      .          .    ..    .   ... . .  .  .  .       . .   .. .    .   .
. . .       .  .     ..  . .  ... . . .  .        . ..    .  .      ..   .          .       .  .  .  .    . .   .                .. . .        .  .. ..        ..   . .    .
.       .   .  .  ..   .  .        ..    .    . . .      . .  .    ..     . ....     ..      . ..   .   .      ..  . ..   .. ..  .  .           ...  ... .   ..         ....
. .  . .    . .. .  ..       . .     . .        .   .   .  .  ..    .. ..   .   ..  .  .    . .            .  ..  . . .     .        .              . . .  .  . .       . ..
. ...   .  .  ...   . .    . .   .    ....  .           ..     . .   . . .  ...  .  . ...  .       .....     . .        .    .    . .       .   .. .        .           .  .
.       ..  ..    ..    ..     .. .  .   .      .       ..    .   ..    ..    .   .  .   .. . .... ..  . .    ..       ..     .   . . .      ..  .  .   .  .        ..    ..
..  . . .          . ..         ...   .      ...  .    . ..  .       . .  ..  . .    .   ..   .   . ..   ..      .   . . .... .        . .     ..       . . ..     ..  . . .
.  .    . . ...  . . .      .    .    .       .  .   .. . ..   ... .. .  .    .  .  ..   .         . .   ..    .  .  ...  ....     ..  .  ..   .  . .     ...   ...  . .   .
.     .  . .        ...  .    . ... .   .     .  .          .   .  ... .     ..          . . .. .    ..    .. . .   . ..    . .    . . .   ... ..  .     .     .   .       .
. ..        . .    .        .  .    .    .      .. ...  .             ..   .. .  . .  .    .              ...     ...   .   .        . ..    . . .       .. .. ...     . . .
. .    .  .       .  . ...   .. .   .  .      .     ..    .     .      .  .     ...  .  ..   . .. ..   .     ....    . ..  . . . . ...      . . .    ..  . ..    .   .    ..
. .. ..    . . ... .   . .  .     ..  . ..   .    ..      ....  . . ..  . . .                ..  .  .    .   .         . . .         .     .  .       . ...   .     . .  ...
.   .        .   ..  ... .    . .     ... ... .  .    .  .       .   . ..   .    .. .. .  .   ..   .          . ..   .   ..      ....    . .    .   .      ...   .  .      .
. ..  .   . .       .     ...    ... .      .   .  .   .   ..     . ..  ..      .       .    ... ...    ...     .  . .  . .         ..           .  .    .  ..        .... .
. .  .. .         . .  .  ..  .        .    .    .    ... .. .                 .       .  ...                 . .      .         . .   .           .   .       . ..     .. .
.  ..    ..    .  . .        .     ...       .   .   .     .     .. ..  ... .. .   . .   .  .       .   .    . ...   .    . .  . .  ..   .               . .  . ...... .....
. .  ..        ..    .   .   .  . . .   .  . .   ..   .      .. .  . .     . ..       ..   .        ... ..          .   . ..  . . . . ..      .    . .         .  .     .  .
. .   . .     .    .. .    . ...  ..   ...  ..    .      . .     .    ..      .       . .  ..    .   .        .  .  .   .  . ..  ....    .     ..  .     . . .. . .  . . . .
.    .    .     .   .      ...    .   ..     ... .     ..             .     . . . .        .    . . .   ..     .   .   .     .  .    . .   .  .       .  .    .     .    ...
.        .               ..  . .....  .   .  .  . .. . ..     ..  .... .    . .  . .   . .    . .   .                   .    .. . .. .      . .     . . .       ..    ..   .
..  . .  ..  .      .           . ...     ..    .  .     .    .      .    .. ..       .     . .  .     .. . .                  . . .      .      ..   .    .. .. .    .    .
. ......             ..    .  .     ..  .    ..  .  .     .           ..      .   .      ..      .  ...  .     ..     ..   .. .. ..     .        .  .... .  .  . .  .  .. ..
.  . .   .     .       ..  .        .   ...    . ..        . .   .  . .     .     .   ..  . ..   .      ....   .  .  .  .   .  .   .        .. . ..       . .   .  .. .   ..
...   . . .  .  .         ..      .       .   ..  .  .       .  .  .. ..      . .     .  .   .   .. .   .. .  ...   ..   . .         .  .  .  .. . . .      .   .  .. .    .
..     .. .  .      . . .         .          . .     .    .  .  .... ..   .. ..      . . ...      .  .    . . . .....  .     . .  . .  .         . .   ..  ..          .. ..
. .  .   . . . .       .                 .     . ...   .   .          .. ...   ..    ..   ..         ..        .     .. . . . .   .. ..   .  .   . .        .  . .       . .
.      ..     .   . . .     . .  .    ...   ..  . . .  . . .         . . .     .   ..    ..    .  ..    .. .   ..   .  .  ..    .  .   . ..     . ... .    ... ..  ..   . ..
..       ..     .    . . .  ......  ..   . .   .          . .        . ...       .   . .  ..  ...       .  .  . ....       ...  ... ..   .    .  ..  . .    . .    ..  .   .
.   .   . .     ..    .  . .. .  ..  .     .    .   .   .      ..  .  .    .      . .     .   .      .  ..   . ..   ..     .      ..      .  .      ...         .    .     .
...       .   .     .      .  .  .  .    ...  ....   . ..    ..    ..    . .. ... .      . .       . .   .  . .  . .   . ....    ......   .     .. .     .       . ...  ....
.  . .  .. .  ..           . ....  .. .  .   .     .  . ..    .        .   .        ...  ..   .  .. . . .              .   .  . ..         .  . .   ...      .. .        ...
.   .   ..        .     ..   ..   .   ..  .. ...   ..  ..   ..   .        .      ..   . ..          .    . .      ..  ..  . .. . .   . .        ..      .     ..  . ..   . .
...   .     .        .     . .       .       ..  .  .  . ..       ..  ...  .     .  .      .         ..  . ..   .  . .. .... ..  .  ..    . .. ..  . .      .  ..    ..  . .
..   .       .     . .   .  .  . .    . .    . .  . ..   ...       ..       .  .           .  ...  ..    .    .  .    ..     .   . .   . .  ..    ...  . ...  .  .  .  .   .
.         . .  ..  .        .. . .  .  . .  . .      .  ..        ..         .    .       ....   .        . ....      . . . .   . .    .   . .       .       .          .  .
.     ...             ..              .     .      .  ..      . ...     . ...  .     .      .    .        ..  .       ..   .     .. .  .  ..        . ..          .... ... .
. .    .              ...      ..   . . . .       ..   .     .       .   .    .. .  .    ..      . .      ...  .  ....      .. .  .  .   ..     .     ... . . .   .   . .. .
.    . ... .   .     . .     ...   .    ..  ..  .  .. .   .. .    .    ... ..     .....       . ..      .. .        .   .....  . ..        . .               .           . .
. ...   .   .   .   .  .  . .  ..    .   ..      . .     .      ..    .. .         .    . . ..  ..   .  . .....  .       .   .  .       .  .    . ...    .  .   . .. .   . .
............................................................................................................................................................................
