.................
.      . .  ..  .
. .. .  .  .  . .
.     . . . .   .
.X..    .    .  .
.    ..   .     .
.    r .        .
.. .. .    ..   .
.      .    . . .
..    . ..   .. .
. ... .         .
.  .     ... .  .
.        .      .
.  .   . . .... .
. . .. . .      .
.....   .  .  ...
.................
