..................
..     .     . . .
. .      .     . .
.  . ..        ...
..   .       r. ..
.. .    .  . .   .
..  .  .  ... .  .
.   . .      .  ..
.     . . . . .  .
. ..        .    .
.       . .. .  ..
. .   . . .. .   .
..  .. . . .    ..
..   X. .       ..
. ..   ..        .
. . .  ..  .  ....
.   .          . .
..................
