...................
..     .    .     .
..    .    ..  .  .
..  .   ..  .     .
.  .X .   . ... . .
.   .  ... . r . ..
... .   . .   ..  .
..   .           ..
.   .   .    ...  .
..  ..    .  .   ..
..     ..   . .   .
. . .             .
. ... .   .      ..
..       .  ..    .
.    ..   .    .. .
. .    ..  ...  . .
.       ...   .   .
.   .  ... .      .
...................
