....................
....     . .   . . .
.    . . . .  ..   .
...      .       . .
.   ..  . .   . . ..
. . . . ..      . ..
.      .    . .  ...
.    ..X     . .   .
. .... . . .  . . ..
. ..      .   ..  ..
.  r    ..         .
. . .              .
.  .  ..  . .. .   .
.   ..     .    .  .
.     ...   .   .  .
.    ..  .   .     .
.      ....  . . . .
. . .  ..    . ..  .
.        .  . .    .
....................
