.....................
.   .        ..     .
.  .      .      . ..
.   .  .       . ....
.      .     .... ...
..   r           .  .
..  .     ..     .  .
. .  .  . ...   .. ..
.  .    ..    . .   .
..  .. ...     ..   .
.X    .. ... .  .  ..
.        .         ..
.  . .. ..  ..  . . .
.  .. .    . .    . .
. ...       .. . .. .
. ..        .   .   .
.     .  ..       . .
. ...  . . .. . .  ..
..   .            . .
. .. .           . ..
.....................
