......................
.  ...  .  ..   ...  .
.       . .  X .   . .
.  . . .   ...     ...
.  .           . ..  .
.           .  .     .
.   . .  .  ..    .  .
.    . ..  .      . ..
.    . .      ..  .  .
..  . ..      .  . ...
. . .     ... .     ..
.     ..   ..    . . .
. ..  .  ...  .   .  .
.  ..    ..  .. .    .
.     .... .  .  .  ..
. .  . . .  .     .  .
. r . . . ..  .      .
. . .                .
.              .    ..
..     .  . . .  . . .
. . ..      .. . .. ..
......................
