.......................
. .   .. ..   ...   . .
...   .  .  .    r .  .
. .  . .      .  .  ...
.  .. .     ..  .     .
.   . .. ..  ...   ....
.        .   . . . .  .
..   .             .  .
. . .  . .   .   . .. .
. .     . . . . .   . .
.      . .  .  ...  ...
.      ..     .     . .
.   .   .. . X  .  .  .
.      .    .  ..  .  .
.. .    . .. .   .   ..
. .   . .. ...  ..   ..
.     .      .        .
.  .       .     . . ..
.. .. .  . .         ..
.  .    ... .     .. ..
.     .           .   .
. ..     .         . ..
.......................
