........................
.      . .       .  .  .
..       ...      . .  .
.  .. . .       .. .   .
.     ..  .       . . ..
..  .          . .   ...
.     .X   . ..       ..
.     .  ..          ...
. r  .... .. .   . ... .
.   .   .    . .      ..
.      . .  .        ...
.   .  ..  .. . . . .  .
. .     .      .  .  ...
.       .     .     . ..
.   ...  ..   . .   .  .
. .   .. .  . . .  .   .
. .....   .  . ....  . .
. .   . .  ..  .       .
.    . .        .      .
. . .              .   .
.      .  .       .. . .
.  .   . ..     ..   . .
. ........ .. .  .  .. .
........................
