.........................
.    . ..  . . ..       .
.  .   .       . .      .
.  .. . .    .    .X.   .
.          .. . .  .    .
.     ..    . .. .  . . .
.   .   . .      .  .  ..
....   . . ..    .      .
.        .  .    .     ..
.. .        ..   ....   .
.      ...  . .         .
.  .  ...      .    ..  .
.   ..     .     ..   . .
. ...      .   .. .  r...
....               . . ..
.  .           . . ..  ..
.   .  .   . .    .    ..
.    .. .        .  .  ..
.       ..         .    .
.  . . ...  .. . .      .
. .  .....   .. ..  . . .
.         .   ..   ..   .
..  ..  .  ..   .. .... .
. .   ..  ..     ..    ..
.........................
