..........................
...  ..  .      .      . .
.   .  ... ..    .  .   ..
..    . .   .. .     .   .
.           .. .     .   .
.   . .   . ..  .     .  .
..  .  .    .      . ..  .
.  .. .   ..     ....    .
.    . .       ..        .
.       .    ....  ...   .
.    .             .    ..
.  . .   ... .  ..   .   .
.  . .X.  ....         ...
.  ...  .. .     ..    ...
. ... .     ..           .
.. .  .   .   .     .  . .
...  . .       .  .    . .
.  .          .    .. .  .
.    ... . r..  ..      ..
. .    ..   . .   ... .  .
. .      .     ...       .
.  .. .. . . .. . . . .  .
..  .    .         .   . .
.    . ..  . ..     .. . .
.       .   .      . ..  .
..........................
