...........................
. .. .  .    ...  .       .
.  ..    . ..     . .     .
.  .   .. .   ..  .       .
. .     .  .  . .  . .  . .
.    .   .         .      .
. . ..  .     . .   .    ..
...    ..  .      .. .   ..
..   . . .   ..  . . . .  .
.      ... ..   . .    .  .
.X     ... .            ...
.           .     .      ..
.   . . ... .   ... .     .
.       .  ...   . ..     .
.   . . ... .    .        .
..    ..          . .     .
. . .    .    .    .   . ..
..          ..       .   ..
.   .  .      .    . .. . .
. ...  ..    r  ....   . ..
.         .  .    ..      .
..    ..     ..    ..   ...
. .   .   . .  ..    .    .
. .. .     .     ..    .  .
.  .. .... .    .. . .. . .
.   . ....  .  .   ..    ..
...........................
