............................
.      .        .  .   ... .
. .  . . .    .  .        ..
.  .     .     ..    .    ..
.  . ..      .. .   .  .   .
.    ...   X..  ..         .
.. .    .   .         .   ..
..   . . . . .    . .    . .
. ... . ..  .     .        .
.  . . .     ..  r       . .
.  .   ..     .. .      . ..
. .    .   .  .   .        .
.  ....         .          .
.    ..   . . .     . . .  .
. .   .     .              .
.   .    .. .     .   .  . .
..        . .      .  .    .
..    ...     .  ....   .  .
.     .. . .. .  ...   ..  .
.. .  ..                .  .
.  .   .    ..  ....  .    .
...  .      . . .  .  . .  .
.. .  .  .   .  . ..   .   .
..  ....  ... . .   .. . . .
... .  .      ..       ... .
. . .  .      .. .       ...
.  . . .   .  ..  .. ..  ...
............................
