.............................
. .   r   ..    .  . .      .
....  . .     ..      ....  .
. . .   ..  .      .. X     .
. .    .                    .
..   .    . . .     .  .    .
.    .  .   .       .    .  .
... ... .    .  .   . .     .
. .. .... ...    . .    .   .
.      .... .       ..    . .
. .  ..     ... ..  .       .
.      .... .       .  .. . .
..    . .. . .  .    . . .. .
. ..  .      ...   .. ..  . .
. .  .  .     .     . ..    .
. ..   .      .   .   .. .  .
.. .  ..      .     .       .
..         .     ..   .     .
. . .  .   .  .    .   . ....
. .  ...     .           . ..
.               .... .   .  .
.       .  .    .   . ..   ..
.. .  ..  .. . . ..   .     .
..   . .  .      .    .    ..
....     . . .  .   .   ..  .
.     .. .   .  . .  .  .   .
.. .   ..    ..  .   .    . .
.   ...   .  .         .  . .
.............................
