..............................
.. .  .             .   .. . .
. .. ... . .   .       .  .. .
.. .. .  .   .. .   . .  .   .
.    .  . .r .  .  . .     . .
. ..        .     .   .      .
. .     . ..  ...... ..   .. .
.            . .    .   .  . .
..     ..             . ..  ..
. .  .  . .  . . .     .  .. .
.      . ...    .  .         .
. ..  . .    ..      ...  .. .
. .  . . .   ....      .  .  .
. . .  .  .       ..      . ..
. ..       .             ... .
..   .         .     .    .  .
.  .   .           .       . .
..     .       ..    ..    ...
.. .. ..  .    .  . . ..  . ..
.    .   .   .  . .  ...     .
. ...      .   .    ..      ..
. .. .. . .   . .    . .     .
.   .  .  X.  .      .   .  ..
. ..   .        .  .  .. . . .
..        ..  ...    .    .  .
. . .  .. ..  .        ...   .
.   ..         . .        . ..
.. . . . .  .  .       .  ....
.   ....        .    ....    .
..............................
