...............................
.  .  .       ..     .. ...  ..
.  .  . .          .  ..   .  .
. .  ..    ...  .   .      . ..
.... .. .     . . .  .    . . .
.  .   .     .     .     ...  .
.     .. .  . .  .   .   .   ..
.        .      .  .  . . . . .
.    .     ..    .. .  .      .
.       . .. ..  .  ...       .
.       .    .  .    .  .    X.
.         .  .     .   .  .   .
..      ..     .    .      .. .
. .  .. .    ..   .  .       r.
.     .  .  .  . .         .. .
.      .   ..  ..     . . .....
. .     . .  .          .   . .
.. .   ..     ..   .   ..     .
.       ..  ..       .    .   .
.. .      .. . ...         .  .
..       .   ...    .....     .
..     .. ... . .  .         ..
.  .  . .   .    .    ..    . .
..   ..  .  . .  ..   ..   .. .
.  ..   . .. . ..  ..      ....
.. . .   .  ..  .        . .  .
.    ..     .  .  ..   . .    .
.   .  .   ..  ..     .   .   .
.     ..  .. .  .   .  .. .  ..
..    . .. . ..      ..   ..  .
...............................
