................................
..  . . .   ..      .  ..   .  .
.  . .. . . . ..     .         .
..      .    .  . .  .  .      .
.    .r     . .    .           .
.      . ..    .  ..       .. ..
..       .      .   .  ..  .....
.   ..  . ..   .  . .    .. .  .
.. .  .       .   . . .    ..  .
.  . ..    .   . .    .  .  .. .
. . .  .   .  ..  ....   .  .. .
.  .  .   .  ..   .         .  .
.  .  .     .  . .     .       .
...   .    .  ....    ..    .  .
.. . .   .  .... .  . . ..     .
...  . . ..    .   . . . .    ..
. .   .      .  .  .         . .
...  .    .    .   . . ..      .
..      .      ..           .  .
.    .  .   .      . . .  .    .
. . .  ..  .      ..         . .
.  .   .    ..  .        ..   ..
. .      . .    . .    .       .
.  ..  .. ..       . ..  ... ...
. .  .           .   .   . ... .
...  .. .  .      .   .  . ..  .
.   .     .    .      .     .. .
. .   . ... .   .. X   ...  .  .
..      . .        .  ..     ...
.  .   . .    .   . .. ..      .
..  .   .   .  ...  .   . ...  .
................................
