.................................
..     .  ...  ..  . ..  .  ..  .
.  .           . .   . ..    .  .
.      . ..X.. .    . .        ..
.. .   . .     . ....  . .. ... .
.    . . .    ..      .     . . .
..  .. . .  ..       .     .   ..
.     .   . .. ....  . ...      .
.  .      .       . ..     .    .
.            . .     .  .     . .
.  . .    . ..  ......   .  ..  .
. .  . .  ..   . .. .        .. .
.     . .        .   ..     ..  .
..  .      .      .   ...  .    .
..   ..      .      . . ..   .  .
...    .          ..   ..  .   ..
.    ...... .  . .    ..    .. ..
..   .   . ..   ..   .  .    .  .
. .     .  .   . . .  ..   . .  .
.   . ..             .  . .    ..
...    .    ..   .. ..    .. .  .
. .    .     .    ..  . .     . .
.  .     . .     . ..   . .   . .
.. . ..    .   . .      .  .    .
.       ..    . .            .  .
.    .        .   .   ..     .  .
.                 . . ..   .   ..
..        ... . .  .. ..   .    .
. r  .    . .    .   .. .     ...
.    .. .   . .  .  .   . ..   ..
. ..        .. .   .    .. .   ..
. .  .          .  .  . .    .  .
.................................
