..................................
.      . .    .     .   . .  . . .
...  ..     .     .  .  ..  .    .
.. .  .   .    . .   ..       .. .
.    .  . ...  .  ... .     .  . .
.   ... .      .. ..   .         .
.     .   .        ...    .     ..
.     .   .      . .   .     .   .
.    . .          .   .. ...     .
.  .     .          .  .     . . .
.         .  ..  ..      .     . .
. .   ....  ..  .      ..   . .  .
.       .   ..        .   .    . .
....        . ..  .. .. ..     ...
..   ..     .              .     .
. . .   .     .    . .  ..   .  ..
..   .    . .  . .     .. .  . ...
.     .... ..  .   .  .  . ... . .
..   ..  .    .  .  . ..    ..   .
..   .     ..           .  . .. ..
.   ..   .    .  . .. .  .    .  .
.  .   . .    .. .  . ..      .  .
. . .        .r.   .  .  .  .  . .
. X..  .     . ...     . .. .  ...
.. . .. .    . .  .   .  .. . .  .
. .                      ...   . .
. .  . . . .   . .       .  .  ...
. ..        .    . ..     .     ..
.  ..   . .      . . .    .... . .
. ..    ..    .  ... . .    .  . .
.  ..  ...     ..       .      . .
.          .     .   . . .  . .. .
..    ....   .       .   ...     .
..................................
