...................................
.       .        .       .. . . . .
.  ...  .    .         . .   .    .
. . .  .      .    ..  ..  .  . ...
.     .. .  . . . .. ...     . .  .
...  . ..      .             ...  .
. .  .   . .          ..  . .   . .
.   .  . . . .  .   ..   .  .   . .
.        . .    .  .  .    ... .  .
. .    .  .       .       .       .
.  .    .     .. ..   .   .       .
.    .   . .  .  ...           .  .
.    . .   . .  .  .     . .    . .
. . ...   .. . ..         .   . . .
.  .    ..   ...   .    .    .    .
.  .. .      X   .  .  .   .   .  .
. . . . ..          . ..       . ..
. .  . . . .      .    .  .  . .  .
. .  .  . .  . ..     .  .. ..... .
...  .     ..        .  ....     ..
.. .   .   .     .  ..   .  . . ...
.. .     . .. .   .. .    . ..    .
...  ..      .  ... ....  .       .
. .         ...      ..     . ..  .
. .   . ... .    .    . .   ..   ..
.  ..     ..   ...  .             .
.    .. .  .            .    . ....
.      .    ..     r . .    .  . ..
.      ...   .   .  ..     .  .   .
.      .      . . . .  . .      . .
... ..  .  .      .        .   ....
. . .  . .            . .. ...   ..
...     . .... ..  . . .   .     ..
..  .   .   .  .      .          ..
...................................
