....................................
.. .  ....   .    ..  .      . .   .
.  .  .  . .                   .   .
.   .. .      .      .   .     ..  .
......     . .   . .. . .. .       .
.   . . .   .. .. .... .  . ..     .
. ..    .  . ..           .  . ..  .
.     .     . ..  .   ..   ... .. ..
.. .    . .      .  .  ..      .   .
. ... .        .   . .   .  .. . . .
.   .    .    .      ..       .    .
.  ..   .    .  .         . ..  .  .
.  . .   .   ..      .    ... .   ..
..  . ..    ..     . .. .     .   ..
.       .     . .     . .    ..   ..
.    .     .            . ..       .
. X.        .      . . .   .. .    .
... ...  .. . . ..  ..   r. . .    .
.     ...       . . ..    . . ..   .
.   .  .  .     ..   .    . .      .
.    ...  ..     ..    ...    .    .
. .         .     ...  .   .     . .
...      ..      .    .  ..    ..  .
..  .    ..  .   . . .  . .       ..
....       .. .  . ..  .   .   . ...
.  .   .   .    .    .   .      .. .
.      .. .. ..  .     ...  .      .
.. ..  .     . ..  . .     .. .  . .
. . .      . .    . ..   . .   . . .
.   .   ..  .   .   .  . ..   . .  .
..     .   .  ..        . .       ..
.  ..    ...  .     .   .     .    .
.   ..     .      .  . .    ..     .
... . . .  . . .  . .    ... .     .
.  .  .         .      . .  .      .
....................................
