.....................................
..  . .         .    .    .     .   .
.  .   .      . .   ...   .   .   . .
. .      .   .   . .        .  .... .
.... .   .  .   .. .   . .    .  .  .
. .   .      ........      .  .  .  .
. ..     .    . .     .    .   ...  .
. .   .   .. ..       . .   .       .
.   .    ..     .    ...   ..   .   .
.    .     .       ..      . .      .
...   .  r..    ...    .  .   ..  .X.
.... .        . . ..   ..        .  .
. ..    .. .   . .  .  .   . .  .....
.   . .  .     .  ....  ... .  .... .
.  .        ..        . .. ..  ..   .
.     . .  ..... . .     .   .   .  .
. .  . . .    . .   ...  .. .  .    .
.          ..  . .        .  .   . ..
.  .         . .  ..          .     .
. .     ..... .   .  ....   .      ..
. ...   .   .     .         ..   .  .
.   .. ..    ......      .      .   .
. .     .   ...  . . ..  ....  .    .
...  .   .       .. . .     .  .   ..
. . .   . . .   ...  .   ..   .     .
.. .  .       .      .  .. . . .  . .
. ..     . ..   .  . . .    . ..   ..
. . .   .  .   .   .   .       .  . .
. .     .... .  . . .  .  .   ..    .
.        ..        . .     .        .
.   ..              . . .  .        .
.       . .  ..           . .  .  . .
.     ..  .. . .  .  . .     .      .
.        .. ..    ...      .      ...
.    .   .    .     . ..          ...
..     . .     . . .    .    ..     .
.....................................
