......................................
.  . . .  . . .  .  .   .       . .. .
. .  .     .  .   .  . . . .    .. . .
. .         ..  .... . .. .   .   .  .
. .   ..  . . ..    .      .      .. .
.    . .      .        ... .    .   ..
..X .. ..      ..  ...           ..  .
.  .        ..... ...  .  .  . .    ..
.   .  . . ..   . . . ..          .. .
.        ...   .      .         . .. .
.. ..             .    . . .      .  .
. ..     .  ..           ...     . . .
. ...     .  . .  ..   .     . .    ..
. .  .  .. ...                   .   .
..    .  .  .       ...  .  .     .  .
. ..       ..       . .   . .  .    ..
.     ..  ...  . .   . .   .   ..   ..
.         .        ..   .     ...    .
.   .       ..    .  .   .   .  . .  .
.  . . . .  .  .   . . .  .  ... ... .
. .. . .       .    ...  ..   ..    ..
...        .. .    .  ..  .  .       .
....     ..     .   ..  .     .  .   .
. .   .    .      . .          ..    .
.      ..   . .. .  ...   . .  .     .
..      . ..   .   .   .   .    .    .
.      ..  ..   .    . .. .     ..  ..
.. ..   .      .           . . .     .
..   .          . .  ....    ..      .
.   .    ..     .   .  ..    .r. . . .
. .   .     . .    . ..   ...  .  . ..
.. ..  .             .      ..  .. . .
.  .   .     .      .   . .    . . . .
.   .      .  .   ..  .. .   .       .
.     . .  .  ..  ... .... .    . .  .
. ....  . .         ..           . . .
. .   . ..   .         .. ... .  .  ..
......................................
