.......................................
...  ..  . .   .     .        .  .   ..
.        . .. .     ..   ..  .. .     .
.  .   .   ... ...     .  . ....     ..
.  .   . ....    . ..          .     ..
..   .   .      .   . . .  ..    ...  .
.      .          .       ..    .     .
. . ....   .     .       ...  .   ..  .
.    .    .      .....    . .     ..  .
. ..           .        . . .    .   ..
..   .  r . .         ..    ...    . ..
.    .  ... ..    .   .      . ..   ...
..    .      .    .. .. .    .     .. .
..     . .  . ...    .   .  .       ...
..             . .   ..    .      .   .
.   . . .               . .     .. .. .
.           .     .    . .      .  . ..
....      . .    .        .      ......
. . .        .      ..                .
.  . .  .   . .      .   ...  . ..    .
...  ..... .   .  .            ..     .
.  .    .        .       . ...   .   ..
. .   .  . . ...   ..       ....  ... .
..    .  .     ..        .        .  ..
.  ...  .     X. ..          ..   ... .
.. .          ..              ....    .
.       .. ..    .. . . . .      .  ...
. .  ...  .    .     .  .  .... .  .  .
.     .  . . .  .. .    . ..  .... . ..
..   .  .  .   . ..... ..    .   . . ..
. .     . .  .  .    .       . .   .  .
..  .         .    .  ..        .     .
..  .     .     .. .     .. .       ...
.     .     .   .  . .   .       .    .
. . . . .  . .. . . .  ..  .. .. .   ..
.  .. .      .  . . .  ..  ...   . .  .
.      . .      .    . . . .. ...  .. .
.        ..    .  .  .   .    .....   .
.......................................
