........................................
.  ... .        .   ... .   . ..  .  ...
...  . . ..                 .  . .     .
.X.    .        .     . .    . .. ... ..
.   .  .   .                 .       ...
.  .      .  .     . .  .    . . .  .  .
..  ..  . ..   .       . . . . . .  .  .
.     . . .  .   .   . .  .     .  .. ..
. .. ..... .    .  .        ...  .     .
..  .    ..   . .      .      .    .   .
.   . .  . .....    .         .  .. .  .
.. . .   .     .   .    ..  .  .  .   ..
.    ..  .       .     .  .. ...       .
.. ...  .  .    .  ... .  . .       .  .
... .        . .     .    ...    ..   ..
...            .  . r .  .  .         ..
.  . .    . ... ........   . . .  ..  ..
... ..     .    .      .. .. .    ..   .
....     . ..          . .   . .       .
.. ..   .        .   ..  .. .   .      .
.          .   .  .     .. .    . ...  .
..         .. ..   ..  ..      .  .... .
.   ..    . ..  . .            . .   . .
.    .      .     . ...  ..    . . . . .
..  .   .  . ...   ..    ..     .....  .
..  .   .  .. .   .. .   .. .  .     ...
..    .  .   . .     .        .       ..
.   .   .. .   ...   .   .         ..  .
.  ..   . . . ..      ..  ..        .. .
.  .      .               . . .   .  . .
..   ..             . ....         .   .
.    .    .  .       .   .. .   .   . ..
.   .   .         ..  .. .   .  ..     .
......     ..    .  ..  ...   .  . . . .
..               ...   ....     .     ..
..         ..  .           ..  .       .
.         .    .    .   .    . .. ..   .
.    ..                .     . .      ..
.       . ..  ...  ..   . . . .    .  ..
........................................
