.........................................
. .   . .   .  . ....   .  .   .    .   .
. .   .     .   . .   .        . . .    .
. ..     . ..    .  ...     ..          .
...    .  ...   .  ..  .      . . .   ...
.    .   .   ..   . .   . .         .   .
.    ..   . .. ...       . .     ..  .  .
. .   .  .. .       .       .  .  ..  ...
.  .    . .  ...  .  .    .     .  .   ..
.    . .      . ...      . .  . . .     .
.   . .     . . . .  . ..... .....      .
.    . ..   ..  .     .  .   .         ..
.   . . .. ..   . ... ...       .  r  ...
.          .  .. .    . ..  .  .  .     .
.   ..    ..   . ....   .  ..    .      .
.    .    .  .    .     .    . .     .  .
.. . .   ..     .   . .          ..     .
..        ..... .  ..      .    ..   .  .
.....  .. . .      .      . .  ..  ...  .
. .   .  ..     . .       .  . ......   .
. .      ..    . .   .     .     .     ..
. . ..    . .   .           ..       ....
. .  .  .  .        . .    . .  .      ..
.     . .    . .   . .       .  .     . .
.  .. .   ..          .   ..         .. .
.  .  .    .  ......         .        ...
... ... .  . . .    .   ...  .          .
.    . .   . .    .   .  ...    ..    .X.
.   .    . . ..        .           .   ..
..     .  .  .        .     . .. . . .. .
.    ..       ..    ... .            .  .
. .....      .. .. .. . ..     . .   . ..
.. . .  . .       .      .   .   .     ..
... .     .     .. .  .  .    .     .   .
..    ..  .   .. . ..    ..            ..
.   .... . .            ...    .    . . .
..     .   ..  .        ..  ...         .
. ...    .  .  ...   . .    .      .    .
. .  .        ..  .        .    . . ..  .
...        . ..        ..        . ... ..
.........................................
