..........................................
... . .       .     .  .  . .          . .
.   .    .   .   .    .. ..   .  .    .. .
.  .  .    .    . . .   . . .    . .  .. .
. . .  .     ..  .   .    . . . .  .   . .
..    .      ...   ..    ..   . .    ... .
..    .  ..  .        ..  . . . . ..  .. .
.  .   .. .     ...     ..  .     .   .  .
.  . .      ..   .   ..  .   .  .        .
.        . .    . .  ..           .   . ..
. .    .            .      ..        .   .
.    .  ..   .. .    .     .. .    .  . ..
..   .   .      ... ..   .  .    .    .. .
.     ...       .      .  . ..  .       ..
.    ...     .  .  .     ..   ...   ......
..  ... .    . .. .      ..          ... .
. .  .            . .    ..   .          .
..      .    ....  .  ..   ..      .    ..
.  .  .. ...      ...  ...  .r  .        .
.  .. .      .     ..    .   . ...  .    .
.        .      . . ..  .   .  .   ..   ..
.        . ..  .       .  .    . .     . .
...        . .    .        .. .  .. . ....
.... .   .  .      . .  . . .  .        ..
.  ..      .. . ..   .         .     .   .
.   .  ..  .       ..   .. . .   .      ..
..  .    . .    .   .  ...   .  .   .    .
. .     .      ..          ....    .. . ..
.          .. ..  . ...     .     .   . ..
.  .  .      .  . .    .        .        .
.  .  ..  . .. ..      ..   .    ..   .. .
.       . ..      .    . .. ..   .      ..
.        . . ...    . .  .   ..      .   .
.... .   ....  ...   ..        . .. . .  .
. ...         . .....  .. .  . . ..     ..
.   X.          .. .   . .      .  .   ...
..  .  .  .    .  .     .  . . .. .   .  .
.   .     .. .  ..       . ...       . . .
. .   . .      .      .. .     .  .   .. .
.               . .  .  . ..  ...  . . . .
.     .   . .   .     . ..     .. . . .  .
..........................................
