...........................................
. .. ..  . .      .    .   . . .  . .  ....
.  .  .  .           ..     .. .    ...  ..
.. .  .  ....     . .    . .   . .     .  .
.  ..       .        .  . .    ..  .    . .
.   . . . . .  .   ..  .  .    . .   ...  .
..  .     .   .      .   .  ...     ..  . .
.. .  .. . .     .. .        ..     .     .
...    ..  .    .   . .     ..   ... ..  ..
. ...      .       . .  .      . .  .. .  .
. .   . ..   .     .  .. .     ..r    .  ..
.      .... . .   .    ..  .   . .  ..   ..
..    . .           ..  .  . .       . .  .
.    .      ..    ..  .     .      .      .
... . . ..       ....  . ....  ..   . .   .
.      ...   .   .       .   .   . .  .   .
...  .           . ..     .  . .     ... ..
.      .  .. .     .X      .       .      .
..   .   .   ...      .   .  .  ..      . .
.         ..       .  .  .   .        .   .
.    . ..           ..   .   ..    .   ....
..  . .. ..   .     . .     .  .  ..   .  .
..         .  .  .     .  . .   ..        .
..    .    .   .. .. .    .   .           .
..    .  .    .    .  ...    . ..     . ...
. .      ... ..      .    . . ..      .   .
.      ..         . .  .....   ..  .    . .
.  .. .    .. .     . ... . .    ..      ..
. .          .    .     .             . ...
.   ...           .  .    .           .  ..
...     ...      .  .    .  .      ..  .. .
..   ..  ..     ..   .     .  . . .       .
.  . .   .  . . .       .  .   .        . .
..     . .  .   . .  . .   .     .  .  .  .
. . ..     .  .   . .. .. .    .. .   ..  .
. . ..  ..  ....     ..   ..   .  . .     .
.  .  .     .   .   .  .    ..      .  .. .
.     .    .   . ..   .   . . . .  . .   ..
. . ..   ....    . .              . .    ..
..       . . ..    .  . .      .  .       .
..     .  ... . .       .  .. . .    .  . .
.  . .    ..  ... ..   .   . ..   ..     ..
...........................................
