............................................
.  . .   .       . .. .  .      .      .   .
. . .    .  .. ..  . . .         .....   ...
.  ..   .   ..    .  .    .    .    ..     .
.   .  .....  .. .     .      .  .    .  . .
.     . .  .    ..  .   .     .           ..
.. .  .    .. .    .   . .     ..        . .
. . .. ..       .    . ..   . .  .    .    .
.  ....  .     .  .  . .      . .  .      ..
.    . .  ..  .      ..         .  . .. .  .
. .    .     .. .         .... . . .. ..  ..
.   .    . .    ...   ..   ..  .. ...  .   .
.  ..  .     ... .        ..   .  . . .   ..
. . . .   ...   .  . .      . . ... .   ....
. ..  . .      .    .   .       .... .  .  .
.     .    . .    .. .  .  .  .    . ..    .
..      .  .   .. .  . . . .   .     .     .
.  . .  .     ..  . ..X. .     . .       . .
.    .    .  .   . .   . .   ..     .   .  .
.. .. ...  .  .    .       .  ..        .  .
.. ..       .   .  .   r            .   .. .
.        ...     .  . .. . ... . .        ..
.    . .     .         .        . ... .    .
..    . ... .   .    . .  ...   .   . .. . .
.  .  ..   .  . . .   . .    ..  ..  . ..  .
.    ..      .  .   .   .   ...     .      .
.      .     .       .... .  ....     . . ..
..   .  ..        .  ..  .    ..  .        .
.   .   .           . . .    .. .. ..  ..  .
. .   .   . . .   .       .    ...     ..  .
..  .       .      . .     .    ... ..   . .
.  .  . .      ..    .  .      .           .
.  .      .  .     .  ..       . . ....    .
...   .  .   ..           .          . .   .
..   .        . .. . . ... . .  .  .   .  ..
..     .    .  ..      ...   .. ..   ...   .
. ... ... .   .           .   ..   ...   . .
.       .   . .    .     . .     .  ..  .  .
. . ... .  .  .      .  .            .     .
.           .       .   ......      ..     .
...   .    .       .    .  ..   .    .  .  .
. . . .  .  . .    ..   ..    ..  .   ..   .
.    . ...        . . . . .. .      .      .
............................................
