.............................................
. .   . ......  .  .   ..       .. .  .   ...
. ..        ... ...     . ...   .     .   . .
.. ..    .    ..    .      .  ..      . .. ..
. . .   . ..       .   .    .      .  .  .  .
. . ..     . ..  .  ..     .   . .       .  .
. .    .    . .  .    .      ....      .  . .
..   . .  ..    .     .. .   .         .. . .
. . .   .    .   ..      .     . .. ..   .  .
.   ..  . ...  .  .    ..      .     ....   .
. .  .  ... .            .    ..   ...   . ..
.. . ..  .   .   ...     . ..   ..      .  ..
.    ..   ..   .    ..  .  ..  .  ..     . ..
.  .. .   . .   ...  . .  . . ...   .   ..  .
. .     . .            .   . .  ..  .    .  .
.. . .  .        ..    .. ..             .  .
.     .  ..            .   ..         . ..  .
.   .        .   ... .   . . .      .     . .
..           .        .       .      .  . . .
..    .    ...    . .   . .   . .  .. . . . .
. ....  .     .. .  .  .  ..     .... .     .
.    .  .  .. .. . X ...                  ...
.      .   .   .        .       .. .  . .   .
.    .  .  .  .   ....  ... .             . .
... .        .   .   .  . . ..  ..       .r .
.  .    . .  . .   .  .          .   .  .   .
. ..       . ..   ..   .   .   .    .    . ..
..   .  . . .              .        .     . .
..      .   .   .    . . ..  .       . .  . .
.    .  . ..  . .     .     .    .    ..   ..
. .  .    . ..    ...       ... ..  .  . .  .
..   .     ..  ..            .. .   .     . .
.      .. . . .        ..        .    .  .  .
..  .         .. .  ... .     . .     . . ...
.   . .   .         .    .     . .  .    .. .
..  .  .... . .   . . . . .    ..      ...  .
..    ...   .    ..   . .        ..   .     .
. . .   . .. ..  ....  .     .     .  .     .
.       .    .   .  .   ..       .  .   .  ..
.    .         .  ...    .  . . .  .    .. ..
.  ..   . . . . ..   .    .  .         .    .
.. .  .      ..   .    ..    .       ..     .
. .   . ....      ...   ..    .   .     .  ..
.  .  .   .. . ..          . .   .. ..  . . .
.............................................
