..............................................
.  ..  .. .. .     .   . . . .  .  . .   .  ..
.           . . .   .  .     .  ....  .  .   .
.. .      ...       ...  . . ..   . .. .     .
. ..  ..    .    .  ....  .      . .      .  .
.. . .  ..    .      .  .  .      .    . .   .
..    .      .   .     .. .  .   .. .. . . . .
..      ....  .   . . .  .  .  ..        ... .
.           ..   ..      .  .  .  .   .. . . .
. .. .   ..        . .. . . .. .       . .   .
.. ..  .        .   ... ...  . .        ..   .
.  .     . .    .  .            . .    .  . ..
...    .  .....    .   X      . . .. .  .   ..
.   .     .  .. . .      .   ..      .. ..   .
..     ..   .   .    .               . .   . .
..    . . ..  .                           ....
..  .   .  .         . .     .        .  ..  .
.  ..   . .      . .  .  ..  .  .. .     .   .
.. .   .. . .....   ..   ...          ..    ..
. . .    .         ...         .      .  .  ..
. . .   . . .     .   ..  . .        .       .
.    . .  .  .    .   .        . .  .     ....
.    . .  . ..   ..    ....  ..  ....  ....  .
.    .  .     .            .     .  .  .  .  .
.     . ... . .  . . ..   .         . .  .   .
.       .  .        .   ..       ..          .
..    . ...   .   .           ...        .....
.. .    ...    . . .  ..  .  ......   .      .
. .     ..     .    .   ..      .   .. .  . ..
. .     .       . ..  .        ...  . .. .   .
.    .        .  ..  .          .  ..    .  ..
...    .. . .. . . . . .     r      ..  ..  ..
. ..   .. ..  ..       .  .      .     .     .
..   . .    .     .             ...  ..    . .
. ....  .....   . .....  .               .   .
.   .      .    .  ..  . ..          .       .
.          . . .  ..       . . .   .  .....  .
.  .. ..     .   .    .      .     ..       ..
. .      . . .. . ..   .  .    . .    .      .
.     . .    . . . ..   .. .  .     ... . ....
.  .    .   .        .   . .      .          .
.    ..       . .  . .. . .     ... .    .   .
. ... . .  .. .  ..          .  . ..  . .    .
..    . .     ...  . . ..    . ..  ... .     .
.  ..    .     ..    .. .  ..                .
..............................................
