...............................................
.    .     ...      .  .. . .   . . .       . .
.. .  ..... ..     .. .   ...   .  .          .
.   . .  ..   .     .                        ..
...   . .      .  .   .     .  . .  .   .   . .
. .   ..  .  ..  .    .. . . .  .  .. .     ...
.  .       ... .  .    . . ...  . .  .        .
..... ..   .    .     . .    .. .    ... ..   .
.. .   .. .      .....    .  . .  ..     ..   .
.   .. .           ..               ..   .    .
. . . . .     .      ... ..  .    ....  . . ...
.      .  .  .     .    .  .    . . .     . . .
.   .        . .            .   . .  . . .   ..
.      .  ..    .      .     . ..     .    .. .
..     .      . .            .   ..  . .    . .
.     ...    .     .        .    .   .....   ..
.    .   . .    .     . . . ...  ... . .   . ..
...  .     .   ..      . .      .      . .    .
.. . .       .                . ..   .  .     .
.    .  .    ..       . ...  .. ... . . .   . .
.           .  .    .   . ..  .  ..     .   . .
.  .. .                  .. .   ..   .....  . .
.     ..    ... .. . .  .   .     . .. ...... .
..  .... .  .     .    . .     ..  .  .       .
.      . .. . .        . .      . X..   . .. ..
..     r .  .     ..               .         ..
.  .      .  .          . ..  ... ..     .. ...
....               . .. . ..... .         .   .
. .     .  .            . ..  .     . .  . . ..
.  ..    .  .   .  .  .   .   . ..  ..  .  . ..
...  . . .  .  ..  . . .   .  .  ..  .  . .  ..
....   .    .  .. .    .     ..       . .  ....
..         .  . .    .   .   .  .        .    .
.        .            . ..  .  .  . . .    . ..
.          .   ... ..  ..      ..   .     ..  .
.        .   . ..  . ..  . .      .        . ..
.  . .   ....  .  ...   .    .     .    ..    .
....   . .  .        .      .      .  ...   ...
. .  .  .  .   . .  . ..    . ..     .     .  .
. ..  ..  .   ....       .     .     .      . .
.   . .    . .   .  .. .    ..  ... .   . .   .
. .  ..       .    . .   .      . .      .. . .
.      .  .... .     .  . ..   . ..     .. . ..
.  . . .       .   .      .  .  .  .  ..     ..
.  ..    . .    ..   .      .  .          .   .
..     ..  .   ..    . ...  .   ..       .    .
...............................................
