................................................
. .  .   ...   . ...  .. ... .    .  .  .   .  .
.  . .    ..  .. ... . .   .  .    . .  . .    .
.  ..      .       . .            .  .     .   .
. .  .     .    .     .  .. .. ..  .           .
.      ..  . ... . ..  ......      .     ..... .
.    ...        ..  . . . ... .  ..    .  .   ..
.  . ..     .               ..     .      .    .
..   . ..      .            .    .    . .  .. ..
.    ..     .   .   ..     ..    .    .  . .  ..
.       r.      . .   .  . .. .      .  .   .  .
. ..   .        .          . .      .    .  ....
. .             ..  .     .  ..    ..    ..   ..
.  . . .. .     .           ..     . .. . . .  .
. .    ..   . . .    .  .  . ..  .  .   .      .
.         ..      .  ..  . ..      .      .   ..
.....          .  .    .   .   . .   . .     . .
.. .. .  .   .   . ..  .    .            .  .. .
.    .  . ..      .       ..        . .     . ..
..     .    . .  ...     .     .            .  .
..     .      . .   .     . . . . . ..   ..   ..
.  .      ...   ...  .. .         ..      .   ..
.   .   .   .  . . .... ...    ....    .  .    .
..    .    .  .. .          .  ..   .... .  ....
.   ..  .  . . .  .    .. .   . .  . .  .  .   .
. .  .....         .        .     .  . .       .
. .          .       .    .         ..      .. .
.. .   .    .   . ..           . .      .   .  .
.  .   . .  .   ...  .       .. .     ..   ... .
.  .  .  . .      ..  .     .. ..    .  .      .
..        .   ..   ....     .   ...  .     ..  .
. . ... .  .. . .    ...       ...        ..   .
. ..  .    ...     . .      ..    .  . . .  .. .
..     ..      .      . ...      ...  . .   .  .
...          .   ..        .   .   ..   ... .  .
.    .    . . ..   .    .   ..            .    .
..    .    . . .    . ..  ..    .. .  .. .  .. .
. .. ... .     ..    .  ..      .    . . .. . ..
. .    ..     .   .    . ..            .   .  ..
..  .   .    ... . .  .  . ...      .  X      ..
.  .  .     .  ..  .    .. .  .      .       ...
. ..         . .  .   . . .... . ..      ..  . .
. . .   .  .   . . .      . .          .. .    .
.    . .   .  .    .     ..   ....    .       ..
.   .  .   ...  .. .    .          . .    .   ..
..  . . . ...    .   ..  ...   .   .        .  .
..  .    .   .   .  ...        ... .   .   .   .
................................................
