.................................................
..    .... .  ..  . .    ...... . ... .    ...  .
.... .   . .    .   ... .   ..     .        .   .
.   .  .        .      .   .   .   . ....    . ..
. .       .. .     . .  .... .     .      .     .
. ... .      .   ....  .. .  ... .  . ... .     .
.. .   ..   .   .  .   . ...    .      .. .   . .
. . .        .            .    ..          ...  .
.    ..        . ...       ..   .   ....     .  .
. .    .    .. .          .          .. . ..   ..
.  . . . ..       .  .  . .  .   ...    .     ...
..     .  . ...    .   ..   .   .    .....    . .
.      .  ..  .     .   .     .       .. .      .
.   .  . .    .. .         . . . ...        .   .
..... .       .. ...          . . . . .... .  . .
.    .  ..    .  .      ...      . ...    .......
.  .   .  ..             .     . ..  .       . ..
.    .    .         ..   . .  . ..  .. .   .    .
.         ..  ..    .  .   ..  .    ..          .
..  ..     ..        .  .  .   .. ..       .    .
.  .   .   ..       .  .  .  ..      .   .      .
.  . .      ..              .  .      . .. ..   .
.   ...       r..        .        . .     .    ..
..   .   .  .. ..   .. .     .  . .  .   ..  .  .
. .. .  .       .       . ..        . .....     .
. .        .. .       .  .        .. .       .  .
. ..       .  ...  ..  ..      ..    . ..    .. .
..            ...   .  ..     ..   .    ..    . .
.  ..   . .      .  .     . ...     .   . ..   ..
.     ...  .    .     . . .   .  . .  .     ..  .
. ...   . .       ...    .  .      ...   .    . .
. . .               . .    .    .    ..         .
.     ..   . ..   . .   .  .   ..    . . .  .  ..
. ..   .....    .   .  .     . . . .   .     ....
.... ..     .. ..       ..  X...  .    .    .   .
...  .  . . .     . .  . .   .  . . .  . . ..  ..
.         .     .    . .   .    ..    .     ..  .
.           .  .      .   .    .  .          . ..
.    .. .    .    .      ..       ..         ....
.   .     .     ...     .  .      ...  .   .  . .
. ... ... .  . . .           .          ..      .
.     .     ..  ..           . ...   ..         .
. .. .        ..    . .. .     . .    .    ..   .
... .....    .  .  ..      ...        .  . . .. .
. .  .. . ..  .          . .. ...    .          .
.    ..   .  .     ... ..  . ...         .    . .
. .. ..  .      . .   . .    . .. ..   .    . . .
.      ..  . .    .    .. . ..        . .       .
.................................................
