..................................................
. .     ..            .      . . ....   .  ..    .
.  ..  . .. .     .  . .    . .  . . . . .      ..
.         .  .   .      . .             .  .    ..
. . .. . .    .       .    .... . . ..    .. . ...
. . . ..  .                   ..      .     ... ..
. .. ...    ...       . ..  ..  . ..  ..     ..  .
.   ..  . .    .  .   ..     .   .   .   ..  . . .
...    ..  ....      . .   .   .                 .
.    .             .  ... .   . . .. .        ....
.  .   .      .    . ..    . ..  . ..     ..    ..
. . .  .   .   .  .      ..    . .  .  .  .  .. ..
.  . . . . .. ..     .         . .    .     . .  .
.  .   .    ...   .   .  ...  ..  .  ..  .   ..  .
.. .  .    ..    . .. .  .  ..         ..       ..
.       .          ...  . .  .  .... ..  . . .  ..
. ..              ..  .  ..    .      .    .   . .
. . . .      .  ..    .             r ..       . .
.  ..    ..   .    . .  .. ...   ..   ...    .   .
...      ..     .   .    .       .  ..    ..     .
. .      .    ..  . .X..   . .     .     . . ..  .
.   .. .         . . .      .    .. .       ..  ..
.      .   .   ..  .   ..  . .       .   ...  .. .
. ...     . .  .. ...  .     .     .         .  ..
....  .    .  .    ..  .  ..        .. .    ..   .
.             .... . .  .   .  .    .  ....      .
.    ..   . .           .      . . .  .        . .
. ... ..  .             ..   .   .      .     . ..
...  .  . .        . . . ..  . .   ..   .. . . ...
.      ...    .  .  .. .    ... . .. . .  .      .
..  .      ..  .. . . .   ..   .    .         .  .
. .        .     .  .  . .      .. . .  .  .     .
.  ... .  ..  .    . ..       ..   .  .      ..  .
..  . .    .   .        ... .      .   .     ... .
.    ...  ..  .           .. . .   ..  .. .    . .
.   . ..  .        .        . ...        .    .  .
. . .     ..   ..       .  . ..  ..     . .  .   .
.  ...               .     ..      .. .   .   .. .
. .. .       .   . . .   .    .     .   .   .    .
.    .   . . .        ..      . . . .  . ..  . ...
. ..  . .  .  ....   . .  .    .         .    .  .
..      . ...  .    .               . .  .  . .  .
. .    .      ...   .  .   ..     .  .   .       .
.      .     . .   ..   .      ..    .       . . .
..  ..  ...   .  ..             ....     .       .
..    . .   .  .. . ..    .   .     ..    .  .  ..
..     . .  .. .     ..     .   .   .. ...     . .
.... .   .     . .  ....   .      . .      ..    .
.   . .    .   ...    ..      . .    ..    . .   .
..................................................
