...................................................
.   . .   .      ..        . .    ....  .    ...  .
..     .            . .     .. ......   .  .      .
..            ...   .  . ...     . .   .      .....
.     .    . . . .  . . .     . .     .    ..     .
.  .         ....      .    .    .    .  .  .  .  .
.      . .      .    .    .. . .     . ..    . .  .
. .   .  .   .   ...  . ..  .  .  .    . .... . ...
....  ..   .  .   .  .     .    ..    .... ... . ..
..  .    . . .        .  . .  .  .   ...    .     .
.     .    ..  .. .   .    .  . ...    .  .       .
...     . ..   .             .     .              .
.   . .       .  ..   .      . ..   .    .       ..
..  .  .  . .. ...   . .  .  .    .    .  . .  .  .
. . .    .  .    . . .  .          .  .  ....     .
. . . ..... .     ... .    .   .  .  .  .     ... .
.     .      .             .. .   ..    .    .   ..
.  .      ..   .      ...     .  .  ..      ..    .
....   .X....   .    .     ....     ... . ..   .  .
... .. .  ..        . .      ..   ..      .      ..
..    .   ...     . ...          . .   .  .    .  .
.        .       . ..  .           .     .. .... ..
.   .  .  . . ..   ..          .   .. .    .  .   .
. . .   .. .. ..     . ..  .   .  . .     .   . . .
.     ..  .    ....   .        .     .   . ..    ..
. ... .    . . . ..  .  .      .  .  .   ..   .   .
.     . . . . .. ... . ...          .      .  . ...
.    . .      .    .     . .  .    . .       . . ..
.    .   .    .   .. .. .  ..      .    . .    .  .
..  . .    ....         .. ..  ....         .     .
. .     . .           .     .  .     .   . ..     .
..  .     .... .    .      . . ...    .  ..    . ..
.  .  .. ...    .  . . . . .   .   .    .. .      .
.   .   ..  ..          .   . ...   .   .    .    .
.        . ... .    .  . .       .   ..      .. . .
.    .   .        .   .  . .    .    .  . .       .
.   .   .       .. .   . ..          ..  .   .   ..
.    ..   ..      ...     . . .        .    . .....
.   .   .           . ...     .. ....        . .  .
. .   ... . ...       ..     .....          .  .  .
. . .  .  .      ..    .. ..   .    .  .    .   . .
...   .    .   . ..        .    ...  .          . .
. ..           ... .  . ..  . . .       ..      . .
.   .  ..    .     .. .      .    .  . .  . . .. ..
.      ..   . r      . .    .   . . . ..  .     ...
.   .  .   .  . . .    . .  .    .     .        . .
..  . ..   .  .     ...       ..   . . ..       . .
.         . . .. .     .   ....         .  .. .   .
. .     .   . . . . . . ..  .  .  .    .. ..   .  .
. .      .       . .   . .     .   .     . . .    .
...................................................
