....................................................
.    .    ..   .      .      ....    .....    . ....
.         .  .. .  .     . .   .  .. ..     ..  .  .
.       . . ..    .  .. . . . .        .  .  ..    .
.   .  ..     .   .        ....    .        .  . ...
.      ..    ... ...  . ..  .. .   ..  . .... .   ..
.  ..    ..  .   .  .      ...   .    . . . .. .   .
.   .   . . .   ..    . .. .... .      ..    .   ...
.      .. .   .   .   . .   .      .  . .. ..   .  .
.      ... .  .      ..  .     . . ..              .
.  . ...   ..     ..  .     .  ...     ..        ...
...   ...   .  .     ..     .    .      ..   .. .  .
.   .   .    ..  ..   .  ... . .    .  .   .   .   .
.  .  .     ..   . . ..     .  .  .  .  .. .       .
. ..... .   .    ...     . .  . .         .  .. .  .
..    . .  .  .               ..          .. .    ..
.   ..     . . ..   .  ..  .  .  .         ..  .   .
. .      . ..    ... .  .   .   .   . .     ...  ...
.         .        .   ... . .   .   .    .      ...
. . . .    . .  ..  .       .       .      ..   . ..
.     . ..  .   .   .                 . .          .
...       .. .  .  ...          .      .   .  .  ...
. ...  .  .  . .     .    .  .       . .     ...   .
. . .  .    . ..  .     . . . . . . .   .  . . .  ..
.   . .     .       .            ... .  .     .. . .
. .  .. .    .          .. .    .       ... . .  . .
..  . ..... . .     ..        ..   .   ..  . ..  ...
. .    . .     .               .... .         ..  ..
.  . .. . . .     ..   ..     .  ..... ..   .   . ..
.      . .    ..             .  .  . ....   ..     .
.     ..   ..       . .     ..   ..  ..  ...       .
.      ..      . .   .           .  .. ....    .  ..
.    . .      . .  .. .   .     .  .     ..... .   .
..       . .    ... .  .   ..      . . .     ..    .
.  .     .. ..     .     .    ...  .. ..     ...   .
.             .   .  .  . .  .. .     . ....  ......
.  . . .      . . .  .. .    .    ..  .  .    .. . .
. .      .    . .   .              .  .    .  .  . .
.          . .  . .         .   ..    .  .         .
..         ....  .   .  . .   ...    .  ..   .. . ..
.       .   .    .      . .     .  . ..   .    .   .
. . ...  .  .  .     .       .     .. ..    .      .
. ..     .   .   ...    .  .  . . ..      .  .     .
.. . ..  .. .    .   .         .. ..     . . ..   ..
.  .         . ..        .     . ..              . .
....  .   . ...         ..  .   .. ..      ..   .  .
.          .     .    .   .         ..  .   .    . .
.         . .    .   . . . .  .     X     .     .  .
.  . . ..       ..        .. .  ..  .        . ... .
.   .         .     ..  .   r ..    .  ....   .  . .
....  .         ..   .       ..      .  . . .  .  ..
....................................................
