.....................................................
.   .  ....     .   .   .        .   ...  ..    .   .
.      .  ...    .. .. .     .        .  .  .       .
.. . . .  ..    .  .   .      .    .. .     . . ... .
...    .    .       .. .  ...     . ..    .       . .
. . ..       .                .   .  .    .   .   . .
.. .      .. .  .   .   .  . .  ..            .  .  .
..         .     . ....  . . .       .    ..      . .
.  . . ...    . . . .      ..   . .    .  . .      ..
.     .. ...   .     .. .    .         .   . .    . .
.      .   .   .   .  ..      ..    . ... ....   .  .
..  ..  .      . ..         .  .. . .     .... .    .
.  .     ...   .. . . . ..  . ...  .   . . .     .  .
. .  .      . .  . ..  ...  ..  .  .    .. .        .
.        ..       . ..   .      .       .     .     .
. . .         .   . ... ..      .   .  .. .        ..
.  .   ...     .. .. .  . .   .  .   .       .  .   .
. . . ...        .  .         . .   .  .  .  .   .  .
.   .  .  .    . .   .               . .  .     .. ..
. .     . .    .  . ..     .  ...  . .. ..          .
.    .  .        .  . . ..    .      .      .    . ..
... .   .       .   . .. .   .   .   . ..         . .
.   .  ..       .. .     .  .    . .  .  .    .     .
.   .  .... .     .  ..  .  . ...               .. ..
. .     . .  ..   .     . .. ..        ..    .     ..
... ..   .    .. ....   .    .. .      ..  .  .. .. .
. .  . .. . .     .  ... . .   . .   .    .         .
. .     .   . . . .     .   ..    .      ..       . .
.    .    .  .  ..               .   .   . ..  . .  .
. .  . ..        ..   .  . ..  . .  . ..   .        .
...     .        ...      . ...      .       ..  .  .
. .  . . .         ..  ..       ...  .   .       .  .
. .      . . .. .  . .        . . .     . .. .   . ..
.    . . ..      ..   .           .  .   .. .   ..  .
. ..   .        .  .    ...   .   .. .     .   .   ..
.   .   .   . ....    .  .   .   .. .      .    . . .
.  .       .            . . . . .  ... .  .    ..   .
. .  .    ..  .             .      .. .             .
.    . . .          . .  ..  .   . . .  . . .    .  .
. .   .   .    .  . ...         ..        .   ..    .
. . ..  .  .    .   . .     .r  .  ..   ..     .    .
. ..  .. .   .    .    ..    ... ..   .  .  . .    ..
.      .       ..    . . .. .     .  . .  . ..   . ..
.  .. .     . .. .  . . ...   .     .   . .   .. . ..
.  . ..      .   .   .       . . .  .. .     . .    .
. . . .   .   ...  . .   .  .. . .      . .. .  . . .
.      . .      .      .       .  ..  . . ....      .
. . .   . ..  .   ..     . .   . . .       .    .   .
. . ..   ..X .   .....     .   ..   . . ..   .... . .
. .     .  .    .     . .     . . .   .       .   ...
.   . . . .. .  ..       ..   .. . ...  ..    .. .  .
.  .     . . .      ..  . .    .  .. ...      .  .  .
.....................................................
