......................................................
. .   .      .     .   .       ...        .          .
.  ..    .        .    . .  .    . . ..    . .  . . ..
. .     .    . .      .    ..     .. .    . . .      .
. .   ..       .   ...  .  .... .   ...  .  . .   .. .
.   ....       ..       .  ..   . .. .      ..  .    .
.    ..          .  ...     .  .      .            . .
.    .  ....  .    .                  .. .          ..
. .    .       ..  . .         ..   . .      ..  . . .
..    .           . ....  ...   ..      .  .  .  .   .
.  . .  .     .   .     .. .        .   .      ..    .
.   ...  .    . .. .   ..    . .       ...    ....  ..
. ... .            .. .    ...    ...  .   ..  .  .  .
....    .      ..      .  ...    .  .  .   ..   .    .
...  .    ..    .  ..  .   .  ..         .  . .. ..  .
.       .  .  .  . .      ...  . . .    ..         . .
..  . ..    ..         ..  . .     .  .....    ...   .
.  . ...     ... . .  ..                  .    . .   .
..  . ...  ..       . .         . .      . . ..   .  .
.      .. . .   ..   .  .    . .   . .    .. .       .
...        ..  . . . .  .....  .       . ....     .. .
. .    . ... . .       .. ..  . .        .  .   ..   .
.        ... ..         .   ...  .            ..     .
... .   ..  .     ...... .   .  ..  .. .     ..      .
... ..  .. . .  ..       .     .....  .     . . .    .
.. .     ..   .  .         .   .   ....  . . ..    . .
.  .   .      ....    .           ..  ..   .. . .    .
.    . . .     . . .  .        .      .  . .    . . ..
..  . .    .. . .    ....      .        .. ..        .
..    .       . .      ....        .   .     .   . . .
.  .       .  .. . ....  .             ..  ..    .. ..
.  .     .  .   ...  .      .  .       ..     .    . .
.    .     . . .  . .    .   . ..   . .  ..    .  .  .
.. .. . .  .      .      .        ..   ..    ...  .  .
..  .  .    .  ...    .  .. .  .       ..  .. ........
. .     .  .  .  . .. ..  . .             .    .     .
.   .  . .  . .     .    .       ..    .   .  .  .   .
. .   ..  ..     .      .         .    .. .  .  ..   .
..         .  .         .    ....       . . . . ...  .
.    .  ..   . . . .     .   .   ...   .   .        ..
.    .      . . ...    ..  .              .     .  . .
. .... .  .    ...  . . .      .  .    .   .  ..   . .
.. .. . .      .  .  .           . .      ..   .   .r.
..  .      .  . ...   .    ...           .           .
.     .. .    . . . . . ..     .      .       .. ..  .
. .. .  .      . ..  .      .  . .  .   ..   .  ..   .
..    . .     ...   . .  ..     . ..   .  . .        .
. .  .              .         . .     . ..    .     ..
..    . ..     .  ..       .. .  . .  . .  .. .   .. .
.X . .   .  . .       ..  ... . .   . ...   ..      ..
. .  .                 . . .               . . .   . .
.     .. . .     .....   . .     ....       . ..    ..
. . . . . .   . . .  .   .   . .. .  ..   .     ..   .
......................................................
