.......................................................
. .  . .        .   . ..  .       .      .... ..     ..
. . . . . ..    .  r   .  .  . .       .          ... .
..  .  ..    .      .    . .     ..     . .  .    .   .
..   .         ..   .         .     .  .    .. ..   . .
. .     ..  .      .   .....         ..  ... .   . .. .
..   .   . ...... . ....  . .. .    . .. .         . ..
. .  .  . .  .  . . .  . .   .        . ..   .   .   ..
..  .   . ...    .  .  . .. .    .       .  .   .   ...
.. ..X   . .  .    .      . . .    ..  .  . . . . . ...
.  ..                              ..  .       .    . .
.    .     .  .  .. .   .  . ..    ..        .     . ..
. .    . ..  . ..  .   . .  . .     . ..  ..   ..     .
..  ... ....      . .    ..   .   .     ... . .   .   .
.   .           .  ... .     .   .    . .    . ..  .  .
..          . ...                     .  .      .   . .
.      .     . . . ..... ..  .  .  . .  . .  . .      .
.  .  . .                            . .  .   .... ....
. . .  . .        .       ..   .  .           .... ....
..... .. .     .  ... .      .  .        .     .  ..  .
..  ..     . ...  .  .  . .    ... .     ..      . . ..
.            .. ..  .  . .           ..     .. ....   .
.            .    ..  ..   ..  .    ..         .. ..  .
.     .   ...    .  .  . .       .. ..  ..   .       ..
. .    ..      . .    ...  .  ..  . . .    .   .      .
..  .  .     .             .  . .     .       .. .    .
..    ..     . .....  ...   .  . . . .     ..  .   .  .
. .   .   . .       ... . .   .. ...  .    .  .  . . ..
.         ....     .     . .       ... .      .      ..
. ....    . . ... .  .. .  .      .  . .      . ..    .
. . .  ..    ..     . .   . .  .   .   .    . ..     ..
.   .          .   .  .     . . .   . .  ...  .   .. ..
. ..    .    .    .     .   .      .. .   ...        ..
.       . .    ....  ...  .  . .  .    ..          . ..
.     . . . .     ..    .      . .      .  . .....    .
.   ..       . .  . .           .  ..  .    .  . .    .
.....  .    . . .       .  .   .    .  . ..         . .
. .. .    ...  .       .  .  ..             . ...     .
. . . .  .   . .     .... . .  .     .          ..   ..
.        . . .        ....     . .      ..   .        .
..   ..  .      ..  .   .              . . . . .    ...
..      .    .     ..  .      .   . .  ..   ...   . ...
.          . .     .    ..    ..   .  .  .    ... .   .
.         .    .  ..      .     .   .      .  .    .  .
... .    .        .              ...     ...          .
.  ..   .   .     .       . . .     . .               .
.   . .  . ..           ...  ..      ..       .. .    .
..   ...... . . ..              .   . .    .  .    . ..
.  .. .. ..      . .. ..          ...    ..           .
...  . .    ..     ...  .       . .   ...  . . .  . . .
..   . .   .    . .   ...   .  .     . .. . ..   . .  .
. .   .      . . . . . .  .    .  .. . .   ...   . .  .
.  .    ..     .... ..      ...   .   ... .  .  ..  . .
.      .   .        .  . .   .  ..   .       .      . .
.......................................................
