.........................................................
..  ..  .  .  ..     ..   .  ..  .       .    .   .  .  .
.       .    ..  ..   ..      .     .   ..     . .  ..  .
.  .  . .  ..      .. .. ...   .            ..       .  .
.   . .   .                 . .   . ..     ..   .      ..
. .. .   ...     .    .       .   .  ... .     . .      .
.... .   .   ..  .... .  . .  .    ..   .  .  ... ..  . .
. . .     . .    ... .    .. .         ..  .          ...
.  . . .   .   .    . . . .       ...    . . .          .
.   . ... ..    .  . .    .   ..  .  .. .         ... ...
..        ..     . . .... .. .. ..  .    .    ..  .    ..
.     ..          ....         .               .   ..   .
.             .  ..     .      . .    .  .   ..        ..
. ...  ....               .   .   .  ..      ..      .  .
.    . .    .             .     .  . .     .   .    .   .
....  .   .    ..        ...      .     . . ....      ...
..  ..    .      . .      . ..   .       . .     .  . ...
. .     .    .  ..   .     ...  ...       . ..     ..  ..
. .  . ..  .... .. ... .        . . .    .     .. ... . .
.     .  .      ..    . ...           ..         .   .  .
. .. .    . .        .       ...  ...  .  .   . .. .    .
.         ...    . ..... .. . . ..    ..          .. .  .
..   .   .  .         .   .          .   .     .  .     .
..    .    .    .    .    . .   .    ...  .             .
.  ......   .    .... .     .   . ..    .    .. .   ..  .
. . . .       .  . .. .    .. .   .              ..     .
. .     . . .    . .             . .     .       ..  .  .
.   .      .  .        ...  .. .  .  .    X .   . . .   .
.   . ..   . .      .. .  ....   .    .  .    .         .
.       .   .  ..  .   . ..  .   .  ..       . .... ... .
.     ..  . .. .  .  . .  ..  . .   ..        .. ..   . .
. ..      .  .    . .   .. . ...  .    .      . . ...   .
..  .. .. .        . . .        .. ..  .  .  ..        ..
.      . ... .    ..        . .         .      .    .. ..
. .  .   . . . .    .. . .        .    .   .   . .      .
..       .  .. ..     . .... . .. .    . .    .    .    .
.. ..     ..  .. .  ..    . .. .          ..    . .  .  .
.   . .   ...  ....               .   ..   ...       .  .
.  .    .. .  ...  .. .  . .         .. ...   ..  . . . .
.  .          .  . . ..    .   ..  .   . .   ..     .   .
.      .                  .      .   .. .     .     .   .
.          .     ..  .  ..    .  ..    ...      ...  .. .
.. ... .. .   ..            .           .    .  . .  .  .
.     .. .         .  ..  ... ..  ....  .      ..     ...
.       ..        .  .   ..  .        .. . .    .       .
.. .  .   .    .     .   ..    .      .               ...
..  .     .  .   . .   .          .   .....  . .  ..  . .
.       ..     .   .. ... .    . ..     .       ..    . .
. . .. .        .. ..    .  . ...    .       ...    .  ..
.       .  .       ..   . . .   .    .. ..     .  .    ..
. .     . . ... . .... .    .  . .  .  .       .    . . .
.   ...  .. ..r . . .    .. ..  . ...    .   .... .     .
.  . .       . .      .    . .. . . ..        .    .    .
.    .            .  .   .      . . ..     .     ....   .
.   ..    .  .  . ... .   ... . . .      ..  .  . ..    .
.....    . .  .    .  ... .     .  .  .. .         .    .
.........................................................
