..........................................................
.    .    .     .         .   .  .     .   .   .         .
.  .       . .    ....       ....     .   . ...    ..   ..
.   .   .      .     ..    ..    .   .  . ...   . .. .   .
...    .       .    .     .  .. . .   ..  .  ...   ..  . .
. .  .      . ....  .   .   . .         ..     .. . .    .
.    . .      .   ..  .  . . ..    .   .        .   .    .
.   .  ..   . . . ... .. .  .     .  . .    ..  .        .
.   .  . .      . ..                   .            ..   .
.     .     ..  ..      r     .. . ....    .   ... .  .. .
.... .    .X .            ..  . ..  ...   .    ....      .
.   ..     .     .   . .. .   . .......     .          ...
.   .    ..        . ...    . ..    ..     .      ...  . .
...              .. .     .       . ...  ..  ..  ...   . .
.  ...     ..      .   .. .  .          ..   .    .    . .
.. .  ...  .. .      ...        .        .    . .     .  .
..       . ..    .  ...  . ..  .      . .             .. .
.  .  .... . ..   .   . . .... .   . .  . .       .    . .
.  .  ..   ...       .  .  ..    .   . .       .      .  .
.  .   .  .. .    .  .     .   .. ..          ....       .
.  . ..  .      . .           .  .       .. . . .     .. .
. .  .     .    ...  .    ...      ..   ....    .        .
.  .   ..  ...       .... .  .      .  . .    ..   .   . .
.   .    .    .. ..  .        ....    . .  ..          ...
.   .. ..  .          .. .    .. . . .. ..       .  .   ..
. ..  .  . . .         . ..  ..    .  .. . ...  .  .  .  .
.   . ..  .     . ..     .   .  .  ..  .   ..   ..  ..   .
. ...             .    . .    . . . ..        .   . .    .
..   .  .    ..  . .  .  ..  . ..   . .. . .. ...  ..   ..
. .  .      .     .            . . . .         .. . ..  ..
.. .       .  .  .    . ...  . .    ..      .   ..  ..   .
. .  .  . .   ..          .   . .  . .               ..  .
.. .  .  .... .   ....   . .                 .. .   .    .
.    .. .   . ..  ..   . .       ..      .        .   .  .
. .   . .  . .. . ..    .                    . .   .     .
.   .. .      .      .  . .. ..       .  ... .   .  ..   .
..          .      ..   .         . ..       . .    ..  ..
. . . ..     .   .        ..  .   .    . .  .   .       ..
..    .  .       .   .     .     .       .   ..  .  ...  .
.  ..  .     .      ....         .  .. ..  .    ..       .
. . .    . . . .  ..   . . .  .  ..      . .   .       . .
.  .....  .  . .          . .         .   .      .  .  . .
.  .. . .   . .   .     .     ....    . .  .   .    .  ...
.    .      ..   .       ..    .            .  .  . ..   .
..  ..        .   .. .....      .     .          .. ..  ..
.       ..  .   ..  . .     .  . .             .    .... .
.   . ..  .           ...   .   ... .  .. .       . .  . .
.. .    .   . .      ..      . .      .... .     .   .   .
.. .. ..  .. .   .. . .. .. . . .     ..  .. .    .   .. .
.   .       .    .  . .  ..     .  .. . . .       .   .  .
. .  .    . .    .. .  . .   .  ...  .  .  .     . .. .  .
. .  . ..    ..... .         .  ..   ..            ..   ..
..          .. .         .    . .   . . .  .....  ....  ..
..   ..          .     .  .  .       .     .    .       ..
....      ... .  . .  . . ..    .   .         .         ..
..               .     .      .  .   . .  ..    . .  .  ..
.      . . .      . . .. .. . .. ...         .  .. . ..  .
..........................................................
