...........................................................
..         ..   ....       .       .    . .  .......      .
...  . .  ..  .    . .   .     . .       ..  ....  .   .  .
. .  .    . .. . .  ..  . ..    .     . .  .   .   .  .   .
.    ..     .. . .  ......    .    ....   . .        ..   .
.   .   .     ..  ..  .  .   .   .   .    . .   .    ..   .
. ... .. .   .   .r      . .       .             .  .   . .
.  .     . . ..              .     .           .        . .
. .  .  ..      .  .    .      ..           .   . ..      .
.      .   ...   . .           ... .  .         .   . .   .
..    . . .. .    . . ..   ..  .. . . ...  .    . ..  .....
....  .        .  ....        ...     .       . . .    .  .
..     .    .       .. .    ..     .  .      .   ..    .. .
.     ...  ..    ..    ..    .                   . . ..  ..
... .   . .  . .     .. .        .  .  ...    .  .. . .  ..
.     ... ..  .   .   .  .              .     .           .
.   .     . .  .        .          . .   . .    ..   .  . .
.  . .    .      ..  .. .     ..   ..   ..          .     .
.    . . .   ..  .  ..    . .  .    .    .   . .  .   . . .
..       .       . ...     ..    .   . .   . . .    .  .  .
..  .     .    .     .      . .   .    . ...     . .  ..  .
.  .           ..  . .   . . .  .  .  . .... . . .     ....
. . . .  ..      ..    .  .          . ..          ..  .  .
...       .. .. .    ... .   .  . .  . . . .            . .
.  ... .. .    .  .      . ... .     .     .      .    ....
.      .     .... .      .    . .  .  .      ..  ..  .   ..
. .. .   ... .. . ...     .. ..      .      . .   .   .   .
. . ...  . .   .      .      . .. .   ... .    .  .   .   .
.  .   .     .          ...       .. .  .  .   .      .. ..
..  . .      .  .   .      ..     .      . . . .   ..     .
.. .  . .. ...   .    . ..       .  ..  .  . ..  .      . .
.      . .  .      . .  .     ..   .    ...   .... .     ..
.   .. .  . .. .  . .   ..     .      .   . ...   ....    .
..    . ..      .   .    .   .      .  .            ..    .
...   . ..    ..   ... .           .. .  ..     . .       .
.. ..    .      .    .    .. .   .  .            ..  .    .
.  .. .  .    . ..    .  ..     . . .   .. .  .  .  . . ...
.   .. .       . ... .  ....  .   . .   .  .   .    ... . .
.. ..  .  ..   . .   . . . .    .   ..   .     .     . .  .
.     .   .. .  .       .     ..  .    .  .  .   .     .  .
. .     ..  .    .   ..   .    .    .        .        ... .
.  . .     . ..  .   .  ...   .   .      . .    . .       .
.   .  .   . .  .    .    .   .    .   ....   .       . . .
. ..          ...        . . . .. . .     . .       .. . ..
.  . .   . ..     .      ..   ..  . .   . . . .  .        .
. .  .    .. .. .    . .    .           .   . .    ...    .
. .     .... .    .   .   . ..          .  .     ..    .. .
. ...  ..   . ..         .      .  ..  .. .. . .       . ..
..       .   .. .   . .       ..             .    .    . ..
.. .          .   .  ... . ..  .  ....   .  ...   .      ..
.     .. .   .....  .   ..   .. . ..  .              .  . .
. .           . . ..     ..  . .   .   .   . .  .. . .. . .
.        .      .     ..     .  .   ..                .  ..
.  . . . ....      .   .. .      . .. .    .  ..  .  X  . .
. .   .   ..   .    .. ..  .    .       . . . .. .. .  ....
..  .. . ... . ..              . . .  .         .  .      .
.. .     . .      ..  . .     ...   . ..        .  .    . .
. . . .              .   .   ....          .     .   .    .
...........................................................
