............................................................
. .   ..   .  ..  ...     . .   .  .   . .  .    ...  . .  .
.    .       .  ..   .   .          .  ..   . . .  . . ..  .
.     .   .     .   .      ... .    .              . ..  ...
.     ..      ..  .    . .. ..  .. . ..  ..   .  ...   ..  .
. ..   ...     .   .   ..    .. .   ..        .    . . ... .
.    ..          .     ..   ..   .. .   . . .   .      .   .
.   .    .       ...  . .           ..... . ..    ..   ... .
.     .     . .  ..         ..  .. .  ..... . ...  .    .  .
..    .    ...     . . .   .   .. ..  .  ... .    ..    .  .
.     .  .  .     . ..        . .      ..        .  .    . .
.         . .   . ..   . . ..     . .        .   .       . .
..   .  . .     ..   .       .... . .    .   .  .. ..      .
.   .    .   .        . . .     . ..   .    ... ....       .
.  . .   .     .   ... .   .         .        .    .  ..   .
.   .       .  ..        . . .     .      ... . ..  .      .
. .   .  .    .    . . .   .    .   ...   .    . .     .  ..
..  . .. .   ..   .  ..  .. .       ..     . .         .   .
.      ..     .      .   .     .             ...  .  ..    .
.   . . .    .     .      .        . .             ..  . . .
.         . .   .      .  ..     ..  .     .  . . .  ..  . .
. .  .  . ....    ... ....  .      . .     .    .   . ..  ..
..  .      ..  .  . ..  .    .  ..      .           ..     .
...  . ...  .. . .    .    . ..  .. ..   .. .   .   .      .
...     . .   .. .  .  . . . . .   ..    ...   ... .       .
.   .       .          .. .   . .  .           . ..  . .   .
.   .. . ..  .. .    ..   .  . .  ..          .     ....   .
.   .    .    .     ...         . .  .  .      .. . . . .  .
.          .            . ... .  .       . .     ...  . .  .
.  .    ..  .    . .  .        . . .    .  ..    . .   .   .
...      .  .  .         .    . ....      .  .  .. .  .    .
. .   ..    .   . ..   .           .       ..   . ..  ..   .
. ..  .  .   .   .     .         . .              .. ....  .
..... .        ..     .    .  ..  .  .. .   .    . .....   .
. .   ..... . .     .        .. .. .  .   .. ..  .   .     .
.  . .   .. ...   . .  ..      .. ...  .. .     . ..  .  . .
. .. . ..          .....   .         .   ....   . ..       .
. . . .    . .  . .   . .  . .        .....  .. .       .  .
.. ..  .     ..  ..     .  ..  .              ..   ..   .. .
.  .. . ..        ..       .   .  .       .   ..   ...... ..
.      . ....    . ...           . .      .      ..    .   .
. . .   .     ..            ..  . ..        .. r   ..   .  .
.    .   .   .    .  ..  .  ..   .   ..  .. .  .       . . .
.  ..  ...  .      .           .    .       .    .  .   .  .
..   .   .      . ..    .      ...    .  . .   ... X.     ..
.    .      .   ..     ... .  ..         .     ...       . .
.   .  . . . .     ...  ..         .   . . .      .        .
.  .. .. ..   .         . .           ..          . .    . .
. .     . . .   . .     ....  . ..    .    .....     ..    .
. ..          .        .  .       ... .... ..          .   .
.  .  .        ...      ...  .     .  ..  ..  .    .      ..
..  . .   . ..  . .   .       .  ..  .   ....          ..  .
.     . .. . ..        . .  ..    ..   ..             . .  .
..      ..   ...     ..  .. .       . .  .   .           ...
. . ...                   ..        ..  .  . . .       .   .
.       .. .  .         .. .        .  .  .        .   . ...
.... .      .       .      .. .  .  . ..  ...   .   . .    .
.  . .. .  .     ....  . ..   . ....    . .   ...          .
. ....         .    ..     . ... . . .       . .  . .  .   .
............................................................
