.............................................................
. .       . . .  ....  .   .  .        . .   . ..    .    . .
.   ..           .    . .  .   .    . .. .   .. ..          .
. . . . .   .    .       ..   ..  .. . ..  ... .    . .. .  .
..  . ..   . .    . ...  ..         .   . . ..  ..   . ..   .
.  .      .  . ...  .  .. . . .  .      .   .  . .     . ....
. .  .  ..    .    ..       .  .             .    .         .
....    ...   .                      ..    ...     .      . .
..    ... .   ..   ..      .   ..  .. ...  .  .         . . .
..  .   ..          .   . .. .. . .  ...           . .  .   .
.     . .  .. ....  ..    .  . .        . .     .           .
.. .  ..   .    . .        ...     .        ..   .     .    .
. .   .   .  . ..   .      X         . ...  ..   .   ....   .
. .          .         .  . .. . .       .. .   . . ..    . .
.  ..        .. .    .. .            . ..  . .            . .
.. . .   .  . .      .          .          .     .   .    . .
..   ...    ..   .....   .       .   .  .    .   .   .    . .
.   ....    . ... . ... ..  . .  .      ...    . .         ..
. . .     .      . ..    . ... ...   .   .  .        ..     .
... .          .     ..           . .    .  ..      .   . . .
.    .  . .        . .. ...   .     .. .     ...    . .. .  .
.      .  . ... ..        .     .       . .        .  .  . ..
...   .           .   .   .   .       .    ... . .          .
.        .   .  . .  ..  ....     .. ..... . .. ... .  .  . .
. ..   ..   ..    ..    ..   ..  .   .     .      .  ....   .
. . ..      . .     .     . . ..      .   .                ..
.   ..        ..  .              ...     ..    . .        . .
.         .    .    .    . . . .   .     . .....    ... . . .
.  . ..  .    ..    ...            .      .  ...      . .   .
...    .  ..  . .. .      . .   .     .    ...    ..       ..
.    . ... .       .       . . .   .   ....   . ..   .    . .
.   .  ..    .  .             .  . .          .  .  ..  .   .
.        ..   .  . .   . .. .  .  .  .. . .       .  ..   . .
... . ..   .  . ..   .     ..     .  .   .. ..    .    .   ..
.   ..   .  .... .  .  .    ..   . . . ...   . .   .     .. .
. . .    .     .     ..                 .    .  .    ..     .
.       ..  ..     ..   .       ...      . .    ... ..... . .
.     .     .      ..  .    .   ...  . ..  . .     .  . ... .
. ..  .  .  ...           .  ..            . . .. .. ..    ..
.             . ...     .    .  . .    . .   . .. .  ..  . ..
..  . ..       .             .    .      . ..     . .     ...
..    ...  .r       .    . . .                  .. .    .  ..
.  .. . ... . .         . ..      .  ..       .  . .  .. . ..
.  . .      ...     . ....  ..  ..     .   .        ...     .
..  ...     ..        .     .  . . . .         . ... .    . .
.  .   . ..   . .   .. ..    . ..     ..  .  ..      ....   .
.  . .  .     .      . ..         .   .  .       .. ... ..  .
..  . .    .  . . .     . .      .   .  ....    . .        ..
.             ...         ..   . ...     .  ..    .. .    ...
..    .       ...            .  ...        .     .  . .     .
.      . . .    .. .       ..         . . ... . . .    . .  .
.   .   .      .   . . . .     ..           .  . ..   ..    .
.  .   ..   .    .              ..       ..       .       ...
. ...  .   ..    ..  .   ..       ...   ..    . . .      .. .
.   ..     .  .   .... . . ..    .. .    .           .    ...
. ..         ...   .  .. .   .    ..  .     .        .  .   .
.  .. .         .   ....    ..  ...  . . .        .. .  ... .
..    ..  .. . ... ..  .    .  . ..   .             .....   .
.   .  ..     ..   ..      . .  .  .       ...  ..   .. .   .
. . . ... .       ..   .   . .      .. .  .  .    .   ... . .
.............................................................
