..............................................................
...      .  .     ..     . .    . . ..   ..    .   .    . . ..
.  .     .                   ..  . .   .      ..     .   ..  .
. .   ..  .  .    .       .   .  . .        . .  .        .. .
.. .       ...  .  .. .   . .       .  ..   .    .     . . ...
.  . .    . . .    ..    ... . ..         .  .    . . .  .. ..
. ...   ..   ....     ...    ..     ..       ...  .     ...  .
.  . .    .  .      . .    ..    . ..  ...          .  .     .
.  . .. .   .       . .      . .  .    .  .  ..       .   .  .
..   . ..    .   . . .  .   ..   . . .       ..   .    ..  . .
. ..  .. .   . .. ..   ...         .     .          ..   . . .
. .   ...  .        .    .          . .   .. .   .. ..  .    .
.. .. ..  ..     . .. . .   . ..  .     .    .. . .    . .. ..
.  .  .  .....     .      .     . ..     .. .                .
.         .     .   .  . ..   .  .    .  . .   .             .
.  ..        ..         .  .  .          ....       . .   .. .
....  .   .. .     .     .             ..   ..  .    . ..  . .
. .   . .   ..  .   ...     ..       .    .  ..        . X   .
.  .     .     ..   ..    .  ..     .  .  ..  .    ..   . . ..
.        .   .  .   .        .     . .   .       .        .  .
..          .  ..   . . .     .    ...   ..  ..    .  ..     .
.            . .  . . .. .   .. .  ..  .    .        .   ..  .
.  .  .       .  .  .      ...  . .  .. ..  ..  .          ...
.. .    .   ..  .  ..  .   .    . ..  .       .     ...    . .
.   .  . . ...      .  . .   . ..     . . ...   .    .. .   ..
. .    ..   . . .   ..    . .   .. .    .. . .. ....  .     ..
.  .  .  ..  .       .  ..    .       .         . .. ...    ..
. . .             . .. .. .     .           . .  . .     . . .
. ....   . ..   .  ...  . .  .    . ..      .  .  .. .       .
.. ...  .   ..   .  .    .  . .    ..          .             .
... .    ...     . .   .     .  . . .       .... .    . .  . .
..   .    ..   ...  ... .     .   ... . ... .   .  .  .      .
.            . ... ..   . .   .. .. .    ...           .  . ..
.     . .... ..     ...   ..  .  .       .   .  .       .   ..
. .  . ..  .       ..     .   .  ... .      ..    . .      ...
.      ...    .       .  .     . .    .           .    .     .
..   .       .   .    . .         .. .    .... .  . .. . .   .
.      .    .  .. .     ..    ... .      ..   . ...     .  ...
.   . . .    .     .  . .           ..   . ..     .     ..  ..
.   .   .  .   . .   . .   .   . ...  . . . . .    ... .   . .
.    .  . . .   .       . . ..  .      ..        .    ..     .
.    ..  . .    .   .. .   . ....      . .       ...  .    . .
..  ..  ..    .         .. . . .   . . . ...    .. .  .      .
..      .   .   . .. .    .  .   ...    .  .. . .   ..  ..   .
. ...    ..     .     .  .        .  . ..     . ...    . .  ..
..  .   .          .  .    ....     .  .. ...   .  .   .     .
.  .. .   . . .   .   .    . .     . .     ..       .  .     .
.  ...     ....  ..       .   .  . ...  .    .  . .     .  . .
..   . . . r.   .  .. . ..  . .    ..  .   ..  ...  . ..  . ..
.  .   .   .  ..    . ..      .    . .  .   .   . .....      .
.     .     ..      ..   ..  .... .     .  .     ..  .       .
. .  .     .  . .    .  .  . .  ..   .. ...  .   .  .   .    .
.   .    .. . ..   .         ..   ...   .    .   . . . .     .
.   .  .                   ..       .   .    ..           .  .
. . .     ..           ...  . .. .. .  .      .        ..    .
...   ..     .    .  ..                 .               .. . .
.   ..     .                .... . .....      . ..           .
..  .    . .  . ... ..      .   ....  ..  ..   .      .    . .
.  .   .  ..    .    .   .     . . . .       ...      ...    .
.   ..   .         .  .. .       ...  .  .  .       .   .. . .
. .      .       . .. .     .   . .    .   .       .. .      .
..............................................................
