...............................................................
. ...  . . .. .      .    .   . .. .   . ...  ..   .   .      .
. .     ....          ..     . ...    . .  . .   ..  .   .   ..
.           ...... .  .    .  .       .. . ..  . .  ..        .
.  . .. .. .    .      .      .  ..    ...   .. .  ... .. ..  .
. ..     .  .  .. .           .. .  . .          .       .. . .
..    .           .   . X .. ..     . .. .. . .  .. ..  .  .  .
. .     . .      . .  ..           .  . .  .. .  ..  . . .  . .
.   .. ....  .  . .    .  ...     .      .  ..   .     .. . ...
.  .. .       .    .         . ... . ..    . . ..        .   ..
.. . .  .       .. .  .       ..  ..   ..  . .  . .   . . ..  .
.    ..  ..      .... . .         . .          ..     . .   . .
. . . .     . . .. .    .       . ..              . . ....    .
.     .     . . .....   .        .    ..    .. .  .  .  .     .
.     . ....         .   .  ..  . ..    ...    ..  . .   . .  .
.   ... . . .  ...  .      ...    ...     . . .  .   .     .  .
..  . .  . ..     ..     .. ..        .. .  .     .  .       ..
.       .....     .     ..     .    .  ..   .          ..   . .
.   .  .  .   .          ....     . .   .....        .  . . . .
. .. ..   .   .. .      .     ..    .  .   .  ..  . .     .   .
.   .    .          .   .  ....  .    . .  .        .   . ..  .
.  .   . .. ..      .. . ...     .  . .  .   .           . .. .
. .     .. . . ..  .. . . . .   . .       ....   .           ..
.         ...  .       .  ..   .         ..         .    . ....
..      .     ..       .  ..   .   .           .  ..  .     . .
..      . .. . .     .      .     .  .  .  .            . .   .
. ... . .        . .... .       . . ....  .  ..   . .  ...  . .
... ..  ..     .. .  .          .  .    .   . .      . .      .
.      . .   ... ... .     ..  .   .  . .   .      .          .
... . ..   . .   ...                              .. ..  ..   .
.. .         . .     .      .    .      .          .    .   . .
.  ..        ....    .  ..    .  .      .    ..   . .         .
... .       . .. .. .   .   ..  . ...     .  .   ...  .       .
. .. .     .  ...   ... .     .   ... .     .    ..       .   .
. .   .   ...    ... .  .      .  . .       .  ..     . . .   .
.  .          ...           .    .. .   .  .           .  . . .
...    .    .        .       . .   .             .            .
. .      .. .. . ..    .  .   ...  . .  ....  .             . .
.  .     . ..  . . .      .       .      . .  .            . ..
..  . . .  .   ..    .  .. .. .   . .  .      .    .    . ..  .
.   .   .    ...    .    .       .  .   ..  ..      . .   .  ..
..         ..  .        .   ... .      .     . .. .         ...
.     .. .      .. ..    .    . ... .    .  .     .    .   .  .
.         .    ..    . . .. . ..      .  .    .    . .    ... .
.    .                  .   .      ..   .     .   .   .   .   .
... .. ... .   ...  .   . .. .. .          .   . ...       .. .
.  . .. .      . .     . . .     . .. ..               .      .
.. .     .       . .      .  .      ..    ..    .    ..     . .
.   r . . .   .    .   . . . .  .         .   ..    .     .   .
..  ..     ..  . .    .     .   ..   . ..  .   .              .
...    .    ..    . . ..  .          ...    .. .   . .    .. ..
.     . .  ..  . ..  . ....  ..     .      ...     .  ..  .   .
..     .. ..   .  .  . ...   ...   .    . .  .  .     . . .  ..
...      . ...  .   ...      .   ..   .   .  .  ... .   . . . .
...  . . ..  .       .  .. . ...       . .  ...     ..  . .  ..
. .           . .   . . .        . .   ... . .        .    .  .
..    .     .            .  .  . ...        ..            ... .
.     ..   .    .     .  .    . .. . .   .     ..    ..     . .
.        .  . . ..  . .          . .     .    . ..      .     .
. ..   .        . .. .. .    .. ..   .  ...   .  ....  .  .  ..
..    .      .    . .    ..  .  ..   ...  .          .     .  .
.    .     ..    .  . .     . . ..    ..   .. . .. .   .  . . .
...............................................................
