................................................................
.  ..   .    .    .. .    ..  ..   .. . . .         .   .  . . .
.    . .  ..    .      . . .   .. . . ..... .  . .   .   .   ...
. .             .        . . ..       . ..  . ... .       .  . .
. . ...     .     .  . . . .. ..     .     .  .       .   .    .
..       .. . .      ....     .   .   .  ..     .        .   . .
. ..  .   .  .     .  . .  ..       .          .     .  .  . . .
.          .        ..     .      .   .   .  . .   .       ..  .
.  .     ... .   ... ...      .    .     ..     .   .  ... . . .
.   ...   ..     .     .       .         .. .... .      .  .  ..
.   .. .       . .  . .    .      ..  .      . r   ..   ..     .
. .     .. .      .        ...  ... .   .        .    ...      .
..      .      .  ... ..  .    . .   .         . .    .        .
.   .  .  . .  .   ..  .       . .     ..   .    .    ...   .  .
..   .         .   . . ...  .       .      . ....     ...   .. .
..  . .   .   . .                   . .   . . .    .  .    ... .
. ...  . ...  . . . .   ....  .   ..     . .   .    ..      ....
.   . . ...    ..  .   ..  .        .    ..    .     .   . .  ..
. .       .. .  .      . . ..             ..  .     .   .  .   .
.. .     .    . ...     .  ..  .            ..      ..    .   ..
. .   ....    .   .     ..   . . .      .  . .     .       .  ..
.. .. ..    .. . . .    ...  .   ..     .  ...     . .   .... ..
. .     ...   .  ...           ..   ....  .  .. . .  ...     . .
.    .     ... .     .   .        ... .   .  .   .  .. ...     .
.  .     .  ..   .. . ..    . .   .          ..         . ..   .
...    .. .  ..            ..      .      .      .. .  . .     .
..    .  . .  .   . ...   . . .       . ....     . . ..  .     .
. ..     .... . ...  .  ...   .... . ..  ..  ..        .      ..
. .  .           ... . ..   ....     .      .   .. .  ..  .    .
.  .  .   . . .     .    .       .    .     . ..          .  . .
.     .  ....                    .   ..  .  .. .             ...
..  .. .   . ....  ..      .  .   .... . .. .  . .  .        . .
.       ..      .          .      ..    .  ....                .
.    .     . .  .. ..     .      . .  . .      .  .  . .   . . .
.   ..   .  . . . .   ..  .    .   .. ..         .  ..    .    .
...    .. ..     . ..     .   .  .      .   ..  .     .      . .
.  .  .     .  .  .   .  ... ...      ...      .        . ...  .
..  .    ..  . .      .. . . .     .     .  .... ..   .  .   . .
. . .   .   .  .    . ..   .         .  .  .   ..   ..     ..  .
.      .       ..    .   . .   .       . . .   .. ..  . ...   ..
. .  .   . .    .  . .        . .   .     ..     .     . .  .  .
.  .       .  .     .      . ..    .     .  .  .       ..     ..
.       ..   . .  ..      .         ...   .   ... . . ..   ... .
.   ..  .   .. .  . . .. .  .      .    ..  .    .     .    .  .
.        .    ..       ... .   .    ..   .. . .  ..   . .  .....
.   .  .     ... .    . ..       .. ..   . ..   ..   . . . .. ..
. .. .  .. . ...    . .       .    .  .   .    .        .   .  .
. .. .  .   ....      ..  .  . ..   .    .  . ..           .  ..
. .  ..  .   ..    .                        .  .    . .  ..    .
..  .    ..  ..       . . .   . . . .   . .   .  ..  .   .     .
.. .   .      ...       .  .     . .    .          .  .        .
.  .        .. . ..      .    .    .     .    .  .  ..   ..    .
.    .       .    .    ..      .   . .   . . . .      .  .   ...
. .      .   . ..     .   .      . .     .. .   .        .     .
.      .     .    ..   . . . .    .  .   .  .  .. ..   ..      .
.  .  . .    ... . .     ..     . ..  .    ..  ..          .   .
. .         .    .. .  .  ...  .  .. .  ..  .       ... .   .  .
.   . . . .       . .    .   X    ..   .. ..  ..      .. .. .. .
.  .   .  .            ..          ..  ..  .            .  .  ..
.   ... .. ..    ...   .   .   ....     .          .. .   .  . .
.      ..      .    ... . .    ..  . .    ... ...       ..  . ..
.  ...  ..   .    .    ..    . .  ..        .  ..  . ..        .
..... .  . .     .     .    . .   . ... .      . . .  ...      .
................................................................
