.................................................................
. . . .  ..   .      .  .. ..  ..   . .   . .  .  .   . .      ..
. . . .. .   .            .   .          .  ... .   .  .        .
..    ..   . .  ..            .    .. .       ..     ..  . . . ..
.     .    .    . .      ..  .     .. ... .. . ..    .  .   ..  .
.           ... .    .   . .  . .  .  .    .  . .   ..  . ..  . .
...   .       . .   .      .  .    . ..  . . .   .   .  .. .   ..
.  .     ...   . .  ...    .     .. .    .         . . ..       .
.  ... ..    .               . .     .    .  . .... ..       . ..
.   .. . ..  .   .   .   . .    .       .   .     .  ..       . .
. . . .    ...  .   .      ..         .   ..  .       .   .   . .
.    . .      ..    ..   .     . .         .   .  ..    .      ..
.. ....   . .  . .   .. .        .  .  .  . .             .    ..
..   ...       .......   .         .  . ..   .   .. .  ..       .
.....   ...  .. .  . .. .      ..  .  .      .    . .      .  . .
.  . .  ..   ..     .  ...   .    ..            .  .  . ..      .
. .     ..  ..  .. .    .  ...    ....  .     .   .  .  .    .. .
.   ..      .   .   .     ...   .    .  .. .  . ...         .   .
. .               .   . ...   .  . ... . .       ...   .   . . ..
. .   .  .       .  .             .... .            . .   .. .. .
.. .   .    . . ... .    ..    . ..    ..   .   .. .    ..  .. ..
.    .               .     . . .. . .            ... . .        .
.       .    ..  . r.  .      . .  . .. ..    .  . .    . ...   .
...                  ...... ..             ..   .. . .     ..  ..
.   ..          .   . .    ..      ..        .   .   . . ..  .. .
. .      . .     .     .  . . .  . . .  ...  . ..  .  .    .   ..
. ..    .  .     . ..           .      .  .. .      . ...   ... .
... .. .     .         . .   . .   ..     ... . .   .  .  .. .  .
..      .   .         .  .    .  . ..   . .  ..  .    ..    .   .
.     .        . .        .  .    .. . .  .   ..  . .     ..    .
. .  ...    ..   ..   .    . .          .  ... .  .   .  .    . .
.. .   .   .... ......   ..    . .    . ..          .  .       ..
..   .          .   .  .                  .. .      .   .       .
. .  . .. .        .  .      . .  .  . .  .  ..  .    . . .   ...
.  .  ..  .    . .  . ...       ......  .    .             ...  .
.  .        ...   . .    .  .    ..  ..     .  . .    .   ... . .
.   ..            .   ...        .    .   .  . .      .      .. .
.     .  ..  . .  .    .   .  .     ..   . ...  .  . .     .    .
.  .  . . . .   .. .   .       . .  .  ... ..    .. .  .       ..
. .  ...  .    . ...          .           X ....      . ..    . .
.      ..    .   . . .   .   .     .  .  .   .. . ..  . . . .  ..
.   ...   .    ..   .  .  .    .. . .   .. . .  .      .     .  .
.               ..   .    .  .    . . . . . . .  . .   .        .
.     . . .     ..   ..  .     ..    .     . . . .    . .       .
.   .  .    .           . .. . .       .      ..     .      . . .
....     . ... .. .      .      . .    .       .           .    .
.. .   .  .         .     .   .   .   .        .. .      .  .   .
.....        .          .  .          .        .   ..  ...   ....
.. .   .   ..   . .  .  .   .   .  ..         .. . .. . .      ..
.  .  ..    . ...   .         .   ...      . .     .            .
.    ..        . ..       ..   ..     .   ...    ...      . .  ..
...      .     ..   .. ... .. . .. .        .  ... .  .  .  .   .
. .   .       . . .  .  .  .  ..   .        .       .  . .. . . .
.  . .         ..   .   .   .  .       .  .    . .  .   .  .    .
.  .   .. .  . .      ...              ..  .       .         . ..
.   . .. .  .    .       .     .... . .  ..  . ...   . .       ..
.     .  .  .  ....   . .     .      . ..    ... ..       .. ....
. . .          ..   . .         ..  .  ..  . .   .       .. . ...
. .    ..  .   . . ..  .  ..       ..      . .  .   .   .  . .  .
..... . .    .. .. . .  ..   ..  . .   .. . . ..  . .   ..    . .
..   .       .  .     . .      ..         ..  . .      .. ..    .
.   .           .  ....    ....   .     .      .  .  ..      .. .
.  . .  ..  ... ... . ..   .    .. .   ....   .   .     .     . .
..  ..  . .   .    ...   . ..  ..   .            .   .     .    .
.................................................................
