..................................................................
.    . . ..        ..  .   . ..  . . .   .  .. . . . . .  ... .  .
.    .   .  .         .             . .. .                       .
.. .   .    .. .   .    .     ..   .   ..       ..   . ..  .   ...
..            .  ...  .       ..     .... .        .     .   .   .
.  .  ..      .      . .  .   .   ..  .  ...       .. .  .    .. .
.. .  . .   .  . ...   .  .  .. .. .  .   .. .       .    ..   . .
. . .. .. .   .    .   ...  ...          .      .... ..  . .     .
.. .. .   .  ..     .  . X...     .       . .   .  .. .. .  ..  ..
.   ..      . . . .  . ..         ..   .          . . .    .     .
. ...  ....               .     .  .  .    .      .. ..     .    .
.  . ..   . .   .  .   .   .   .. .  .. .     ..     .  . .  . ...
.     ... .  ...    .     .    .   .  ..  ..    ..     .     ..  .
.   .. .    .        . .  ..   ..  . .          .              . .
.  .. . ..    .   . ..       .. .    ... .  .     .  . ... . .   .
.  .      ..  ..    .. .    .        ..   ..    .  .      . . .  .
. .. .   .   . .  .. .  . . ...        ...  .  .    . .     .   ..
.      . .  .  ..  . .     .  .. .  .  .   .   .. .    .    . . ..
.    .   .   .  . .  ..    . .    .      .    .                  .
...   ..  ..       . .    ..  ..  .   .     .. ..  .. ..   .. .. .
.  ..  . .     . . ....     ..  ...    .         .  ..   .  .    .
.. .. .      ..  . .       .   . . .              .  .  . . .  . .
.  .   . .. ...  .. .   .            .    .  .   ..  .. . ..  .  .
.  .     .  .. ..  . . .  .  .. .     . .   .      .  ...  .     .
..  .    . ...  .  .         .   .  .        ..  . .   ..  .   . .
.    .  .        .      .   .           . . ..  .   ....         .
.. .  .  .. .   ..  .    .. .    ..   .  . ..    ..   .     .  . .
. . .  .   .. . .   .         ..    ..        .   .      .   .   .
.  .     .     .     . .        .  . .  ..    .       . .. ..   ..
.  .     .       . ..       .    .  .   . ..  .. .     .   ..  . .
.    .        ..  .  . .   .   . .  ..     ..    .  .      ... . .
. . ..    ......    .      .... . ...   . .....         .... . . .
..    .      ..   . ..  . .  .   ...  .          . .. .... .     .
.      ..    .   . . .         .         .. . .   . ..     ...  ..
.        .  ...      .. .  .     .  .  .    ...   ...  ....  .   .
. . .. .   .      .   .. .. . .  .    .   .    .  .  ..   .  . ...
.        .      . .  . ..    ..  .      .      .   ...  .      . .
.     . .   .     .     .    .   ..    ..   .  . . ..   .   . .. .
. .. .. .      .   ..            .          .     . .   .  . .. ..
.       . ..     ..   .. . . . ..       .  .      ...... .       .
.    ..    ..                . . .      .  .     ..    . .  .    .
...    .   ....        .           .    .  ... .  .        ..    .
.   ..          .  . . .        .   .      ..   .   .  . . ..  . .
. .      ...  .    .        .            . .   . .  .      .     .
. .  .. .        ..  ..     ..  . .    ... .        .     .r . ...
.. .  .  ...     .  .     ..     ..  .  .  .  ... ..     .    .. .
. .. . .      .    .   .   .  .. ..      . .  .    . .. ..       .
...  .      . .    .    .  . .    . .     .    .  .. . .   .     .
.   ..         . .   .      . .   .  ..  .  . . .   .    .       .
.. .   . .          .  . .       .. .  .      .   . ..   . .  .. .
.  .  ... .  . ..              .   ..  .   .   ..    . . .  ..   .
. .     .     ...  .   . ..  .   ..   ..       ...     .       . .
.  . .   .      .   .  ...     .     ....  .  .. ..     ..       .
.    . . . ...    .. .           . . .. .. .  .  .... .         ..
...    . .    .         .     .  . .        . .. .    .   ..  .  .
. ..    .    . ...   ..   .      ..    . .          ... .      . .
..       . .  .   .   .. .  .  .    .       .   ..  ...  . .    ..
.    ..  ... . . . . ..  . ...  .      .         .      . .      .
. . ..   . ..  .. .          .              ..   .  .     ........
..     . .. .    .       .  .   .   .     .   ... .     .       ..
.     .   .     . . .     . . ..   .    .    .  ..  .         .. .
.      .               .   .       .       .    ..   .  .       ..
.. .  . .      .  .   .   . . ..     .     ...    ...            .
. .        .   .     ..     .  ..   .          ..         .    . .
. .      .. .. . . .   .  .  .  ..    .    . .  .  ..  ..  ..   ..
..................................................................
