...................................................................
.   .. ..      .  .    . .  ... .  .  ..       . .  . . .  . .  . .
.   .  .  ..         .  .    ..    . .       .  .      . . ..  .  .
.  .. .  .         .    .   .     . . .  . .  .     . . .      .  .
.. .  .       . . .            .   . . .    .      . ..  .       ..
.               ..          .   ...   .  .  .   .  .   ..     . ...
..  .       ......      .  r  .  ..  .    . .. .        . ..     ..
.    ..   .  . .   ...    .. .   .      .      .               .  .
.           .  .   . .    ..   .  . . .  ..    . ..    .     .   ..
.   .   . ...     . . .   .       . .  ..  ..  .. . .  .  .   ..  .
...  .  .       .... ...    .  . .   .    .     ..      .      . ..
. .. .. ... ..    .   . .. . .      ..  ....          . .    . .  .
.     .     . .    ...      .     .   ..   . .        .       . . .
.      .   . ..      ..            .    ..      .    .   . .      .
.       . ..       .   ....   . ...  ..           .   .  ... .  . .
.   . .  ..  .        . . .... ..   . .  ..  . .     ..   . . ..  .
. .  .  .  . .. .    . .. ...    .  .   . . ..  .  ..      ....   .
. ..    .  . .  . .      .   . ..    .     .    . ..     ... ..   .
.       . .    .    ....  .   .         . .             .    .    .
...       .         .  .  ..    .        ..       ..   ..  ....   .
.  .    ..    ... . .   .      .. .     .   . .  . .   .   .      .
..  .     .         ..  ....           . .....       ....  .    . .
.. .. .   .  .  . .           .      .   .. .   ..            .....
.  .       ....  ..  .   ..    ... .   .         . . .  .  .  . . .
..   ..      .. .     . ..        .   . .  . .    . .. .    . .....
. . .    ..    .  . .. .              .    ..    .     ..   . .  ..
..  .. ..  .         .. .. .       ...  .   .   ......          ...
..        .     . . .           .  . . .      ..      ....  .  .  .
.  . ..  .    . . .  .. .   .  . .     .      .  . . .   .     .  .
.   .. .. .         .. ...    .. .     . . .   .   . .    .   .   .
..     .. .  ..     .  .      ..     ..     . ... .  .. .   .     .
..  .  . ..  ...  .      .     .   . .        ...           .    ..
.  .  .     ..   ..      . .   ....... .    .      .    .    . .. .
.  . .   .  . .    .....     .               .    .     . .       .
.    . .  .       ..   .        . .   . . .. ..          .        .
. . .. ..      . .  . . . ..    .         .            .         ..
.  ..          .  ..  ..  .          . .  . ..     .    . .     ...
. ..        ..      ...  ..         .       ..    . .   . . .  ....
.... .     .  .              . ...  ...             .    ...   .  .
.    ..   .        .  X.   .    .     .....      .  .    .... ..  .
.    .  . . .  .    ..         . .     ..   ..  . ..  ..  ..      .
. ...   .  .  .   .. .  . ..     .  ..  ..  .            .        .
.    .      .      .         . .    ... . .  . . .  .    .      . .
.   .     .. . ...    .  .   .  .   ..  . . .  . .     ..     .  ..
.    ..  .   . .   ..      ..         .. .. .   . .   ..  . .  .  .
.. . .    ..       .. . .   .  .   . .. ... .  . .   .      .  . ..
..     . ...   .      . ..  .       ..  .     ..  ... .   .. ..   .
. .  . .   .. .    .   .     ..                   .     .    . . ..
.    .  .           . .       . .      ...    .   .. .    . .     .
.     .     .   . .  .    .      . .. .    ..     .. ....   .    ..
.. .    .    .             .   . ...    . . .         .      ..   .
.  .  .....  .       .    . . .        .   . .    . . .      .   ..
. .. .     . .      ..   ..  .  ...       .   .        .    .   . .
. .       . ... . . .......      .  .   ...            .   .    ...
. .  .  .. .  .   . ..  .  ..   .  .. .  . .  . ....     .      ...
...    .    .     ...  ....  .  . ..     . ..   . ..... .  .  . ...
.   . .          .  ..       .   . ..     .    .  ...  .    .     .
.   .         .. .  .  . .    ..  .          ..    .    ..  .   . .
..  ..   .  ..               .  ..     .     .        .     ...   .
...  .  .  . ..  .  ..     ....      .. .. ..     ..   ..    .    .
.. .   .    .      .  . .... ..  . .    ..  .    . .    .   .     .
.   .  .  .  . . .      . .   ..   .  ..      .    ..     .  . .. .
..             . .. .  .      .      .  . .  .. .     .  ..   .   .
.  .. .       .   .. .    .        ....  . . . .      .    .    ...
.. .   .       .            ....        ....  .     ... .     . . .
.     . . .....           .  .  . ..       .. .  . .  .       ..  .
...................................................................
