....................................................................
.  ..    .  ..  . . ... . .   . ... .                 . .  . .  .  .
..  .  ..    ..             ..  ..   .. . ... ..   .         .   . .
.   ...       .      .     .            .. ..  .  ..    ...  .   . .
.. .        .  .  .         .  .         . .           . .    .. . .
.      ..  ..        . ...  .       .   .    .     .  .   .    .   .
. . .  .  . . .  .   . .  .   ...            .       .  .   .  . . .
.   .  .. .        .      .   ..    .  .   .. ...    ...  .     .  .
..  . .  ...   . .   . .     .   .    .  .  ..  .   .       .    ...
.    ... .   .       .  . .   .   . .  .    ... . .       ..       .
..  .     .   .. . . .       .    .          .      . ..  .  .  .  .
. .     . . .   .   .. . .   .  ..       . .. . . .        ..  .. ..
.      ..  .  ..     .    ..   ...  .. .  . . . .         .   .    .
..    . .. ...   .   ...    ..   .     . .     .            . .   ..
. .     .   ...        .    .  .    ..    ... .  ...   .   .   .. ..
.   ..    .   .  .. ..         . ..      .    . . .   .   . . ..  ..
... ...     .  ...    .. . ......    . . ..  . .       .  .        .
.... .  . ..    ..  . . ..     . .         . .  .   .     .   .    .
.        .... .    ....      . . .   ..         .    ..  ..   .  . .
. . . ..    .. ..... .....         .....  .    .      .     .     ..
.  .       .   .     .    .  .  ....  .     . .   .... ..          .
. . .    .  .  ..     ..    .. .     .    .   .. .    .  r   .  . ..
...      .   .. . .     ..... .    ..  . .          .     .    ..  .
. ..       .         . .        .      .                  ..      ..
.   .   .  . ... .    . .   ..  . . .    ..   .  .    ..    . ...  .
.         . ..      . .   .        .    . .  .  .  .. .         .  .
..  .  .  ..  .       . .  .     .          .   ...    .      ..  ..
.    . . . . .   .. .  .     . .  . ..    .     .     .   .  . .   .
.      .. .    . .   ..     ..   .  ..   . . .       .... .. .  ....
..        ...  . .    .   . .      .  ..     .  . .   .. .. ...    .
...         .       ..     .   . . ..   .  ... .  .    .   .    .. .
. .   .   .  .  .  .              .     .    ...  .    . .   .     .
. .... . ..   ..  .      .     ..   .  .. .        .    .        . .
.   .. ...   .   .    . .    ...   .    . ..    .    ...   .     ...
. .  .         .        .   . .  .    . . .     .  . .         .   .
. . .  .       . .  ..  ...... . ..  ...X .   .   ... . .      .  ..
.   .   .  ...    ..  ..     .  .      .   . . .  .  .          .. .
...    ..      .   .... .    .  .  . .      . . .    .         . . .
..         .. .. . ..    . .   .   .     .         .   .. ...   .  .
.  .         .        .     .            ....    .      .   .  .   .
.. . .           ..        ..      ..    .   . .    ..           . .
.   .  .  . . . . .  ..      .   ... .... .. .       .  . . .      .
... ..    ... .  .  . .        .  . . ..     .   .      .. ..      .
. ..      ..   . .    .   . .. . ..      . .  . .  .               .
.    .   ..  .   . . .   . .  .   .           .   ..  .    .       .
.  .     ...       . .    . ...  . .     .         .  .    ..   .  .
.   ..   ....  .  .    . .  .   . .  .        .            .   .  ..
.   .    .   .     ....  .  ...   .  .. .. ....     .. .   ..    . .
.. ..      ..    .  .     . . ..  ..   .   .    ..    . .     .  ...
.  .    . .        ...    .     .  .. .      .    .      .   .     .
.       .         ..   . ....  ..    ..     .         . .  .  ... ..
.          . . .    .  .       .    ..   . .    ..   .. .   . .    .
.  . . .   .   .  ..    .. . ..       .   ..  .   . .   ...        .
..         .  .  . .   .  .  ... .. .     .     .         .. . . . .
. ..       ...   .      .  .    . ..  .       . .            ..   ..
. . ..  .        . .  .   .  . .         .  .   ..   ..      ..... .
.  . . .     .  .  .   .   .  . ... .     ..     ..       ..       .
...  .. .    .      . . . ..   .. .   .    .  ..        ...  .. .. .
.    .   . .. ...   . .     .      .  . . .  .     ...  . ..    .  .
.  . .  .   .          ..  ... .    .     .  ... .  .        . .   .
.    ..  .   .        .     .   .   .  .. .    .       . .   ..  . .
..   .   . ...  .    .      .        . . ..  .  .    .   .       . .
..             .   ...   . .. . ...  .      ..     .       .    .  .
. ...    . .    . .   ...     .   . .  .. .   .       .  . .. .  ...
.          . ...   . . .    .   ..     ..  .   ..  .    . .      ...
.  .    ..       ... . .. .     .  ..  .    .   .     .       .  . .
... .  .   .     . .. ..  .      . .     .        .. .   .....  .  .
....................................................................
