.....................................................................
.. .        . .        . ..      .    .  ..    .          ...       .
. .       . .    .    .. .   .    . . .          . ... . . .   .    .
.. ..   .    . ....   .  ..       ..    ..    . . .   . .   .       .
.        ... .  . .      . .  . .     .   .      .  .. .    .  .   ..
....   . .      .         .    .   . .  .... .   ..   .   . .      ..
. ..      .  . .  .  .  .    .. ...  .  ..   .. .   .  .     .  .   .
.     ... ..         .    .. .  ..  .       . . ..  . . . .        ..
.   . .    .       .   .   . ...   . .   .. ..   . .       .      . .
....  .    .   .     .. .  .    ..    .        .. .        .       ..
.   .   .      .     . .  ..    ..     ... .  . .. .  .    .  .     .
..   ... ....    .    .          . .   .    .   .   .  . .     .  ...
.   .    .         .     .      .   .  . ..     .         ..     . ..
...   .  ..               .        .   ..  ...  .. .  .     . .   ...
.    . .    ..     ..      .           .       .   . ..  .  .       .
. .       .      .  .  .          .. .    .     ..  .     . .  ..   .
..  .  .... .     .  ..   ..  ..     . ...... . . .      ...  . . . .
..   .. .  .    ..     .  .  .   . . . . ..... .        .  ..  .    .
.  . .. .  ..           . ..    .   ..       . .     .      . . .   .
. .            ..  . ...      .    .        .   ...  .  ..   . .. . .
.. .   .. .    ....    . . .. .        . .. ..   .     . ..   . ..  .
.     .   .       .    . . .   ...    . . .      . .      .        ..
.       ...   . .  . ...   .   .  .       .. .    .  .  .     ...   .
..          .    ..  .     . .   .. .      .    .   .. .. ..      . .
..   ..       ...      .  . . .  . . .  .   .      .      .    .   ..
.   .    .  .. . .  .  .   .    .      . ...               .     .  .
.   ...             ....      .  .     .   .       .   .  ..   . . ..
.   . .  .  .    ..  . .      . .      .       .    . .   .   .  .  .
.     . . .. .    .     .  ..     .    .    ..       . .         .  .
. .  X. .. . .   .      ..   ...    .    .  .  .. .   ...         . .
... .  .  .    . . . ..   . .   . .  ..         . ...  .     .      .
..      ..      .        .... .  .          .  .  .    . .  .   .   .
. ... .. .   .. .     .   .     .  ...   .. .    . . ..   .   .   . .
.    .  ...... .         . . ...    . ..      . ..   . .        .   .
.. .   . .         .. .   . . ....         .          .    . . ..   .
. ..  . .           ...         .   .  .   . ..      ..   ..        .
.  .   .   .  ..     .   ..   ....    ...     .    .   .   ..  . .  .
.  .. .....   .   .    .    ...     ...  .                        . .
.. .      .    .    .   . . .  .   ...    .     .              .    .
.   .  .. .     ...      ..  . ...        . .    . ..     .   .    ..
. . ..    .  ..  .. . .      .   ...     .. ...       .           . .
.   . .    .      . ..  .   .. .    .  .... . ..       .  ...       .
.             . ...    .     .   . . ..       .    .        ..  r   .
. .  ..    ..    .    ...              ..   ... ..     .  ...   . . .
.   .     .  ....  . .   . .         ..  .  .   ..     ...  .      ..
. .          .    .. .   . . . ..  .     .     .. . .. ..  . . .    .
. .  . ..       ...     . . .   .     .   .       .  .   .          .
.... . ..      .  ...        .  . ..  .. . .....  ..     .       .  .
. ..  .. .  .    . .  .   ..      .          .     ..     .. .      .
..  .   .    .           ... . .. ... .        ..   ..  .     . . . .
. ...  .       .    ..   .   ..  ..    .   .  . ... .    .  .     ...
.. .     ..       .... .... .          ... .   .. .  .  .           .
.  .    ...     . .     .     .     .  ..    . ..       .  .    .. ..
. ..  .         .   .  .       .   .        .    .  .        .      .
.     . . . .     .   .   .... ...      .    .    .  .    .  .   .. .
. .   . .. .   .. ..    . . .    ..      ..     .       ..     ..   .
.. .  .       .        ... .  .   .    ...  . ..    . . . .  .   .. .
..  .     .  .     ...    ..  . . .       .  ...  .           .  .  .
..        . ..      .      ....  .. . ..      .      .  .     ..  . .
... ..                  .       ..   .  . .     .   ..   ...  .   . .
.     .  ...   . ....    ...  ..  . .  .  . ..    .      ..   . .   .
.    .  ... .     .  . ..   ...  .  ...   ...       . .  .     .    .
.... ...  ....   . ......   .            ..   .       ..  .     .  ..
.     .    .. . . ...  .    .. .   .....    ..   ...  .  .. ..      .
..       .  .   ...    .    . .    ..  . . . .          .     .   ...
.    .    ...  . .. .. ..  . ...                    . .. .... .     .
.     .       .  . .    ..  ..     . . .      .  .  .   ..    . .  ..
.   ...  .  .         ..    . .. . .    .  . .  . . .       . .     .
.....................................................................
