......................................................................
..   .   ... .   .  ...        .  ..     .     .. .  . .  .   ..    ..
. . .  .  .   .. .  .    .... .    . ..    .      .    .  .  .  ... ..
.. .     .    .    .  .             . .  ...   .  .   .  .           .
. .      .    .           ..        . .... .  .      .   .      .    .
.   .        .   ....  ..       .      ...  . .      ..  . ..  ..    .
.  . . . ...   ....  . .  . ...   .  .  .    .  ..    ..    .    ... .
...  .  . .    .   .   . ...      .  . .                      .   . ..
..    .   .  ..      .   . ....     ..   .   . .  . .    . .. .     ..
.  .   .. .   ...   . .       . . .  . .   .. .  .       ..         ..
.       ..   . .    .    ..   .      . ..  .    . ...        .....   .
.      ...  .  .  ...   .       .  ..    ... .     .  .. . .       ...
. . .     .  . . .          .  ..     ...  .  .   .       . .   ..   .
. . ..  .       ..  .  ....  .       .    .  . . .        .    ... ...
.  .   . . .   .   .        ..           .  .  . . .   .       .  .  .
...   .  . ..    . ...    . . .  ... .      ... .   .    . .         .
.    ..    .       . . ..   .      .      ..  . .. .   .       . .   .
.  .           .          .    . .  .        .     ..         ..  .. .
.     .. .   .      ..    .  .. ...     ..    .       .  ..        ...
. .              ...  . .    . . ..   .   .   . .       ..  . . .   ..
.   . ..        .   ..  ....    ... .   ...     .   . ..       . . ...
.   .     . . .  .  .  ..  .  .       .     .    .  .  .             .
.    . ...    .    . ..  .  ..   .  .. ..               . .     . .. .
...    .. ..    .  .. .   .   .     . ..      . ..  .  . .  .   .  ...
.. .   .    .  .     ...  .  .  . ...  .  . .  ..  ..   .. .  . .    .
. ..   .   . . ....    .  .   . .   .        .  .  .  .      .  ...  .
.           .  . ..       .     .   .   . .. .  ..    . . . .. .. .  .
.         . .. .. .       ...           .       ..      ..  . .   . ..
. .  . .           .     .        ..  .    .       .   .      . .  . .
..  . .. . . . ..    .  .     ... .     .  . .  .  . . .  ...  .  .  .
. .  .   .       . ..          ..  .      ..  . ..   ...             .
.  ..    .    .   .   .    ..    .  . ...  .          .  .     .  .X..
. . .   .     . .      .        .       .  ..    .       .   ..     ..
.     .   .      . .             .      .  .    ...        . .  ..   .
.   .   .... .   .       . .         .. . .  .  .              .  . ..
.  .. . .  .  .    .  . ..    .   ..  .. .  ....    . ..   . .    . ..
..  .     . .  .   ..    ..    .    . .       .     . ...     ..     .
. .   . ...  . ...    .  ....  .  .  ..    . .      .. .....     ..  .
.   .    . .      .  ..   . .     .   .  . . . . .    . . .      .. ..
.  .  .     .  ..   ..   .. ...   ..         ..   .   .     . . . .. .
..    .     ..   ...      ..    .   ..  .  .    . .     . .  . .  .. .
.    ...  .    .          ..  ..  .  . .. .  . ....        ..     .  .
.  .       .     r                     . .. ...   .. .. .    . ..  ...
.  .    .    ..   . ..      ..  .  .   . .   .  .      .  . .    .   .
.   .  .    .. . .. ....    .    . .   ..      ..   .... .  .  .     .
.          .   .   .  ...  .   .     ... .   .   .         .         .
. .. . .  .      .     .  .. .    . ..   ..      .  ...  .    .  .   .
.         . ...      . . .  . .           .  . . .     . ..       .  .
. .   . ..  ..     .    .  .  ..                ..     .  . ..    .  .
. .  .         .   .  ....       .  ..   . .   . ....       .       ..
.. .    .  .    .  .  ..     .... .    . ...    . .   . ..    ....  ..
.     .     .           .  ..  .....   . .     . .  ..          . .  .
.. .           .        . .... .  .  .  .   . .   .   .....   .      .
...       .    ..    .  . .  ..             .  ..     .   ..   . .   .
.. ...   .  ..   ...        .  .  .          .    .        .  . .   ..
.     .      .    .. . . ..   .     .  .      .      ..  .        .  .
..   .  ..      .  .            ..   ..  ..       . .      .       ...
.  . . .     .   .     .  ..   ... .. ... .          ..         .  . .
.   .. .  .    .      .. .   ..     ....     .. ..  ..  .      ... ...
...  ..  . ....   .  .     .  .     .. .     .  .. .. .   . .   .  . .
.         .   ... . .  ...   . .  . .          .  .. .   ...    . ....
.      .. .  .   . .  ..   .. .            .  ...  ..  .     . ..    .
.  .   . .        . ..  ..    .   ...    ..  .   .  .  ..   .        .
. . . .   .    .  .. .   .  ..   .   .. ..        ... .. ..       .. .
.   . ...  .      .         ..   ..  . ..    .  .    .       .    .  .
...  ..    ..  .  .      .  .    .   . .    .      .         . ..   ..
.  ..     . .        .     ..   . .   ... .. .       .   ..        . .
.   .   . . .  .    .          . .    ..       . .. .    .           .
.     .             . .. .  .  ..  .   . ..    ..   .     .   .     ..
......................................................................
