.......................................................................
.   .        . .     ....     .  .    .    .. ...    . ..      .    . .
.           .. .        .     . ...  .... . .            .  .         .
..... .. . ..          .... ..  .        .  ... .               . ..  .
.    ...  .   ..  .  .    .   .      ... .   ..    .      ...  ..    ..
.        .   .  .  .. ...   .      ..    .      . . .  . .     .  . . .
.      . .         . .         .. .       .   .       ...     ...  .  .
.              .  ..  .  . . . .    .     ..    ....  .. .     .     ..
.  .  .      r. . .  ..         . .  . ... . .    . .        . ... .. .
.     .           . . ..   .. ..   .  ..    ..   .  . .  .    . .   . .
..    ..   .  . .  ..   . . .     ..    .. ..      .....       .   .  .
. .            ..  .   ...   .  .        .  .   .         . .. . .. . .
..     . . ...  . .  .     . .        .  .          ..  .   .   .   . .
.       ... .  . .  .   .   . .  .      ..           .  .   ..       ..
.  .  .  .      ..  .      .        ..  ..   .  .  ..           ..    .
....   ..  . .  ...    . ...  .       .  .. .     . . ...       ... . .
..   .    . .  . .    .    .   .   . .  ... ..  .     .  . . . ..     .
...  ..      . .      . . . . . .   ...    . . .  .    .  .   . .  .  .
. ...   ... .   .   ..       .             .  .  . .  ...    .     .  .
.. ..   .    . .   ..   .  . .. .     .     .       .   . . .   .     .
.     .  . . .  .   .         .   .        .  .     .  .        ...   .
.   .   .   .  ..         .. . .  .    .        . ..  ...  .    .  .. .
...     ..    .       . .           .. .   . . . ...  . . .          ..
.  .      .      . .  .  .    .    .    .  .    .   .  .  .....  .   ..
.  ..  ...   .       .  .  .         .     ..           .....   ..    .
. ..   . ...  . .  ..  .       . . .  .         .  .    .  .  . .  . ..
.  ...   .. .  ...    . ... . ....  .      . ...      . . . .       ...
..    .. . .  . . .  .   ..  .    .   .  .    . . .  .    .     .X .. .
. .   .       .  .. .    . .   .. . .. .... .  .... .      .  .     . .
.     .  .    ....     .....  .        .... ...  ..         .    .    .
..           .    .   .   .    ..  .  .. . ..   .       ..        .   .
.  .     .. .     .  ...     . . .  .   . ..     ..       .    ...  . .
.  ..    . .  .   . .  . ..    .  .           ..         .   .  . .   .
.... .     .    ..  .        ..   . .  .   . .    .  . ..   .....     .
.               .  . .  .       .     .. . ..         .   .. ..  .    .
..  . ..    .     .   .    .     . ...    .. .     .   .  .   .     ...
. .   . .   .     ..  ..  ..      .     ...     .  .. .  ..... . .    .
.   ..     .    .     . ..        .. .     ..     .    ..     ..  . . .
.     ..   . .  . .  ... .    . .. ..        .       ..      . ..    ..
..           .  .  . ..... ..     .        . .  .     .     ..   .  . .
. ..     ...       .     ...   .   . .      ..   .. . ......   . .   ..
. ..   ... .      ...      .. .    .  .      .    .  .        .. .    .
.     .  .    . . ... . .        . . .... .  .     . ..   . .   .   ...
.   .  ..        .   . .. .     . . ..  .  ..  ..   ..      .. . .  ...
.   ..  .   ..    .  . .  .    . .   . .  ..    .  .   .. . .      . ..
.   .. .    .. .  . ..    ..      .   .  .  .   . ...      . .   .    .
.   .      .  ...    . .       ...   . ..      . .      .      .    . .
.  . .  . .    . ...      ...           .   .   . .  .      .  .   .  .
. .  ...   ..    . .     . .   . . . .  .       .   ..   ..    ..  .  .
. . . .   ....        .      .  .          .   .. ...    .    ..  ..  .
.   ...               ..    ..    ...     .     .. ....    ..    . .  .
.      .  . ...      .     .         .    .  . . .  .  . ......       .
..          .    .....       . . . .. .    .    .   .    . ..     .  ..
... ..    .    . .         . . .   .     .  . .          .       . .  .
.     .  .                   .    . .    ..  . .    . .    ..  .   .  .
.. .  .  ...         ..      .     .  . .       ..     .   ..   .     .
.   . . .. .  ..  .   .     .    .    .  .          .    .    .  ...  .
.    .   .     .   .  .   .  .. .      . . .     . .    ..  .        ..
...   .  . .         . . .  . . .     .  ..     ..      .     ..    . .
.   .    .   .   .  ..  ..      ..      .  .        . .  ...      . ...
.   .. .. .   .      .. .   ..     ...  . .       .   .     . . ... . .
.          .  .  .      ..        .  ..   .  ..   .  .  ....... ...   .
.     .   .    . .      .     .         . .   .    ..            . .. .
.  .  .. .   .  .  .        .       .   ..    .      . ..    .     .  .
. .. .      ..   ..  . .                     .  .. ... .. . . .       .
.  .  .    .  .     ....        .    .    ..     . .        ...  .    .
...  .       .. .        .     ..  .    . . .   . . .        . .      .
. .  .          . ......  .   . .  ..    ..     . ..  .  .  . .  . . ..
..   .    .  ...  .. .     ..  .. .     .   . .          .. .    .    .
. .               .  .     .. . .   .  .     .   . .  .    .    .   ...
.......................................................................
