........................................................................
.   ..  ...    .   .      .  ..  ..  .     . .    .. .  .  .    ... .  .
.     . . . ..  .  .      .    .   . .  . .    .. .    .   ..    .    ..
.  ..   ..    .       . .  .. .  ..  . .    .. . .  .  .        .      .
. . . .   ..     .    .. .         .   .  .   ..     ..     ..   ..   ..
.  .    ....               .      .  ..  .      .  .     .    ..      ..
. .  .  . .  .  ..    . .     . ...  . ..          . ..            .   .
.  .      .     . . ..          .. .   ..   ..    ..      .   .. .. .. .
.  .       . ..  .       . . .     ..  . .  ... ..         ..    ..  . .
.                  . .          .   . .      ..      . .    .      .  ..
.     .   ..  .       .   .    . . . .....      . .  X.      .    .   ..
.. .        .  ..  ... .     . . .      .     . .  .       .  .  .     .
.       ..  ..   ...  . . ..  . .    .       ... . .    . ..       . . .
.  .              .. ..      .   . . .  ..    ..  .           ....  . ..
.     .   .  . .     .   ..     .             .       .         . .    .
. . . ...    . .. .    .   .   .    .. ..   .    .  .  .... .  . .  .  .
.    .   .    .  .. .. .... .         .   .  .  ...   .  . .       .  ..
. . .        . .   ..  .      .  ..            .       .        .. ..  .
.      ... . . ...      ..         . ..      ..    . .  .  .    . ... ..
.  . ... . .   . ...     . .       .  .. .     .    . ...          .   .
.  . .  . . .. . .     ...      ..  . ...    ..    .       .  ...  .   .
.  .    .  .   .     .              .        .   .  . .. .    . .  ..  .
.    .. ..  .  . .  .   .  ..     ..      . ... ... . .   .  ..   .    .
. .      .          .  .. .   ..  .           .. ..  ... .  ..         .
.. .    ...  .   .     .    ..   .  .   .  ... . .          .. .       .
.   ..  ..   ..     .   ..  ...   .. .        ..                    ....
..   .  .  .    ....   .           ...  .. .   .     .  .    .   ...   .
.       ..  .      ..   ... .    .    .    .    .. .        .  . .    ..
...            . .   ... .... ..   . .      .         .   ....... .    .
.   ..  ..     .  .     .  . .  .   .. .    . .   ...     .    .    .  .
.  .   .   ..  .      ...    ...      ...       .    .       ..       ..
.  .. .   .   .. . .   .. .    . .    . ..          ...    .  . .. . . .
.    .  .     .  . .   .      .  ..   .  .  . .   .  .  .   .  .. .  ...
.   . .    ..         .   .... .. ..  . . .       .  .    .. .       . .
.    ..    .  .. .    . .      .   .  ......      . . . . .  .       . .
.    .   .     ..        .  . .       .          .          . ... .   ..
..  .         ...  .   .       ..     .  .   . . .   .      .  .    .. .
.   .     .       . ........    .         .     .       .  .   ..      .
. ..  .  .  . ....     ..    ..  ..  . .  . .  ..  .  ..    .  .   .. ..
.       . .  .  .        . .     ...    ..  .   ..  ..      .r   .    ..
...      .     .   . . .. .  ....        . .  ....  ...    .       . . .
.. .        .       .     . ..       . .  .  .    .  . . .   . ..   ....
.  . .     .   .  ..  . .    .  . .   .   . .. .  . .         ...    . .
.  .   .  ...  .   .   ...    .. ....      . ..      . . .      ....   .
. .  .    .  .      .    ...... .   .       .        ..  .          . ..
.. .   .      ..     .   .  ..   ...          ..... ..   .  .    .     .
.  .   .  .         . .      .             ..    . . ..   .       .  . .
.    . .. . .     .          .  . .     ..  ..   .  .    .. . .    . . .
..  ..     .  .    . .  .   .. .    ...   .     .    .   .    .  .     .
.   . . .   . . . .   .   .  .    ..     . .       .. . . . .. .  . .  .
.. .      .   ..      .  .   . .      .    . . .             .       . .
. .    . .  ...   ..  .        . .    .   .      . ..  . . .         ...
.      .  .    .  .     .. ..    ...     ..  .  ..      .      .    . ..
...  . .            ..      .   .          .. . .    ......   ... . .  .
.... .. .  ..    .. ...  .     .  .  . .    . . ...            .    .. .
. ...     .     .      .   .  .                   .  .                 .
.. .    ... .    . .       .    .  .. ...    .    .  . .  ..   .  .  ...
. .    . .     . .       . . .   . . . ... ... ...      .  .    . .  . .
.  .. ..    .    . ..      ..   . .            .. .  ...  ..           .
.  . .          ....   ..       .       ...  .  .  .  .    .   .   .   .
.. .     . .. . .    .  .    . .   ..  ..  ..  . . . ..   .   ..  .. . .
. . .    .            ..  .. ... .  .   .           ..  .  .. . .  .  ..
.   ..    ..  . .. . .      .    .       ..        .    ..             .
.  .   . ..    .            . .   .  ..     ..          .. . .   ..    .
.   ..  .   .  . . .  .   . .  .  .       ...  . .     .   ..  ..  .   .
.   ...   .    ..    . . ...    .    ...      . .   .  .   . .     .   .
. .      . ...  .       . . .   . . . . ...  .  . . .    .  . . .. .   .
..  . . ..        .    .  ..  .  .   .   .   ...    .          .    .. .
.  ....     ..   .  .   .         .  .   .      . .   .  .      .  . ...
.      .    ..   .      .     ... .  . .  . . .       . . . .   ....  ..
...  ..       . ..   .     . . .  .       .. .      .. . .   . .  .    .
........................................................................
