.........................................................................
.  ..  ..   ...    ..   ..   .  ..      .  ...  .. . .... .. . .        .
.      .  .   .  ..   .  . ...  . ..        . .      . ..  . .     .   ..
...  .       .        .. .          . . ...       ...   .. .  ...      ..
..  .     .     . . ..  .  .   .   .   .         .  .  .   .  .    . .  .
.      .        . ..  .  .   . ..   ....    ....           .     ..  .. .
...   . .           ..   .   ..       .   .....      . .    .           .
.   .....  .  .  .      . .  .          .  .    . ...   .  . . .  . .   .
. .  .          .  .   .       .     .      . ..    ...   .. . .. .. ....
. .   ..    .  .   . .  . .    ..   .       .. . ..   .   .   . .  ..   .
..  .     ..    .  .   .. . . .    .  .   .  ..        . .         .   ..
..  .  .    .         . ..    .   .   ..  ..     ..  .  .  . . ..  . .  .
..  ...       .  .    .   ..   ...    ..    . .    .. .   .   . .   .   .
.   ..   .. ...   .. .     . .. . ..  .                 .... ..       . .
.  . ..     ...     ..   .   .. .  .. . .   .     . . .  .           .  .
.     . . ..     .   ...       .          .    . ...  .  .      .. ..   .
..   ..   . .     .   .  .. . .     ..   .   .  .    r..   . .     ... ..
.       . .  .     .  .   .  .           ... .       . .    .  . .   .  .
.  .  . ..    ..     .  . .  ..  ..  .    ..  .  ...  ...     . .   .   .
..           .   . ...    . .   .. .      .  .   .  .  .  .  .. . .. .. .
... .. .. . .. ...       .. .      ..  .. .      ..  ...        ..     ..
. .  . .    .. .   ..  . .   . ..  .. . .   .  ..   .      .  .... ..   .
.         .   ..        .           .      ... . .   . ..    . . ...   ..
.    .       ..  ..... .       .  .          . .            ..   . .  . .
. .. .    .        .. ..    ..   ..    .   ..    .   .   . . .   ..   . .
.             . .        ..   . ...  ..    . .   .. .  .      . .. .... .
..  ..        . ...      ..   .       ..  .         .  .     . ..   . ...
..  ..  .     .   .    .   . .  . . .         .. .    .  ..   .   ..    .
.       .. .  .    .  .  .   ..    .   ...     .       . .. .     .   . .
..       ...   .. . . .   .        .  . . . .               ..  .  . .. .
.       ..         ..  .      .      .. . . .   .      .      ....      .
. .           . .      ..     .. .. ..... .  .......  .  .       ..    ..
..   ..      ..   . .. ..    .       ...  .              .    .. . .  ...
. ..      ..   .    . .   .   . .  ... ...   ..   ..         .. . .    ..
. .  . ..  .  .     . .. .      ..     .. .     ..     ..      .. .  .  .
.   ..   .            .    . .        .       .         .. . . ..       .
..  . . .  . .         ..  ..        . .   .  .       .        .      . .
.   .           .   .  ..    .    .             .      ..       .    .  .
. .    .       .  ... .      . . .  .     . . .. .             .  ...   .
.         .     ......   .   ...  . .  . . ....     .    .  ..       .  .
. ..  .. .    .   . ..     .  . . . .      .  .. . ....      ...    .   .
.   .  ..           . . .      . .  .     . .      ...    ..   .  .     .
.      .  .    . . ...    .       . .. .   .. .   . .         .    .  . .
. .. .        .  ...   .   . .          ..   .     ..   .        ..     .
. ... ..   .    .        .    .  ...     .     .. .       .  ..  ...    .
. ..      .            .   .   . .    . ..    .   .     . .   .      .  .
.  .   .  .     .   ..    . .    .    .  .  . .     .      . ..   . .  ..
..     .  .   . .       .     .    .. .   .          ..X  .  .. ..  .   .
.      . . .        ..      .       ..    . ..  ..  .  .        ...    ..
.. . .. .  . .     ...      ..  . .   .   .    .    .  . ..        ..   .
.  .       .   .   .. .     ...  ..  . .   ..  ...     .          ..    .
.  .     . .   . . .    . . .. .     ...          . ..      .. . .   .  .
..          ..    ..   .    .   . ..     .. .    .. . .    ..  .. ..    .
.. .. ..   .   .    . .     .....    .  .      ..   .   .  ...   .   .  .
..              .   ..      ..   ..      .      .              ..   .   .
. .     . .    ..    ..  ..  ..  ..       ... ..    ......   .    ..   ..
. ..  . . ....   .. .  .      ...   . . .   .     .       .     . .     .
.  .     ..  . . .....         ...     .    .   . .. ..    .       .    .
.     .            ..  ...   .  .   .. ..         .   .  ...   .. . . . .
..   . . .      . ..    . .        .  .. . .. . .  ..    .  . . .  .    .
.   ..    .   . . .. ...   ...        .  .  .     .   ...  ..   . .. . ..
.      ...      . .      .    .  . ..  .   .. .   . .    ..  .  .. . .  .
.      .     .   .     .       .... . . . .   . .. .  .  . . .          .
. .    ...  ...  .       .   . . .  ..     . ...    .       . .     ..  .
. .     .      . .    ...       .       . . ..    .  .. ..       . .    .
.  . .. .. .         ...              ...   .   ..   ..    .  ..  ... . .
.      .   .  .             .   .  ...   .      . ...      .. . . ..    .
. ....   .     .  .        .       ..   . .         .           .   ..  .
.         .. .  .  . .   .    .  . ..       . . .     .              .  .
.  . .    .     . .      .  .    . .   . . .. .  .  .   .        .   .  .
. .   ..  .      .   .  .           ..        . .    .     . . .   . .. .
.    .    .     .  .       . . ..    .  . .    .       ..     .  . .    .
.........................................................................
