..........................................................................
.    . .. . . ...              .  ...        .  . .   .. .  .    .  .   ..
. .  ..  . ..  ..    .    ..    . .  .  .. . . .   . ...     .  .   .   ..
. .     . .    .      .   ..    . .    . . .       ..     .       .. . . .
..      . ..      .        ..   . . .  . . . . .   .. .    .     . .     .
.   .. . ..  .. .     .   . ..    .  ...     . .   . ..   ..   .   .  . ..
. . ...   .     .   .    .  .. .  .   .  ..      . .       ...      ......
.. .. .   . ...  .  .   .        ..   .      .   ..       .  .   ..      .
. ..  . .    .     .    . . .        ..    . ..         .           ..   .
..  ... . .    .     .    .   ..   ..  ..      .  ..  .      .   ..   .  .
... .      .     .     ...      .    . .         .   . . .   .    . ..  ..
.  .   .  . .. . .   .        .  .   .     .      .    .     ..  . . . . .
.  ... ..    .....  ..   .    . . . . .      .  .    .           .  ..   .
.. .     ...      ...  ..  ..    .  .     . .  .    .. .  . . .. .   .   .
... .  . .            .  ..  .. .    .   ...   .  .. .  .   ..    .. .   .
..   . .  .......       .  .  ...   .. .    ..  .           .   ..      ..
.   . . ..  .. .      . .   .  ..  .. .   ..  .  .   .     ..    .   .   .
..   .  .    .. .. .     .       .      ..     .. ..   .    . . .   . .. .
.    .. ..  .  .        . .  .. .    .   ..     .      ...    .   ...  . .
.  ..    ..  . .....  ...    . . .  .  .    .. .         .  .   . ....   .
.  ..   .. ...    .. .    .    .  . . .   . ..   ..       .     .        .
..   .   .     .   .    .. . .       ..    . ..  ..   .   .  .      ..   .
.   .   .  ..  ..  ...      .          .    . ....       . .             .
.. . ...  .    .   .  .    . .   ..    .          .   . .      . ..     ..
. ..       ..   .    .    . .  ..   .             ..      . ... ..     . .
.        .    ..            . .        ..     .    ..    .  .   .     .  .
.. ..     . . .   .  .    .    . ..  .        .   .     .  ..    .   .   .
.      .  . . ...  .           ..    ... .. .      .. .         .  .. .  .
.  .   .   . ..       .. .   .     ..  .  .     .            ..  .   .  ..
.  .         .     .    .       .      .   .   .  ..  . .. .  .     .    .
.  .   ..  .. .   .. . .   ..       . ...     .    .   .   .  ..  .. ..  .
.. .....    .. . .    .   . ..  ......   .      .     .  .  ..      ..   .
.  . .     .     .. . . ... .  .   . ...  ..   . .    .      .    .   .  .
.    .     ..  . ...  .               .  .   ..   .    .  ..             .
. .. .    ...  .  ..       ..   .       .  .         .   .   ..    ..  . .
.   .    ..   ..    .. . . .   . .    ..     ..  . .   . . .. ....  . . ..
. . .. ..     .    . .....   .   ... .  .       .    .  ..  ..     . .   .
. .. .           .   ..             . .    .  ..    .     .   . . .      .
..   . .      . .        . .   .      .    .            .       .. .     .
.  . .  .  .  . ..  .   .. .    .    .    .  . .      .  ...     . .     .
.       ..   . .              ..  .      ...  ...     . .   ...       .. .
..  .  .      . . . .  ..   .   .     .  ..   .. ..    .      .. .    .  .
.   .  ...   .  .      .      .  .       .       . .   .       . .   . ...
.     .   . .   .   .   ...   .    ...     ..     ..  . ..          .    .
..    .      ...      .   . .  .    . . ...              ..     ...     ..
...    .     .  .. .  ...   .    ...      ..   .     .  .         .      .
.  .   ..  .. . . .         .     .  .... .  ..  ...   .      . ..  . .. .
..            .       .          ..   . . .    . ..     .    ..   . .  . .
.    .   .  ..         ..  .  ..   ...  .     . ..     .       ....    ...
. .   . .  .     .....   . .    .           .      .  .   . .     .      .
..      .....     . .    .   .   . .     .    .    . .   . .    ..       .
.        . ...       . ...     .  .  . .  .       ....      . ..     .  ..
... ..   . . .    X..  . ..   .  .  .   ...  .    .. ...  . . .  .     . .
. .   . . ..    .       ..   .       .    . .             .    .    .  . .
.   ..   .   .         .. ..            . . .  .. ..    .       ..  . .  .
. . .  .     ..    .     . .        .  ...  .. .   .      .  .     .     .
.   . ..   . .  ..  . .      ...    . . . .        .   .   .           ...
...  .      .   .         .          .  ..   ...  .   .. .  ....  . .   ..
.... ..  .                      ..    . .  . .       .  ..     .  ..  . ..
.   .      ..  ..  . .. ...   . ..    ..   . ..       .  .   .     .  .  .
...             .  .     .. .   .    . .   .        .  .      .   .      .
.   . .      .   .  ..  .    . ..         .. .  .       .  .     ..      .
. . ..           . . .  ..           . .  .   .  .   .  ..     .   ... . .
. ..    .   . . ..       .. . .     ..       .. .  .  .   ...         . ..
. .        ...   ..  . ..     ..      ..          ..  .  . ..  ..  . .   .
.      . .   ..  .    .. .     ..       .      .    .    ...      ..     .
..  .  ..     ..   .   ..       .   .     .. ...  . . ... .  .   .. .    .
.. . .     . .   .      ..      .  ..  .... ..      .    . . . .  ..     .
. ..   ....      ..      ..     . .     ..      .       .  .. .  ... . . .
. . .  .  .. . ... .   ..   .  .        .           .   .    ...       ...
. .. . .   .          .  ..    .. ..     . ..  .     . . .  .. .     . ...
.   . .. .     .  .  .     ..  . . .   .  .. . .           r.. . .   ..  .
.      .  .    ...            .  .. . .      .         . .   .  . . . .  .
..........................................................................
