...........................................................................
.      .    ..  .    ..  ..  .     .. .   . . .          ... .      . ... .
.             .  ..      ...      ..    .  ..    . .    .  .. .       .   .
.   ... .    . ... .     .    .    .   . .               ..  ..  . .  ..  .
. .    .    .         . ....  .     ..                 .. .   .      . ....
.  .   .         .  . .    .  .. . . .    .   ..  .         .       .     .
.   . .   . ..  . .     . ..       .     ... .      . .  .      ....    . .
.    .. . ..     ....       ..      . . .  .  ....   ...  ..    .   .  ....
. . .    ...  ..   ..   . .. ..      .      .    .  .   .  .     .    .  ..
.. ..      .        .  .   .    ...  .  .   .... ... .   . ... .. .       .
.  .       .        .      .    .        .   .   . .  . .   ...     .  . ..
..    .. .. .  .    . . .  . .      .. .     ..       ... .   . .    ..   .
...   .  .   .        . . .    .   .. . .   .       ..  ... . .     ..  . .
.      ..     .        ..  .  . .  .     .. r.   .   ..     .      . ...  .
.      .        .. . . .    .. .  ..  .           .. .... .       .   .   .
.   . . .    .     ...     . .   .  .   .         ..  .      .  .      ....
.  ..     ..   ..             ..... . . .   .  .       . .    . .     .   .
...  . ....     .        ..   . .  .  ..      .   ...   .. .    .    . . ..
.  .      .  .               .   .  .    .  .  . ...       ... .  . .. .. .
... . .      . .  ...     .     . ..      .    ..      .       .     . . ..
.       ..  .  ..   .  .  .    . ... .. ..     .   .         .     .     ..
.               .  .           .      .   .. .     . .    .  .         . ..
.   .           ...  .    .  .      .          ..        .      .   .. .. .
.      . .     .  .    .    ...  .  .   .   .    . .  ..  . .       .   ...
.               . .. ..      . .    .     ..  .  .. ..    ... .   ....   ..
. .  ..   .. .   .        .       . .    . .             .... . .  .   .  .
. . ... .  .        .. ....   .     .   . .   .   .  ..  .     .     .  . .
.   .   .   .  .. .    .      ..  . ..  ..  . .    .       . . .          .
. .   .  ..   .  . ...  . .  .      .  ..  .  .     .  .  .          .. . .
.   ..    .      ....   ..      .   ..  .   .     .     .   . .  .... .   .
.     ...        ..      . ..    ..     .       ..  .     . ....    .  ....
.  .   .  .. .    .     . .   ..    ... ...    .   .  ....    . .    .    .
.             ....   .   ...   .. .   .    .  .. . . .    ....     .      .
.   .            . .. .. .        .. . .  .      . .  .   .  .   .        .
.     .       .. ..    .. .  .  .      .   .         .    ..   . .    .....
.   .  .   .    . .   ...   .     .   .       .  .  .    .     .      ..  .
. ...  ..     .  ....   .. ..  .      .   .  .     ...   .   ..   .  . . ..
. .    . .   ..    . .. .  ..  . .  ... ..      ..     .   ..    .   .  . .
.                    .     .   .      ..          .. . .     .   . . .  . .
. ..  .  . ....        .  ..    .        .  .          ..  ...   .   . .  .
.            .    ... . .  .   .     .   .     .  .     .     .       .  ..
. .        .  .  . .      .        .      . ..  ....  ... ...  . .    .   .
.          . . .  .     .  ..   .. ..   . .   .  .        .      ..       .
.   ..    ..  ..  .   .       .   .. .       . .   .   .   . .. .  . .. . .
. . .   .     .   . .    .    .      . .. .... .  .  .. .      . ..       .
.. . .    .  .   .                ......  . .   .    . .  .  .. . ..  .   .
. .  .     ..  . .   .     . .    .   .    ...  . .      .  .  .. .  .    .
. . .   . .         . .     .      . ... .      .....   .      . .        .
.      . .        .   ..  .       .     .      ...     .   .  . .   .  .  .
.   X.     . . . . . .      .   . .  .  .  .. .  . .  ..     . .  . .     .
.. ..  .   .    .   . ..  . . . . .   .    ...        .. .  . .         . .
.  . . ... ..   . .  . ..  ... .     .  .       . ..      .    .  .    .. .
.  ..        . ..  .. .      .    .        ..      .   ..       .  . .    .
. .  .  ....   .   .  ..   ..  .  .. ..   .  ..  .    .  ... .           ..
...        . .    .  .       .     ... .   . ....  . .. . .  . . .    . . .
.      . .            .    ...           .         .  .   .  . ... .     ..
.  ..   . .     .   ....   .     . .. ..   .   ..  . .  .   .  .     .    .
..  .  .       ..   .  .              . . .     .  .  . .. .. .. ..    .  .
. ...  .  .       .  . .         .. .  . .    .       .     . . ..     . ..
. . .    . .    .      . ..  ...     ..  .           ...  . .. .     ..  ..
..   .    ..  .       .    .      .  .. .. . . .  .    ...   .  ...  .    .
... ..   .  .    .      .      . ....  .  ..   .    .  .    .            ..
..       .     ..     ..       .. . .. .  ..   .  . .   ..     .      . . .
.   ..      .     .   ...   . .    ..   .. .   .   . ...        . . ..   ..
. . ..       .     .. . .  . .  .     ..  . . . .  .   ..  .     . .    . .
..   .   .     .  ..        .  . .  ... ..    .   .    .  .           .   .
..    .. .       . . ..  . .       . .     .  ... ...   .     .... .      .
. ..  .            ..   .   .     .      .     ... .       .  . . ...     .
.  . .           .   . .. . .... . . .. . .  .    . .  .. .  . . .        .
.          .  .  .    ..  .....  .    ..   .     .  .  . .     ..  .  .  ..
.. .. .           . .      ...    ... .   .   .        .. . ..            .
. . . . ...  .  .    ..   .  . . .   . .  .  .  .    .     .     .  .   ...
..     .   .  .. ..    ...     . .     . ..   .    . .. .  ..      ..  . ..
..    .     ...  .    . .   .    .   .  .    . .   .      . .  . .  .  .. .
...........................................................................
