............................................................................
. .  ... .       .   .  ..        . . . . .  . .  . . .                   ..
.. . .   .    .    .   ..   .  .. ..  .    .    .   ..  .    . .      .   ..
.    . . .  ..                      ...   . .    .    .. ...  ...   .    . .
.    .       ... . .    . ...     ..      ..    . ..          ..  ..   .   .
....  .         ......    . .  .  ...   .    .  ..  .  .        . .    . . .
.   ...   .     . . .  .      ..    ..  .. .         .   .  .  .   .    . ..
.    ...  . . .     .            .  .   . .    .   . ..   ...  . ..   ..   .
..    ...                      .   .   ..    .  ..  .    .  .  ...    .    .
. .    .   ..    .  .       ..  ..  . .  . .     .  .    ...    . .  .    ..
. ..  . . .    ... . .      ..  . .  ...       .  . .        ..  ..  . .   .
.         . . ....      ..       . ...           .   . . .. .      .   .  ..
..  .     ... . ..      .   .        .   . ....  .. .   .    .    ... .  . .
..  . ..           .   .  ..   . . .     . ...            .          .    ..
.                ..   . . . .   . .           . .  .    . . .  ....  ...   .
. .  ..   .  ..      .  ... .    . .  . . .. r. . .                 . .  . .
...    .  . .   .   .   . . .    .   ... .       .  .. . .       .  .. .. ..
.    .     .  .             ..        .  . ...      ...          ...     . .
.    .  .    . ..  .  ...  . ..         .  ... .. ..    .   ...        .   .
.  ..     .      .  .  . .  .. . .. ..    .            ..    ..     .  .   .
.        ... .   .  .   ..   . .     .              ... .. .   ... ..  .  ..
.. . ...   .. ..    .          .     . .       .   .... . . . .    .  ..  ..
.    .        .  .    ..    .   .  .    .  .  .      ....     ... .   ..  ..
..  ..        .  .         .. . . .    . ..   .. .    .    ..  . ...      ..
.   . ..... .   ..  .....  ..  . ... .      .    ...  ..... .    . .   .. ..
... .  .         .  .  .        ..  .                .  ..       ..    ..  .
.      .      .      ..  .  ..  .. .         . .  ..     . ..     .   .   ..
.. ..   .. . .       ... .    ..  .   ...      . ...   ..   ... . .      ...
. .         .     ..   . ....  .   ..       .         . . . .   .    .. .. .
.  .    . ...   ..    . .  .     . .      .  ...    . .. ..    . .    ..  ..
.    .  . .      ..   .  . .      . .       .. .  .           . .    . .. ..
..  . .              .    ... .  .  .  .   . ..    .               . .     .
.  .        .         ..      .  .  .   .    .   . .    . ....      .  ... .
.  . .. ..      .  .   .      . . . .   .      ..  .  .    .      . ..    ..
.   . .  .  .       ...... .    .. ...  . .    .  ..   . .    ..    .     ..
.   ..  .                        . .    ..         .  ..  . . .         . ..
. .  .   ... ..    .    .. .. .   .    .     . ...  ..       ..        ..  .
. .  .. .          .      .  . ..   .    .  .   .   ......   .  . .        .
.  ....      .       .. .....          .    ..  .  . .     ..  . .  ... .. .
.    . .  .  ..   .      . .       .         .. .           ..  .   . .    .
.  ..        .      .. . ..      .   ...  ...      .   .        . . .   .. .
.     ..    X.        ...           ...  .     .  .   ..     . ..       .. .
..   .   ..    ..    ..   .  .. . .  .    . .  .     .      .     ....    ..
..        .     .  .   ...  .. .     .   .      ...   .. .    .. ...       .
.               .  .        .  .  ..   .     .    .     ..  .   ...   ..   .
. .   . . ..           .. .    .  . . . .     ...   .   .   .  . ..   . .  .
.... .   . . .       .   .. . .      .  .. ..   .  . .    .. .        ..  ..
.      . .   .  . ...     ..     .  ... .     .      ..        ..   .    . .
.                 .  .   .. . ..               ...      ..     ....    ..  .
. . ..    .... .        .. .    . ..   .          .         ...   .   . .  .
..  ...  ..   .     .....  .   .      .   .  . ...   .  . .        .....   .
.  .  . .      . .    .         ..    .      ... . .. . .     .    .       .
.   ..    .  .. ..    . . .       .  . .     .  .      .           . .     .
.  .  . ....   .  .  .   .     .  . .  .    .  ....     .  . ...           .
.         .   .         .    . ... .    . ..   ..  .        .       .   .  .
.      .      . ..  . .  .       .    . .   ...      .      . .  .  .     ..
.   .        ...... .. .   . .    ... .      . . ......   . . .    .  ..   .
.    ..   . .    .        ..     .   ..    ..     ...    . . .. .  .  ..   .
.  .. .   .   .    .  ...   . . .     .   .        .. ..       ..     ... ..
.      .       .    . ... . .  .    .    . . .    .    . .. .              .
.. ..   .          .   .. .       .    .  .  . . ..  . .  . ...       . .  .
..  . ..  ..     .       . ..     .    .               . .   ..      .  . ..
.  .      .     .  . . .. ......      .   .   ..        . .       . .  .....
.    .  . .. . .. ..   .  .      . ..    ....       ...  .    ..    ...    .
...       ..     .  .      . .. ..  .   . . .      .     .  .  ... .       .
.  .    .    .. .  . . . . .  ..   .     ..     . . . .  . .     .  .      .
...     .. ..  .. .       ...  .  ..  . .   .        .. . .     .         ..
.   .      .        . .. .         .   .. ..   .  ...    .     .     .  .  .
. . .  . .       .    ... .  .       . .      .          ..   . .  .    . ..
.  ..   .       . .    .           .  . .   .  .. .     ...  ....     ...  .
.        .   .     .  ..   . ..         ..      ...  .           .. .    . .
..          ..  .   .     .      .    .  .. .   .     .   . .  .   . . . . .
.  ..        ...  ... .. .   .     .. ....  .  ..   . .    .           .   .
. .     .   .  .   ....        ...     ..             .           .. . .   .
.     .            .. ..  .     ...      .     .   ...   ..    ..          .
............................................................................
