.............................................................................
..     ..  .. .  .....   . ..           ..      .    .    . .   ..         ..
.  ...          ..      ..     . . .       . . .   .    . ... .  . ..       .
.    ....      .             . ..         .  .   .  . .  .  .   .. .    ..  .
..    ..   .         ..     .       ..  ...  .  .        . .. .  . .    ... .
. ...   .      .       . .  .  ..  ..     .  .. . .  .      ...      .    ...
.  ...    .   .   .   .    ..  ..        .     .          . .     .  .    ...
.   ..   . .    .....    . . .           . ...    .  . . .        . .       .
..   ..   . .          . . .        .  .  .       ....  .   ..       ...    .
. ..         . . .  .  .     .    .       ..    ..  ..    .  ..   . .      ..
. ..    .   . .  ... .  ..      ... . . ...      .       . .     .      .. ..
..       ... . .   . ..    . . .   .     .  .     . .     .     .   .       .
.  .       .       . ...  .. . . . .    .. .   .  .          ..         . . .
.  .     . . . . .  .      . .  ...  .  ...     .        .     .   ..   ..  .
.    .  .  ..   ..      ..       .         .   .  .    . ...  . . ..   ..   .
. . .   . .. ..  ...  . .    . ....   ..           .   .      ..          ...
...        .               .      ...   .         .  .    .  .              .
.   .       .  .          ..  ... .    .    . .      .    ....  .     ..    .
.. .                .  ..   .  ..  .   .  . ..   ..       .. ..   .  .      .
. . .    .    .  .     .  . .  ..  .     . . .       . ..    .         .    .
.   ..    .    .    ..         .   .  .      ...    . .     ..            . .
.......  .   .    ..         . . .  .  .  .     ..       . .. .   .   .   . .
.. .  .  .  .. .    . .   .   ....      .  .   ...    .        .. . .  .   ..
..   . .  .     . ...       .         .      .              .  . .         ..
.    .  .   .     .    .  .   .. ..  .   .. . . .     ..  .  .. ......      .
. .  .  ..    ..  .  .                . .      ..    ....     . .   . . ..  .
...    . . ....   .      ..   .     .        .     . .    .  ..   .. ..   . .
. . .  . . .        . .        .    ..    ...    .   . . .  .   .         . .
.   .    .  .   .           . .  .  .      .  ..   ..   .      . .   .  .. ..
.  .    ..     .. .    . ..    .      .    . .          . .     . .. .. .  ..
..  . .  .  ..  . ....     ..  ..        ....    . ..    .    . .        ....
.   ...  .  ..     .    .  . .     .          . ..   ..  .. ..  .  .....  ...
.      .    ...  .              .. ...  . ...      ..   ...        . .. .   .
..    .  . ... .        .    .   ..   .   .  .    ....  . . .    .  .    .  .
. .    .   .  .  .... . . .   ..  .         .       .  . ..  .      ...    ..
.  .. . .  ..                      ...   .. .  .. . .   .          . . . .  .
.  ..     .         . ..        ... .   .  . .  . ... .    .   .   . . .    .
. ..   . .. . ..   .  .      .       .   ..    .      ..      .. . ..      ..
. . .   .    .          .. ..  .        .    .        ..  .       ...    .. .
. . ..      .      . ..     . ..        ..   .  .     .      .   ..  .. . . .
. ..     .    .  .   .   ..   ...             .    .         .   ...  .  .. .
..  ..        .. .      ... .      .  . ..             .  .  ..   .       r..
.  .      .   ..   . ...   ..         .        .      .    ..  . .. .   .   .
.      . .  . ..  ..   .    .  ..          ..  .      . .  .    .  .        .
.       .   . .  . ..  .    .     .  ..   .  . . .  ...  . . ..  .  ..      .
.    .... .. ...   .   ..    . . ..  .                .. . .   .  . .   .   .
. . .   .   .. .  .  .  .    ...     .   .     .         . .  .    .  .     .
.  . . .     .. .      .   .      . ..   .    .    ...  . .            . . ..
. . .    . . .....        . .  . . ...   ..  .     ..  .         .  ..  ..  .
.      .        .. . ..      .    . .   . ..      . .    .. .. .   . .      .
..   .. ..                   ..  ...  ..              .   .  .  .     . .  ..
....  .  ...    .  .   .  .  .. .      .   ..  .  ..   . .     ..  . . .. . .
.      ..  ..  ....      . . .  . .    . ..  ..       . .      . .    .    ..
...     . . .      . X     .  . ..    ... .       ..  .. . . .   .      .   .
.. .  .   .    .   ..   . .    .    ..   . .   . .    .       . ..      .   .
. . . .....  . . . .  . .           .   .       .   ...      ..  .     ..   .
. .      ..     . .  .  .      . .     .    .  .     .       .   . .   .    .
.                  ....   .     .  ....   . ....  .    ..     . .  .   .    .
.    . .. .       . . .         .   . .        .   .      ...  . . . . ..  ..
.   ...     .   .  ....   .       .  ..  . ... .  .    .  .  ..          .  .
...    ..    . .  .      .  ..    .    ..  .     .. .  ...  .      .  .     .
.  . .. .  . . . .    .        ..   .       .  .    ..   . .  .  .  .   . . .
.   .       ... ..     . ..   . ..    .  ... .    .  ...    . .      ...   ..
. ..  ..   .  ..  ...        . .    ..   .  . . .  .   ..  .  .    . ...  ...
. ...  ..  ..   . ... .     ... .     ...     ..     .  .    ...  ...       .
.  ..         . .  .   .  . . . .     . ... .   .                ..     .   .
.   .   .. . .       .  . .  .   .  ..   . . .  ... .   .   .  ..      ..   .
.  .....                 .  .  ..   .. .  ..      . . .. .. .   ...         .
.  ..     ...       .  . .. .     . . .       . . . . .. ..       .         .
.       ..  .      .. .    .   .. .    .        ..  ..       .        ..  . .
..  .         .    .    .... ..   ..   .    . .  . .  .... .             . ..
.... .   .                   . ....  . . .  . .   . .   . . .    .   .   .. .
. . .       ... . .  ..... .     .   .      .      .    .  .     . . .. .   .
. . ..    ..  ... ..  . .    ..   .   . .  .....     ..               .   . .
..    ... .  ...   ..  .    .    ..  .                ..    .  .       . .. .
.   ..   .   ..  ..  .      .  .    ..  . .  .   .. ..   . .. . ...    .    .
.............................................................................
