..............................................................................
. ......    .  ..    .    ....  . .  .  .    .    .     .     .  .    .  . . .
.        .   ...  . .     .    ..    .  .. ..      . .    .    ..   .    .  ..
.  .   ..   . . ..     ...             .              ..         .       .. ..
..   . . . .     .    .      ..   . . .  .  .       .  .   .  .... .. ..    ..
.    . ..   ...  .. .       ....  ..    .  . ..  .. .      .  . ... .    .   .
. ..  .....       .  ..   .  ... . . .     .  .     ....   .    ..    .   . ..
.    .. . . .    ...       . .    . .       . .  .   .     .  .       .    . .
.  .   .   ... .  .... .   .      .. . .    .         .        ..  ....  .  ..
.. ... .  ..     . .            . .. .      .     ..  ... . .   . . .  .     .
. . .         ..           . ..     .   . .  ..  . . .  .  .. . ..   .   ..  .
.    .        . .   .   ..    ....     ..  .. . .         . ..  .      . .  ..
..       . .    . . .         ..  .     . ..    .    .      .            .   .
.. . .  .     ..  .   . . .. . .     .  .     .      ..    .. .    ..      . .
..     .. ... . .     . .     .   .   .    ....     ..    .  ..     .        .
. .  ...  ..  . ..  .  ... .     .. .      .        .      .          .  .   .
... .    .  .   ...     . . ..   ...  . .     ...   . .       .   . ..  .  . .
. .      .     ..   ....   ... .      . .   .      .   .  .     . .  ... ... .
.  .. . .   . .    .             .  .. . ..  .   .     ..     .  .  ...      .
.          .           .  .. . .     .    .. . . .   . .  ..   . . .      .. .
.    ... . . .     .    ..    .   .           ..     .      .     .        . .
.   .   . .    .  .   .. .   . .    .       .. .     .   .. .. ..  .   . . ...
.     ..   ..  .    ....   .  .    .   .   .     .  .   ..  . . .    . .   . .
... ..  .   ..  .. . . .            .         .. . .  ..       .  . ..    .  .
..  .   .   .      ..   . .   .          .  ..  .     .  .     .   ...    . ..
.       .  ..      .           .  ..  ..   . .     . .    . ....     .       .
.            . .        ....     .  .. .      .     .  .       .  ....       .
.  ..        .     .. .  .  ....      .       ..  .  .  .      ..      .  . ..
.      ..      .  .   .          ..          ..                   .       .  .
... ...         . .     .  .   ...     . .    . .  . .  .   .    .     .     .
...   .     .                   .  .  . .  . ..    .     .    ..  . .  .  .. .
..  .  .       ..  .      .         .    . .     .    .  .  .       .   .    .
. . ..   .  ..... . .  .   ..       ..    .  . .. ....   ..    .  .  .   .   .
..  ...    .   .   .. .   .  ..  ..   .  .... .  .    ... .  . .. . ...      .
.  ... . .   .   . ...    .        .     ... .         .    . .    ..       ..
.  .   .   .  ..   .        ..  .  ..                  . .. .  .   .         .
.   .  .  .    ...     .  . .     . .   .. .  . .  .           ...    .  .   .
.    ... . . ...   .     .. . .    . .  . . .      ..   .  .        .        .
.. ..   .. .  .        ...... ...        .       .       .      ...   . ..   .
.   .      .    . . .     .   ..  . .   .   X .     . .    .  ...      ..    .
...          ..  . .      . .      .    .    ..   .  .    .. ... .    ..     .
.  .   ... .    ...  .. .  ..  .   ..  ..    .    . . .   .  .  .  ...   .   .
.  . .       . . .  .     .    ..     . .          . . .  ..                 .
.  . . .   .    ... .  .   . . . ... ..  . .        ..      .   .        .  ..
.   .           .  ..   ..    ..    ..        ..       .    .    . .  .. ... .
..        .      .   .  .    .   .      . .. ..         .   .. ..       .. ...
. ..  . .    . .  . . .. .     ...  ..  .. .   .  .    .    . .    .   .     .
.     .         .     .  .    .      ..         . .  . .  . . . .   .  .  .. .
. ..     ...     .  .  . .      . . ..  . . .  ..          .. . .       .   ..
.     ..  .               .          .    . .   . . .     ..        . . .    .
.   . .. .     . .... .  ...      .     .   .       ..   .   .    ..     . . .
. .  . .  .         .    .   .       .     .  ...        .  . ..  .    .. . ..
..          .  . ... ... .  .   ..    . .  . . .  .  .     .            .  . .
...    .          .   . ...    ...... .   .  ..    . ...   .. .  .. . . .... .
.. . ... .    ... ...  .        .  .    . ..   ...   .          .  .     .  ..
. . .  . . ..   .  .    .   . .  .  .   .  ..    .     . .  .  ..  ..        .
. .    . ...            ..     . .     .   .     . . .   .  .. . .     .     .
. . ..  ..   .   ......  ..  .. .  .  . .     . .  .   .     . .    . .   .. .
.   .   . .  . .  .   .... .        .       .    .          . ...   .   .  ...
.      ..     ... .. .    .    .      . .   ..     . .    .     .   .     .  .
.    ..  .. . .      .. ..   . .      .      ..  .   ....      ..       . .. .
.    .   .        . ...      .   ...    .    ..   .        ..  .   .    .    .
. .         ...  ....        ....     .   ..   .... .   ..      .   .        .
.  . ...     ..     .....        .       . .  ..          .   ....  .  .     .
.   .    . .      .    ..     .  .    .  .         .    ..   .  ... .  .  .  .
.  .         ..    ....   . .  .....   .    . .          .. ..    .   .    . .
. .    .    ...     .r .... ..     .    .                       ..    .      .
. .   ..   . . .           ..... . .. . . .   .   ...  . .         . ..      .
.   .       .   .      .         ..  .    .   ..    . ...   .     .. .  ..   .
. ..   .  .   .....    .     .       .   .   .   .   ..     .    . . ..   . ..
.   .     ..     ... . ..  ..... .... .   .       . .           .      ..   ..
. . .  .  .    .    .   .  ...  .   ..  .      ..   .      . .   .. ...  ..  .
. .     .  ..   . ..        .  .      .   .  ..   .     . .              ..  .
.  ... .   .  . ..  . ..   ..     .        .    . . . .   .  .         .    ..
.    ..  .    . .         .    .   ..       .       .. .. . . .  .  .  .     .
.    .  .        . .. .. .     ... .. ..  .  ..  .      .      . .     ....  .
.  .  . .    .  .   ..       . . ...   . ......        ...   .   .... . . .  .
..............................................................................
