...............................................................................
.  .   . .    .  . . .. .... .   .   ....  ..  ...  . . .   .      .        ...
.  . .    .    .   . .       . .    .    ..  .    .  .       .   .     .....  .
..    . .     .   ..            .   .         . .... ..   .    .       .  .   .
. . .    .   .   .  ...    .           .      . .     .     ..   .    .. . .. .
.   .       .   .   .  . .   .  ..        ..    .     .    .   ..   .         .
. ..   .    . .   .   .      .       ... .  .  .  .   .   . . .  . ..    ..   .
..     ..   .        .. .  .      . ..   .. .... .   ..      ...     ..  ..   .
..  . ..    . ... .       .. .  . .. .        .        .  ..  .   ..  .. . ....
. ...  .. .    ..    .  .    .   ..   . .  .  ... ..    ...  . .     .      ...
...       .           . .  .           .. .   .   .   ..   .   .        ..   ..
.  .   ..                        .... . ...  . .   . ..    .   ...            .
.  . .           . ..      .     . . ...    .      . . .  .       ... .      ..
.      .    ..  .     .    .    . .  .    ..   .    .. ... . .      .    .    .
.  ..      .      . ..  . ....   . . .   ...    ....  . .   . .   . .  . .    .
.   .  .      . ..     . .   . ...  .  .. .  .    .. .   .       .  .. . ..  ..
.. . .    . .  ...  .  ..    .  ...   . .. . .  . .       ... . . ..   ..  . ..
.   .    . .. .   .    .  .  ..   .          ... .   .  ......   .   . ...    .
.  ..         .  .           .  .  .    .    .. ..        .   . . . ..  ..   ..
.           ..        .      .. .   ..            .. .   .     .  .      ..   .
.       .    . .         .         .    .     ..       .  ..  . . .    .     ..
..  . .  . .  .     .    . ..     .. .... .      . . .  .      . .        ..  .
.. .....               .       .   .. .   ..  ...     .    ... .   . .....    .
. .         . .     . .. .     .  .      .   ....   .         ..  . . ... .   .
.. .. . .     .      .     .      . .       .     .  .  .   .  .   ..  .  .   .
.  . .  . . ..   .  .   ...   .          .   .      ..         .     .     . ..
. .     .  . . ..  . .  .   .     .     .    .    .    .. .             ... . .
. .  ..      .    ..  .    .      .  ... ..   .. . ..     .    .     .  .     .
. . .      .       .           .                .       .      .   . ..  ... ..
. .   .  . . ..  .     . .  . .  .  ..  ..   .    . .. .  ..    .    .   ..   .
. .   .    ..   .            .    .  .   . .    . .        .       .   .   .. .
. ...        .  .. .  ....  .   . . .   .  .   . .... ..  .  .    ..       . ..
.      .      ..  .       .   .     .....      .    .   .  .. .   .    .   . ..
.      .  . ..   .      .    ...    .. .    ..   ..        ...     . .     .. .
..  ..  . . .            .          ..  .  .  .      .    ...   .     .  ..   .
...  ... .     ..       .   .     . . .. .   ...   . .    ...  .      ...... ..
.   . .      ..  ..  .  . . . .              ...     ..      .    .. .   .    .
.  ..   ..                    .. .     .   .   .   .          .    . ..  . .  .
.   .   ..  .  .X  ..     .. .      . .    . .     .     ..         .     . . .
.   .. .    .               .... .  .    ..     .      .      . .  .   .. .   .
.. . .   . ...    .         .    ... .. .. .          .. .. .  .  .      .    .
....     .      .       . ..            ....  . .. .      . . .       . .  .. .
..   ..      ..         .   .            .. ..    . .  .       .   ..  ..     .
.  ..       . ... . ..  .. .     ....      .  ..  . ..      .  . ..    .. .   .
. .      . ..  ..   .   ...  .  . .       .      .  . ..    ...      .. .     .
.   .. .     .    .   .  . . .    .. .     .   ..     . ..             . ......
..       ..    . .   .  . .  ... .  .. .. ..   .  . ..  .  .  . . .. ..   .  ..
.    ..   . ...             . ..  .    ...  . .    .  . ..     ..     .       .
..   .     .   ...  ..  ..     .     ...  ..       . . . ..  ..     .    ..   .
... . .    .  .    .  .  .. . .      .   .  ..                 .      .   ..  .
. .    .   .. . .      ..   .  .     .   ..   .      .     .   .  .           .
. ..    . . . ...      .     . .  .. .. ....            .  .    .  .  .  .    .
.     .   .   .  .        . . ..    .  . .     .     .     . .       ..       .
.. .    .    ...       .. ..     . .....  .    . . .       .  .. ..    .    ...
..   .  .. .    ...   ...  ..    .. ..  .    ..  .             . .    .. ... ..
...   . . .     .  .. . .   ......  ..         . .  ... ..  .   .    . . ..   .
.    .   .   .   .    .   . .  . . ..     .    ...     .     .    ..  .    . ..
. ..   ..  .       . . . .    .  .     .     . ... .     . ..   ....     .  . .
. .    ..     . .    ..  .       .  . .  . .    .           . .    ...        .
.     . . .  . .  .     .... .  .  . .  ....       ..        .  . . .       ...
.        .           .   .       ...          ..  .   ..  . .       .      . ..
.       ..         . .          .     . ...     . ..... .    .   .      ...   .
. .  .       ..      .   .  .    .  .. .  ..  ..       .. . . .       . . .   .
.  . . .      ..  ..      .   .  . .     ..  . .   ..   .     . . . . .  .    .
. .   .    . .      ... .     . .   . .  .    . ..      ..    . ..   . . ..   .
... .  .. .  .. . ..  . .             .   .  .  . . . . .     .    .. . ..   ..
.  . .   .  .  .r          . . .       .  .  .       ..       .  .        .   .
. .  ..   .     ...  . . .     . .      .       .  .. .. .  .   .     .  ..   .
.        ..  .    . .. ... ...            .   .  . ..    ..       .           .
.   .     ..  .   .  .   . . .   ...   .    ..    . .      .  . .  ...  .. .  .
. .    .   .    .    ..   .       .   .... . . .   .   ..    .      ... ..  . .
.    .  . .  . .   . ..       . .        ..    . .  ..   .                ..  .
.. . .. .    ... . ..   .  . .    ..      . .   . .        . .   .. ..  .     .
.     .     .   . .   .                 . .. .   .. ...  ..          ....     .
.        .    .   ..   ...  .   ..   .   .. ..      ... . .        .    .     .
...       .  . . .  . ....        .  .   .       ..  .  .... .               ..
. .  ...  ..  ...  .  ... .             ..     .  . .  .   ...           ..   .
..         ....    .      ..     . . .     ...   ... .       ..  ..           .
...............................................................................
