................................................................................
.  .   .    ..   .   .   . . .    .           ..               .     . . .   . .
. .   .    .... . . .... .      ..  . .  .    .    .. . .       .  .     ..  . .
.   ... ..   .      ..        . ..    . .  . . . ...  . .   .     .  .   .   . .
.    .   ..              .   .   .  . .       .. ..  .     ..                . .
..  .  .. ...  .. .    .. ..       .  ...      .  ..  .. ..     ...   ... .   ..
...  ..     ..     ..   .           .            ... .  .   .  . .. ..    .   ..
..      .          .. ......  ..      .     . .       .. .. .   . . .  . . ..  .
.  .    .    .       .    .   ..   ..  .        .      ..  .  . .  . .    .   ..
.        ..  .   .  ..  ....   ...  . . . .     . .    . ..      . ..     .... .
. .        . . .  .. . .     ..  .     .. . ..        . .  .  .     .          .
. ..       .  ..          ..  .       .    .      .   . ..  .  .        ... .  .
.   .   .  ...       .        ....  . ...   .  ...... ....     ...  .  . .   ...
.  ..    .          .   .   ..     .    .  .  .. .  .  .. .   .    ..     .    .
..  .      .   .   .   . ...     . .... . ..     ..   .   . .      .    .  ..  .
.   ..   ..         .      .  .       ..    .     . .. ..  .      .   . .   .. .
. . .  .  . ...   . .         .     ... .  .. .. ...  ..  .    .. .        . . .
... . .    . . . . .  .                 .   .  .                  .  .     .   .
.. .. .   .   .   ..    ..    . .  . ..      . .  .. .  ..  ....    .          .
... .   .    .        .   .        . .     ..   . .  .    . ....  ..         . .
...    .  ..   .  . ..       .. .   ..  .. .    .   .  ...  .         .  .  .  .
.   ..   ..    ..  ..    .  .    .   .     .. .    .   .  . .  . .   .    .  ...
.. .  ..  .   .      ..           . .          .    ..   .        . ... .  ... .
.  . .      .    .  .   .                   .       .   .  ..   .  .    . . .  .
.  .   .      .  ..   ..        . . ..  .... .  .             .  .    . ...  . .
.   . .. . .. ..  .  .  .               . ..  .    . .      .     .. ... ..  . .
.     .            . .     .    .    . .  . ... ..      ...      ... .    .    .
.  .        .   . .  .   ..         .. .      . .  . ..   .. .   . r  ..  .    .
.  .. .         ..  ..     .   ..   ...   .   ..  .    . . . .. .          .   .
..  . . .      .    .    ... .   .  .    .    . .... .. .. .     ..  .  .  .   .
. .         . .  ...    ..     .... ..   . .  .   .  .  .     .     .          .
. ...   .     .     . . . .. ..   . .    ..      .      .  .  ...    .         .
.   ...          . ...         .. .. ..   . ..      .   . .              .  .. .
.         . ..          .     . . .   . ..  . .  .   .             . . . .   . .
.       .               . . ....       . .   .   .. ..  ..    ..  .. . . . .   .
.  .  . ..       .  .. .    ..  ...  ....      ...      . .            ..    ...
. . .. ..        ... ...  .  .           . ..      ..         . .    ..  .     .
..    .  .  .    ..    . .          ...      ..       .          .  .   ..     .
.  .   .   .     .  .   .       .     .     .     .  .. .     .  .    .   ..  ..
.. ..    . . .   ....   .  .  . ..   .   .     .      . .  ..   .    ..  .    ..
.. ..        .     .  .        .      .    . .   .      .     ..  .  .  .    ...
..   ..    ..   ..   .    .. .      .... ...   ..    .. . ...  .      .   .... .
. .   .       .   .  .  ...    .   ..   .   ..      .. ..  .. .  .      ..   . .
.    ..   .    .    .. .     ..     ..     .      .. . .   .      .   .  .  .  .
.  . .        .       .   ..    . ..    .          .. ... .           .    ..  .
...  . ..    .    .. .     .. .  .   . .        .         .        .        .. .
.    .       .. .  .  ..  .   .. .            . . .       .   .     .          .
. .. .     .. ..   ..  .   .    ..         .  .    . .   .       ...    . .  . .
. ....      ..   .....    .  .   . .    ... .. . .       .  .     .     ..  ....
. .  .   .   .           ....  .  .       .         .  ..  ..  .           ... .
.  . ..  ..      .     ..    ....    .   .    . .     . .  .  .... . .   .    ..
. .   ...    .  .     .. X   ..  .   .  .  ..   ..... ..        ...  .  . .    .
.   .         ..       ...      . .  .    .  .    . .  ..    ...   .   . .     .
..  . .          ..     .           ..     .           .      .                .
.         .   . .     .    .     .  .        . .     .   . .. . .  .. ..       .
....   .  ... ..      . .      ..      .. .       .               .   .... ..  .
.    . . . . .  .  ..  . ..       ...  ..  . .  .  .    .. .         .. .      .
. ...   .. .  ..  .. .  ..    . . . .  ..     ...  .  .  .  .  ...  .    .     .
. . .   .   . .  .  .  .  .. .               .  . . ..   ...            .  ..  .
.       ....   .               ....     . .... . . .   . .  .  .. . .  . . .   .
.            . ... . . .        .    .       .       .. .   . . .  .   . ...   .
...     .  .  .   . ..           ...      . .  ... ..    .    .. .    . ..     .
.   .        .   .  .      .   .    ..  . ..  ..  . .. . .  . ...  . .    .  . .
.    .      .   ...       .     .   . .. .. .    . .  .     . ..    .    ..    .
.  .    ..   .  ..  . . .  .   .. . .          ..  . .  . . .    .   .    ...  .
.  .        .   .  ...     .                 ..        ..    .   .   ..... ..  .
.    . ...    .        .   .  .  ...    .   .   . . .     ... .        .   ..  .
.    .               ..    . . ... . .  .    . .  .       .       .     ...... .
...  .    . .   .    .  . .               . .. .  .    ..   ...  .       ..    .
...  ...  ..   ..   .. . .        .         . . . .. .. ..      ....     . . ...
.     .  ..     . . .     . .    .      ...    .   . . .      .  .. ..     .  ..
.  . . . .   ..   .  ..   .   .  ..... .    .   . . .   . .       .   .. . .. ..
... . . .    .        .. .        .  .    . .   .    ..   ..   ..     .      . .
..  ..   .        .        .   .. .  ..     .  ..     .   . .        .   ..   ..
..  .... .         .  . .        .  . ..      .. .  .    .     .  .    ..     ..
.    ..    .   .. ..   . .     . .      ..     .   . ..                 ... .  .
..... .   .     .  . .        . .  ..    . .  . .   . .     .  .   .   . . . . .
.          ...   . .              ... . ...    . ..  .  . .     .         ..   .
...  .  .  .   .  .   ..  . . .   .       .  .   .   .     ..       . .  . . ...
................................................................................
