.................................................................................
..  .. ...  .   .        .. . .  .  .   ...  . ...                    .  .  . . .
.     .  .. .    .....      .. .   .        .  . . ..    .   ...      .    .   ..
..                . ..   ...      . .          .  .      . ....... ....         .
.  .  .. .    ..  .  .  .  .  .   .  . ...       . .        .     . .  ... . .  .
...  .    ...     . .   .  . . .. . . .    .  . ..    .   . .. .      ....     ..
.. ..  ..      .  . .        .     .        ..      .     .  ... ..   ..   .    .
.   .   . ..           ..              . ... .   . ....           .  .  .    .  .
.   .  .   ..     ..                             . .  .     . .   . ...  ...    .
..      .   ..  .   .    .  ..     .     ...       .           ..  . . ..  .  . .
.  .       .     .     .     .     . ..   .            .   ..  ..  .   .r.  .....
.     . .  .      . .       .      . . ....  ..   .       .        .   .    ... .
.  ..        .    .   .      .    . . .   .     ..   . .        .  .  .      .. .
. .     .       .     .       . ..  .  .     .  .. .           .   .    . . . ...
..  .    .   ...       .    . .      ..... .    .  .   ... .....    .   .  .    .
..   ..     . .. .   .  .. .. ..   . .... ..          . .      .  . . . .  ...  .
. .       . ... .. ..  .    .  .    .  . .         ..   .  .  .  .    .         .
.       ..    . .           .   . ..   .     .      .    .   .. .  .  .    . .. .
.         . ...     . ... ... .. ..          ..   . .. . . .  .  . ..   ..   .  .
.     .     . .. .    ...   . ..        ..   . . .   ...    ..     .      . .   .
.    ...  .    .             . .  .    . .. .        . ...     . .   .        . .
...  .    ..   ..      . ..   .   .  . .   .   ..  ..    .    .   ....          .
... . ...   .    .  . .  .. . ...  ...    ... ......   . .  .    . .       .. . .
.    .         .        ..     .      .  .  ... .     .      .      . ...    .  .
.    . .   . . .  . .             .  .           .  ..   .  .    ..  .  ..   ....
. .    .   ..         .  .. .    . .       ..  .      .  .   .      .       ... .
. ..  .   .   ..  . ..       .   .  .     .    ..       . ..  .. .  . .   .     .
.  .  .   . .  . .   .     ..     .. ..    ....      . . ..      .  .    . .. . .
.  .      .          .    .. .  .        .  . . .   .    ... . .    . ... .  . ..
. ...  .       . . .    .    . ...       .  .    .  .   .           . ....    ...
.....  .   .  ..                .    ....   ..   ..    .    .  .   ..  .  .  .. .
. .. .   .          ..   .        .     .      ..  .     .    .        . .  .   .
.             ..     .       .   .   .. .    .     ..  . ... .      .  .    . . .
..    .   ..         .   .  ....   .  ..   .      .      ..      .    .     .   .
...  . ..    ... ....    .     .. ..     ..    .  . ...       ..  .. .   .  .  ..
. . ... .    .    . .   .  .     .  .  .  .   ..    . .  . ..  .  . .        .  .
..    . ..     ....      . .   . .           .  .. .  .  ..           .. .. .   .
. .. . ..        ..   ..   .            .           .  ..  ..       ..       .. .
. .    .. . . ....... ..  . . ..   .    .   .           .. . .        .    .   ..
. . .. ..      .   .  .  .    . .     .       .   .  . .   .         ..     . . .
.  ..  .        .    . .       .. .     . . . .   ..  .    .. ... . ..  .       .
.   . . .     .           .        .  .         .        .. .    . . .         ..
.  ..  ... ...   .    .      .      .   .    ...   . . ..  .   .  .  ..     . . .
.  . . . .      .  . ..  ..        ..  .               .... .  .  ... . .. .. . .
. . ..   . .  .   ..    .         .  .    ....      .     ..     . ..    .     ..
.     .       ..  . ..      .        .   ..        ..  ..    ...  . .        .  .
.  . .     . .  ..  .  ..   .      ...     ..    .   .  .  .  .    .  .      .  .
.   .        ..   .      . . .   .....    .. .          .   . .    .. .      .  .
.    .      .. . ..  .   .. ..   . ..      .    .          ....       .    .    .
.  .. .  . . .  .   . .  .  .       .   . ... ..   ..    . .      . . . ..  .   .
. .     .   .      .   ..     .      .     ... .    .. ..   .  .    .   .       .
. ...   . .     .  ..  ..  .  . .     .. .. ..   . ..  .  .   .. .. . .     .....
.     .. . .  . .      .  .             .  .. .     .. . .   .     . .  .   .   .
.  .         .      .  . .  . .              .   .           . .. ...     .    ..
. ..   .  .. ..       . .       .. ... .   .   .. ..                 . . .. . . .
. . . .      .  .  ...  .  ..  .      .   . .   . .   .   .. .  ...    .    ..  .
.   ..   .        ...     .      . . ..        ..   .     . .    ..         . ...
.    .  ..   .. ... ..    ..   .              ..  .      ..      .....  ...  . ..
...     ..      .  ..  . .    . .      .  .   .  .  ..   .    . .       .   ..  .
.  .     .   .  ...  ..   ..   .      . .  .  .       .. .  .    ..    ...      .
. .                 .. ..        . .    . .   ... ..  . ....    .  . . .  ..  ...
. .  .   ..  .    .   ...    . .     .       ..  .         . .. .   .    .      .
.  . ...       .    .     ..  .    . . .              .. ... .  .     ..        .
... .. ..   ...   . .  .  ....    ..  .       . .   .  .. .  .    .         .   .
.         . .. .     . ..   .    .   .   .. .    .       .       .    .      . ..
. . ..     .  .. .. ..    .   .. ... . .  .  . .     .              .. . ..  .  .
.    . . ...      . .      ..          . ...             .                 ...  .
. .    .          ..  .    ..       .      . ..     ..           . .           ..
.  ...      .   ..  .      . .    .  .  . .  . .   .    . ....        . . ..  . .
.. ..   .     .   .   ..  ... .  .. .  . . .  .   .        .  .  ..  .  . .  .  .
. ..     ....  .    . .   ...  ..  ..     .          .  .    .     . . . .     ..
. ..... ...   .       . .    .....    .    .    . .     ..    .    . ..       . .
.     .     .  .  . ..  .      .    . ..      .  ..     . .    .     . .X .  .  .
.. .    .   .       .  .   . .       . ...      .     ..   . . .  ..    .. .    .
.  .  .  .  .     .      ..    ..   .... .   .  .  .. .   . .   . . ..  .       .
.       . ..      ..        .    .     .... . ..     ..    .  .  .. . .   ... . .
. .. ... . .     .        .      .      ..       .  .      ..     ....   ..     .
.......  ..  .     .. ..  .  .  . .   .    .   .      .  ..  .             . . ..
. .    .       .    ..     .  ..... .... .  .. .     . .         .        .  .  .
. ...  .  ... .  . ..     ..             ..        ..  .  .   . . .       . . ...
.................................................................................
