..................................................................................
..  .   . .     .    ..  . .   ..   .      ....    .  .    .  . .    ..     ..   .
.    .    . .  .  ...   .    .   .      .     ...    .  .      ..  .           . .
. ...     .  ..  .    .     ..     .. .  ... ..  ... .           . .. . . .     ..
. .   .  . .     .. .      ..     ..   . .     .  . .  .     .. ..   .  . .  . . .
.     .  . .    .        ..  .   .. ..   ....     ... .      .    .   . ..    ....
. . .    .      .  . .  .  .  ..   .. .      .     . ..  .       ... .. .. .   ...
...... ...  . . .      ..     ... .   ... .  .   ..     .   .   . .   .  ...  ....
.    .     ... .  . .  .      . .   .    .  ...    .. . .        .   .    ..   . .
..   ..  ..     .   . .     .  .   .      . .       .   .           .   .. . . . .
... .   .. ..       .  ..     . .  .. ..   . .  .  .            .       .   . . ..
. .  .    .    . . .  .  .    . ..  ..  .   .    .    .   . . .  .  .     . .    .
.          .           .     .    . ..  ...   .       .   . . . .     . .  .     .
.   ...  ..        . . .  .  .   .      .  .    .  .   ...  .  .    ..   .   .   .
.. .       ..        ..  . ...  ..  .  .    . .  . ...  .  . ..        ... .  .  .
..  ..    .          .  .            . ...   ..       .   .   .. . ..    ...     .
.     .. . .     .    . . ..   .   ..      .  ...  ....      ...  . ....     .  ..
...  .  .    ..      ....            .         .     .  .. .         .  . .   .  .
. . .. .. .. .     .  .....    .  ..  .. ....r      .   . .  . .     ....  ..... .
..   .. .                 .     .   .  .  ..      .     .   . . . .    ..     . ..
. .       ..  .  .   .       .     ....     .  .    ..   . .    .  .  . . ...    .
.        .   . .      .  .         . . .      ..    .           . .            ...
.    . ..         .     .    .... .    .        .   ..   .        . .    .  .    .
.    .  .        .  .  .    .   .. .        .  ..      ..           .  .   .  .. .
. .   .     ..   .   . .      .  .  .  ..    ..         . ..    .    .. .    .. ..
.    .     .      .         . ..  .     .   ..   .  .      .  .   .   . .. .   . .
.....  ..  ..     .      ..  .   .   .  .    .    .    .    .  . .  . ...    .   .
.        . .. . ..       . .  .  .  ...    ..  .. .  .... . .        . .         .
. . . .      . ...    . ..   ..   .. ..  .   ..  ..  .     . .      . . . . ... ..
.    ... . .. .     . . ..  .  . .    ..  . .. ...   .     .   . . . ..... .     .
. ..     ..     .  .   .      .    . .      .. . .  .    .  .   .       .      . .
. .    .   ... ...      .  .     .     . .    .   ..              ... .. ..    . .
.  . .  .  .      .   . ...     .  .          .            ... . .... .  .     . .
.    .   ..  . . .      .  .. .  ..  .  ..   .  .  . .  .  .   .. .         .  . .
.  .   .  . .   ... . .       .  .. .       .  .         .. .. .  .      .  .  . .
..  ..     ..        .            .   .    ..     .           . .  .   . . .   . .
.   .     .  .   .  ..  ...     ....     ...   ...  .  .   .   .    .         .  .
.. .  ..        .   .   ..   ..    ..   .     . .     .    .  .     . .. .  . . ..
.   .     .  . .... . .    .     . . .      ....   . .   .     . .  .  .        ..
.   .   .   .  ..  .   .            .          ..          .  .     ...          .
.. . ..  .   . ..  ...    . .    .    ..          .       .   .           . .    .
.   . . .   .     .  .   . ..    . .     .     .   .  ...  ..  .    .   ..       .
.   .  .      ..    .     .           . .      .  .      .     .  .      .   .   .
...  .  .   .   . .     .   .    ...   .            . . .. ..   . .  . .     ..  .
.    ..     .   . .     ..   ..  . . .     .  .        . ...... . .  .  .     .  .
.     .. ...    .. .   .. .  ...        .      ..       . .      . . . .   .    ..
.  . .   .       . .   . .  .          .         .   ..       ...  .  ..    .   ..
.    .      .. .  .   .    ... . .... . . .         .. ..       .    . . .     . .
.  ...      .      ..           . . .  . ....  ..    .      ... .     . .    .  ..
.  .               ... .. ..  .   ..  .  ..         .    ..    .     .. ..  . .  .
.        .    .  . . .   .  .  . .. . . ..  ..      .  .          .  ....       ..
.  ..      . ..   .    .  .     .              ..       .       .      .  . ...  .
..     .      .   ... . .   .  .    . ..  .   .      . .   .  . . .   ..   .     .
.   .         .   ...       .     .. . ... . . .     . . . ......  ... .   .  .. .
.      . .       ..  . . .          . .   . . ... .    .     . .  . . .  . .     .
.  .   ..    .   .      .....   .               .... ..     .. ....  .   .. ...  .
.  . ..  ..   ... .   ....  . .     .     ...   .  .   ..              . .  . .. .
...  ..   ..  .  ... ..  . .        .      .  .         .   .           ... . .  .
.  .. .  .      .   .     .      .   ..  ...  ..       . . .  .         ..  . .  .
. .       .   .   .   . .   .     .           . ..  . .  ....    .   . . .   ..  .
.     ..  .  .. .   . .  .. .       . .        .            .  .   .   . . .  . ..
.  .  ... .  . .. . .        ...  ..  .     ..       ...    .     . .. .  .     ..
.   . . .    .    . .  .. .     .   .. .        . . ..  ..     .  ..      .   .  .
.        .. .    .     .        ..       ..  ..  .         .  .    . ..     .  ...
..   ....        .        .   ...   .. .   .      . . .  .  .      ..   .       ..
.    . .. .           .     .      ..  .... .      ..  .  ..   ..             . ..
.     .  .  .    ..     .       ..      .       ..  .    .    . .         . .   ..
.. ....         .   ....    .  .  ..   .. . .   .  .    . .   .  . .  ..  ...   ..
.  .  ..   . .   .  . .    .    .   .   .   .   . .  . .  . ....        .....   ..
.  ..   .    .  .. . .  . .     .           . .   . .   . . .   . . . .       ....
.. ..      . .     . .       ...   .   . . .   . . ..  .  . .    .  ..   ..      .
.   .   .   .    ..  .  .   . . ..       . .    . ..    . .  . ..     . .. .  .. .
..  . .     .  .  .       .         .  ..  . ..    .        ... .    .       .   .
. . ..    ..    .        .  .               .  .   .. .   .    .          ..   . .
..        X..  . .  .  .      . ...   . ..  .    . ..    .  . .   .  .   .       .
.     ..      . .  .  . . . .   .      .....  .      ..      .  .    . .      . ..
. .. .  .  .      . .. .         .    .   ..  . . . .      .. .   .  . .   .   ...
...      .       . .    .  .    . . ..    ..       ..    .     .    .      .   . .
..  ..         .   . ..      .   .     ..     . ..    ....    . . . .. .      .. .
....  .     ..  .. . .  .  .     .          .    .    . . ..  . .   .            .
.  .    . .          .. . .   .       ..  .     .  .    . .  .     ..  ...   .   .
..................................................................................
