...................................................................................
..  .   .       .     ....     .....     . .  .  . ..      ...   . . ..   . . .   .
.        . . .  ..  .. .       .  .         .. . .  . .    .    .      .   ..  .  .
... .     .     .   .     .     .. ...   .. ..   .    . .. . .  .  ..     . .   ...
..   ..  . ..    .    ...     . .           .           ..  .. . . ...   .     ....
.          .      .       ..   ..          .....   .. .  .    .   .           ... .
.   .                     .    .      .  .   . .    .  . . . .    ..       . .. . .
.      .. .  .. .   . ..   ...  .                .  .     ...        .    .. . .. .
.     . . ..  .        .         . .    .  .     .  ...    .    ...  .     .. .  ..
.       .    .    ..      .. .     ..         ..    .   ..   . . .  ..  .     . . .
..     .       ..  .  .   ..     ..   . .   ..    .      .   .    . .     .   .   .
.     ..    . . ..      . .  .   ..    .  . ...  .    . ..     ..           .  .. .
.. .       .      .   ..           . . . .      . .     .  . . .    .  ..     . . .
.   .    . .      . . . .             . . ..  . .  .      .  .  ... .... .  .......
.    ..   .      .  .  . .   ..               .     .  ..    .         ...  .     .
. .    .. . .  .     ..         . .     . ..           . .        .  ..     .. . ..
. .  ..   ..      ..     .    .....    ..  . .  . ..   .  .    . .   ...... . .  ..
. ...     ..  ... .    ..        .          ..  .... ...    ..          .        ..
.      .  ..   .     ... .   .     .          .  ..  .         .. .   . .    . .  .
.     .     . .   ..   ... .      . ..     . .       .. . .   .            .    ...
. ..       . ..     . . .          .   . ..  .    .  . .   .  .     .       . .. ..
..     .         .       ..  .    . .. . . . ...           ..        .. .     .   .
.      . .  .    .  . ..  ...  .. .  .       . ..    .  .  . ..  . .  . .   .     .
. .  .    . . .      . ..   .     ....           .      .  .   ..  ..  ..        ..
.. .  ....   . .. . .. . ... .  ..    .    . .  .     ..  . ..    .. .      .    ..
.   .. .      . . .       .   .  .. . . .. . .   ...  ..  .   .   . .  .   ..  .  .
.      . . . .    .    . .    . .. ..       .   . .    ..   .           .   .     .
.. . ..        ..  .  .....  ...    .    ..   .               .  .  .        ...  .
.. .  .. .    .  ...         .          ..        ..        . ..     .  .         .
. .   . .    .    .    . . ..    .    .. .  .      .. ..   .    .      . ...      .
.          .       ..    . .  . .  .    .  ..       .  . .  . . .   .  .  .   .   .
.   .    .. .   . .   .    .     .    .      .        .        . .  . .  ..     . .
.  .    . .             .  .    ..   . .  .    .  .       .          ..  .   ...  .
. ..     .                    .  . .              ....         .           .   .. .
... .     .  .  .       .   .        .    .   .  .  .  .        . ...      .  .   .
. .. .      ..     .      .    ..   .  .    .  .   .   .      . .       ..      . .
.          ..... .   ..  .     .    .  .    .  .. .. . . . ... .  ...    ..  . .. .
.....   ..   .    .  .  .   .     .  ..... .. . .    ...     .   . . ..  .   . . ..
.. . ..     .   .     ..   .    ..      . . . .    ..        . ....      .      . .
. .   ..             .      ..   . ..  .  ...  ....    . ..  .  .   ...  .   .    .
.    .  .  ..   .  .          ....  ..   ..   ..       ..   .      .  ..   .  .   .
.     . . .  .      .   .   ..      .       .     .. ...  .  .   .      .   . . . .
.     ...    .     . . .  ...      ..    . .    .     .. .      ..          . .  ..
.. . .  ....    .     .     .                .  . ..   . . .     ....    .    .   .
...   ..  ..  .. .  ... . . .        . .  . .  ..  .    . .... ... . ..  . .     ..
.       . .        .         .       ...     .  .  .    .   ...    .        .  .  .
.  .  .    .  .. .  . .. . .   .      ..    ..       ..   ..   .  . .  ..  .      .
...  ..  . ..            ..  ..     .  .   .   .         .  .  .    ..  ...   . . .
.  .    ..      ....   ..   .  .  .         . .   . .   ....   . .  .   ...   . . .
..     .   .  .    ...              . .    ..      . .     . .     .. . . . .   . .
..   .  .  . .  . .   ..        .  .  .     .   ..      ... ..       .  .      .  .
.   ..       .    .....  . ....    . .  .       .       .          .         ..   .
.   .    . . .   .   . .  .   ..    ..     .        ...  .   ..  .  .   ....  .   .
. .        ...  .         .  .. . .. . ..    .  .  .   .  .   ...       .      .  .
.   ..       .   ...  ... .  .   .  . ..  ..       . . .  .     .  ...      .    ..
..      .   .   ... . ...  .    .  . .           .       .   .   .  . .    .   . ..
. ..  ...  ....   ..     . .  ...   . .   .   .   ..       .  ..   .      . .  . ..
... .     .   .    .            .  .    .  . .. .   ..     .  ..  ..    .. .X   . .
. .   . .. .           . .   . .. .    .       .         ..       .  .  ..     .  .
.        .  . . .     .  . . . .   .   ..  ...      . .       .  .  .  . . .....  .
.  ..     ..       .         .      .   . .  . .     . ... . ...   . .  . . . ..  .
. . .   . .. .  . .   .      .. .   .   . .    .. .       .  . .      .  ..       .
.  ..  . .    .  ... .. .    .       . ...    . . .... .  . .. .     .     . .   ..
. .  .. .. ..   . . . . .         ..  .  . ..  ..  . .          .       . ..   . ..
. . .       .      .    .. .  ..  .     .     .      ..  .. ..  ..  ..            .
.  . .   .  . . ..  .       . . .  .  . ..  .. ..       .   . ..    ...  . ..    ..
. . . ..    .   ...     . .         .    ..      .    .      .   ..  . .  .     . .
..         ..    . .. .      ..  .   .     . .   .  .    .    .  .  ..   .    .   .
..    . .. .  .   . .. ....       .    . . . . ..     .            ...  . ..    ...
....   . .  .       .. .  .   .  .  .   .    .  ..     ..  .     .   ...    .  . ..
. .  .  . .  .   r..      .   ..        ..  .    ..    .    .   ..     . .     . ..
.    . .    ..      .      . ...   .   .    .  .    .    .  . . .      . . .   . ..
.   .   ..    .. . . .. . . .   .          .      .. ....    .. . . ...  .  .    ..
. .  .  .      ..       .....   .   ...          ..         . .     ...   .     . .
.      .           . . ..        . ....       .. . . .          .. .   .  ..      .
..     .   . ... .  .   .      .         .     .  .  ....     .                 . .
... . .      . .     . . .     ..    .    ... .   .   .   .. ....     . . .  . ....
.. ..         .   . .. . . .  . .   .     .    .        . .     .      .     .    .
.    . ...     .. . .  .   . .... ...  ..   .  ..    . ..  .  .  . ..        .    .
.               . .     .  . ..         ..     .  .  ..    .    .  . .   .        .
.  .     .        .   .    .. .   .. . ... . . .     . .   .  ... .  . . ..       .
.   ..   .  ..    ...  ..  .   ..  . .      .   . ..       .       . . .  ..    ...
...................................................................................
