....................................................................................
.... .    .    .       ... .       . ....  .  .     . ..   .        .  ..      .   .
.      .   .      .       .   ...   . . .. . .     .. ...  ..    ..  .  .          .
.  .        ..     .      .    . ...      ..    ... . .. ..  .     .  ..  .  .    ..
.  .    .. .    . .    . . ..       ..  .    ...    ...     . .      .. . ...  .. ..
.. .. .  .     ......    .   ..      .       .        .  .   .    ..   .  . .. . . .
.     .        ...    ..      .  .   .         ...    .   .. ..  ..    . ...   .   .
.   .  .    .    ..       .           .   . ..    .... . .  . .      . .   .  . .  .
. . .    . .   ..   .      .   . .    . .. ..      ..     .    .     .  .. .    ....
..   . .        ..    .. .    .         .  .... ..   ..    ...      .  .   .. ..   .
. .     ..      ..   .  .         ... .    .     ..     . . .    . .    ...      . .
. .   .         .  .. .  . .  .     .  .    . . .    ... ..      . ..    ..   ..   .
..   ..  .. .  ...          .  . .    ..  .  .      ..   .    .  .  .    .  ..  .  .
. .      .  . .   .   .   . .   .. .   .     .    .  ..     .        .. ..   .    ..
. .    ..     .   .  .      .   .    .          ...            . . ..           .  .
... .   ... . .    . .        . ...   ..  .  .       .      .  ... .   .       .   .
.. .      .  . .  ..  ... .  .    . . .   . .     .   . ... . .      .       .     .
..        .r  .  ..  . .      .  .      ..  . . .      .   . .  . . . .     .    ...
.. .. .   ..   . .       .        .      .          ..            . .    ..  .  . ..
..  . . ..       .   . ..   .. .  .  ..  ..         . . . .   .. ..  .    .    ..  .
..  .       . ..   . .. .....    ..   .     .   ... .  .   .   .     .  .. .. .    .
.... .      .   .. .    .    ...      .. ..      ..    .   . .    . .   . ..  .  . .
. .. . .  ..  .  .   . . . .    . .    .  ..    . ..   .       . . .    .       .. .
.   .  . .  .. .  .               .   .   .        ..  ..   . . .   .  . ..  .   ...
.    . .   .      .  .  . . .     . .     .    . ..  ..  . . ....  .  .  .   .   . .
.. .. .       .       .      ..    .     . . . ... . ..   ..    .    ..  .  ..   ...
..                .           .     .         .   . ..   .       .            . .  .
.     .       ..    .    .    .   .. .  . . .  .        .. .   .    ..    . .   . ..
.  .  ..     .  ...   .. .   .    .   .   ..    . .           .   . ..   . .       .
. .     ..           .     . .   . .            ..      ..    ....   .    .  ...  ..
.   ..         .   .. .. .   . .        .    .  . . ..   .    . .   ..   . . ..  . .
. .    .   .    .           .       .  ..  . .   .  .   ...  .....    .   .   .   ..
. .        ..     ..   . ...  .   . .    ..   .  . .    .   .  .  .    .  . .   ....
.. .   .        ...  ..       .  ..        .          ... .      .    .   ..   .  ..
..  ..  . .       ..  .       .... . . .            ..  .  .   ...  .    .  .   .  .
.  . . .   ...   ..  . .   .   ...        .      .  .   .  ..   .   . . .    . .   .
.       . .     .            . .. .. .    .  .   ... .  .  ....   . .  . .. . .. . .
.      ..     .    . .    .        .   . ..   .      ...  . ..  .. ..   . . .   . ..
. ..   .. .  .. ...    .    .    . .   ...  .         . . ..                   .   .
..             .. .   ..           .    .              ..           .   .    .. .  .
.   . ..    .. . . .       ..     .   .. . . ..  ..  .  .  .  . . .     .   .  .  ..
. ..   ..          .      .   .        .  . ...     ..    ...    ..      .   . . ...
.                 ....   . . ...  .. . .  ..  ..  .    . . ..  .    .  .       .   .
..       .   .  .  . .    .  . .  .     .   . .  .            ..    .     .     . ..
..    . ...  ..  .     . . .   .    . ...   .. .  .    . ... . .       .      . .  .
. .      . .  .    ..      .  .      .    ..                        ... .  . .  ....
.    .  ...  . .... .  .    .. ..   ....  ..     . .. ..   ..    ..     .       .. .
.. .      .       . ...   .     .                   .          .  .  ...         ...
.                 ...    . .    .. ..   .. .         ..      . .   . .    .... ..  .
..   ..   . ...  .     .     .      .      .      .  .   ....                      .
. .. . ..       .... .    .    .. .   .    .  . . .    .  .     . ....  .     . .  .
. . .. . ..  .   .         .. .   .  . . . . .  .  .  .  .  . . .         . .    . .
..   .  .    .        .      . .   .. ..    .  ..   ..         . .   . .    .      .
.    ..    .        .    .   ....  .. .   .  .    .  .   .  .  .  .  . .. .. .    ..
....  .  .  .              ..      . ... .   . .  . ...     .    .  ... ..  .      .
... .     ..     ..  .            .    . .         ....           .    .   .   .   .
. . . .    .   .... .. .  . .  .        .     .      . ... . .  . .  .  .  .. ..   .
.  .  .    .  ..              .  .       .  .    . .  ..      .    .   . .   .     .
.   .     ..    . .  . .  ..   . .  .   . . .   . ... .   . . ..     . .    . .    .
. .    ..  . .  .      ...... ..  .  . .  . .  ..      .  .           .   .   .    .
. . ..   .       ..  . .. . ..     .    ..    .      .   .      .  . .. .  .  . .  .
...    . .    .. .  . .   ..    . .   .           . . ...   ..   .        .  .   ...
.  .  .  . . .       .   .        .       . .   .         ...    . . . .   .  .  . .
.. .    .  .     .         . .   .     .          .  .. .   ... . . .  ....       ..
.. .   . . .  . .        ..  .   .      ..  ..  .  .  .  ..  .      ..   .     ... .
. .        ..       .    .. .  ..  . .   .    .  . .   .  ... .         . . .   ....
.   .      . .    ..   .              .   .          . .. .. .          .  .   .   .
..  .   ..  .   ..  . . .  .  ..        X      .   ...  ...    ..    .  .      .   .
. ..   ...        .        .        .. ..  . .. .  . .   .  . .. ..     . ..  ..   .
. .          .  .      ....    .     ..     .    . . .  .    ...        .          .
.       .   .  ..   . .  .  .   .  .   ..   .. . .         . . ....  . .   . .. .  .
.                             . .  .. .     .. .    . .   .     . .    ..       .  .
.  . ..      . . . .  .    .    .     ..    .          ..     .  .    .      .  .  .
.        .    .   ..    . .   .    .. .   . .    . . ..    . ..        .   .  .    .
.      .   .      . ..  .   . .  . .         ...  . .   .  . . .  .. .   .  ..    ..
.        ..   . . . .       ...      . .  .    ..        ..   ..    .    .   ..  . .
. .  . .   ...     . ...   .  ...  ..  .   . .     . ... .   . .  . .  .  .     .. .
.  ..  ..   .   .  ...   ....  .  . .       .    . ..   .  . ..    . ....  ..     ..
..  .. .. . .  .      ... ...   ...    . ..         .  ..    .     . ....       . ..
.. ....       .. . .... .       ..   .   .. . . .    ..           .  .    .   .    .
.  . .    .         . . .  ..  .  .        .. ...          .      .    ...  .. ..  .
.     ..      ...   ... . .    . .   ...     .  .   . .     .    .  .    ..        .
.   ..  .. ..           .  ...      ..   .   .  ..               .    .        .  ..
....................................................................................
