.....................................................................................
. .  .  .   ..  .   .. .        .     .       .  ..   .   . .   .   ...   .   .   . .
.    .. .     .. .. .  .     .  ..       .    .    .      ...   . .              .  .
.          .         . . .      ..       . ...  ....  ..   .    .  .   .  . .   .   .
.  ... .  .   .    .                       .      . . .     . .. . ..     . .. .  . .
..   .. .     ..     ..  . ..   . . ...    .   .    ...   . .   ..      .           .
.  .              ... .. ..          . .       ..    ....       ... .     ... .  .. .
... . .  . . ..        .  . .        .. .  .. . ..     ...     ..  .    .    ..     .
.   .. . .  .     . ..  .  .  .  .       . .   .  .. .  . ...    .        .         .
. . .   .   .      .    ..  .    .     ..... .   .   .   ..  .          ..    ...   .
.. . .     . ..   .              .    .   . .  .   .        .      . .     . .    ...
.     .  ..  ..              .      .      . .            . .     ...   .    . .   ..
.     ...   .    ...  . .      .         .    ..  . .. . .   .... .  ..   .     .. ..
...    .    .   .       ...    . .   .  .. .  ...        .    .. .    ... ..     . ..
.     ... ..      .. ..   .. .   .. ..  .  . ..   .. .  .. .    . .. ..  ..         .
.      ..     .     .      . . .  .   . .  .    . ..        . ..   .. .    .   .. . .
. . . . .    ..  .   ..    .    .    ..  . .  .   . .  .     .         .            .
. .    ..     ..    ..          . .      .  ....     ....  .   ..   .  .    ...     .
.. .           .    . ..  .   . .. .   .            .. ..  .. .      .  .  .   .  ...
.. .         . .         ....      .       . ..     .  .. . .. . . ...        . .. ..
.   .   . .. .          ..   .      . . . .      ...       .  .     .  . .     .    .
. ..   ..  .      .       ..     .        ..     .      ...  .   ...  .  .  ..     ..
...     .. .         .   . .   . ..  . .     ... ..           . .    ...            .
. ...  ... . . ... .  .   .      .       .  ..   .  .  .     .    .. . ..   ..    . .
.  .  .        . . .  . .    .   .     . .   .... .... .      . .  .       .  . .   .
.       .              .        .  .. .  .     .. .  .  .  ... .  .  .   .          .
.  . ..      .. .... .. .    ..  . . .  r . . .  .   ...  .   .  .      .     .   . .
.    ..     ... .      .     .        .  . . .  ...     .... . . ..           .. .  .
...  .   .   .   ..   ...           .    .  .     .   .  .    . . .    ..   .      ..
..  .  ...     .   ..    .  .       ...     ..  .. . ..       .   .         . .  .  .
.       .  .  .....  .       .. . .  .          . .  .          ... .      .        .
. ..  . ..     .        ..      . .. . ..       .   .  ..  ..    . .   .  . ..      .
.  . . .   ..  . . .     .  .  .      ..  .      .         .  . ..  . .   .  .   .. .
.    .  .   ..       .       ..     .. .  . ..      .   ..      .  .             .. .
. .     ..   .    .    ..   . . .  .      .. . ....   .      . .   .  . ... .  . . ..
...     .     .     .. ..     .     .    . . .   .    ..  ...   .  .. ....  .       .
...   .. .  ..     ..      .    ..      .      .   ...   ..  .  . ..    .   ..  .....
..           .. . .  .  .   ..   .      .     ...   .  .. .. .                 .   ..
..   .. .     .   ..       .. . .  .   . .   ..        .    ..    ..     . .      ...
.      .....  ..  .  .   . .   .  . ..    .   ..  . .    ..         ..   . . ...  . .
. . ...              . ..   ...      .   .. .      ...   .   .    ..  ..  .    .    .
..    . .  .  .... ..  .  .. .     ...    . .     ..  .  .. . . .     . ..  .      ..
..   ....   ..  ..  .    .     .   .     . ..     . ... ...  .  .    .. .  .      ...
..   ......         . .   ..    ..         .. .   . .   . .. .     ..  .  .   . .   .
...     . ...  ..  ..   .      .  ..   . .  . . ..  .   .   . ..     .    . .  .   ..
. ..     . .  .   .  ..    .     .     .      ..  ..   . ..  ..  .   .          .   .
..           . .      .    .    .  ..       ...   . . .  ... .. ..  ..   .. .. .    .
.    ....    ..  .. .   .       .  ..     .     .. .  .. .        . .     .  .  ..  .
.   ..  .      . .      .. .            ... . .    ..     .     .  .   .   ....   ...
..     .     .    ... .  .   . . .       .. .  ...... .    . ..  . ..  . ... .  ..  .
.     ...    ......        ... ..    . ...   . .  ... . ..  .           .  .      ...
. . ..     .    .   .  . .   .     ..   ..   .   ...     .   ..... . .        .     .
.   .   ..   ....       ..   .    . ..      .              .   . ..   .      ..  .  .
.....             .      . ..  .   .         ..    .  .   .. ..  .    .   .      .  .
. .    .      .   .     . ..       ...... .... ....   . .        .       .          .
.. ..   ...  .      .   . .      ..            .. .     . . . . .    .. .    .   . ..
.          ..    ..   .   ... . . ..     .     .       .   .   .  .     ..    . . . .
.        .   .. ...     . .   .    ..  ... .  .   . .      . .      .  . .  ..  ... .
.  .. .      .. .           .    ..           .  .     . . ..  . . ..           . ...
... ......   . .    .    ..  .  .       .  .     .      .. . . ..    .      .  .   ..
. ..  .  ...   ...   ..            . .             .      ..    .     .   .  . .  ...
.      ......    ..        . ...  .       .. . .   .    .     .  .. ..    .  . .    .
.... ..   .       .. .                   ..        . .  .  .     .    .          .  .
.  .        .  .            .   . .     ..        ..    ... .    . ..    ...     .  .
.          ....     .  .     ...    . .    ..       .. .   .   . .  .  .    ... . ...
. .     .          . ..  ...  . .   ..   .  .. . ..   ..   .. .  .. .  . .  .   .....
. ....  ..   .         . . . .   .     .  ..   ...  ..      .  .     .    . .  ..  ..
.      .        .    .  . . .    .. .     .    ..     . ..  ...       . . ..    ..  .
.  .  .  ..      .     .  .  . .       .X  .  . ..     . . .     .    .     .    . ..
.    .    .      .  . . .   ..   .    ..      .     . .      ...  .    .. .... .. . .
.     .             .   ...   .    ..           ...               . .            .  .
.     ..  ..  . . . .. ..         . .   .       .  . .  . ..  . .        .       .. .
. .    . ...  .     .   ..  ..        .. ..      .   .      .       .  ..  ...    ...
. .   .           ..  .  ..         .  .   . .... .... .    . .   .  .      ..    . .
.  .        .  . . .     ..   . .    ...      .. ..     .. .     .  . .. .. .    .  .
.   .. ..  .     .   .      .      .  .  .. . .            . .         .    .    .  .
.    ..         . .     .  ...        .     . .       .    ..       .. ..  .   .... .
.    .. .. ..        .   . .  .           .    .  .      .  .      .  ..  .  .      .
.. . .   .             .    .      ...   . . ....  . . . .   ..    .       .. .     .
.   . ..    ..      .        ......        . ..  .           .. . .. .      . . . ...
. ...      ..  .        .    ..             . .      . .    .  ..  .  . .     ..  ...
..     .   . . .    .               .  .  ... . . .  ..                        ..   .
. . .  .        .     ..       .        .  .     .     .    . .        .. .   . .   .
.  ..         .    .       .. .  .     .   .                   .  . . ..   .   .    .
.....................................................................................
