......................................................................................
.      .  .   .   .  .  .   .       .  ..      . .  . .. .    .     .. ...    .  .   .
..  . ..  .  .   .   .  ... .   ..   .    .. .  .     . .    .. ..        .  .       .
.... .    .   .  . .    .    . .   . . ...    ..       .   . .   . . .        .  . . .
.  .   .   .. . . .     . . .  .   . ..    .          .   ..    ..   .    .    ..    .
.. .   .   .  .    . ...  .      .. .   ..  .  . . ..          ....  ..   .. . . .  ..
. ..             . .     .    .     . .  ....    .  . .  .       .....    .  .    . ..
.      ..       . .    .  .  ... .     . .  .      ..           ..   ... .    ..   . .
. .    . . ...  ..  . . ..  ...  ..     . .. .....   ... .   .  ..        ..   .... ..
.      .  .      .. .   .  .          ..   . ..      ..     .       .        . .    ..
.   .   ..      .  ..     .        .    .        .  .  .  . .    . .  .    . .    . ..
. . ..         ..       ..     .  .r     .    .  ....   ..     ..            . .    ..
.. . . .           .  . ..   ..     . .  .    .   .  ..    .  .  ....    .    .  .   .
..     . .   .    .   .        .     .  .   ..  .     .           ..    ...    .  . ..
.      ..  .      .   .  ..  .  . ..     .    .      .  .  .. .. .      ..... . .    .
....         .  .   .    . ..               ..   . ..  .. ..    . ..            .  . .
.   .   .   .   . ..    ...    ..  .    ..  . . ..   .. .. .         ..         . .  .
. .       .            .     ... .   .     .   .  .. ..      .      .. .             .
. . ...  .   . .  .. . .   .. ...   . .    ...    ... ..  .    ..   . .        .     .
.   . ..  .         .   .   .      .  . .  .  .     . .    .      .                 ..
.  . .. ....   ..  ...   ....  .. .  .. . .  ..     .       ..     ... .  . ...      .
.      ... .   .             .      .   .    .  .        .   .    . .     . ... .    .
.. . .  .   .  ...   .. .   . ..    .           .     .  .   .       ..           . ..
.           ..  ..         . . . .    .        .      .  . .  . .   ..  ..  .        .
.      .  .   .  . .   .    ...    .    . .  ...   .   . .  .  . .       ..     ..   .
..  . ....  .            . .    .. . ...   ..  .  .   ..  . .  .   .. ..         .....
...   ..  .. ..  ..   .   .    .  .      . ..    . .      ..  .  . .       .    .  . .
.  .. .. . .          .      ..     .   .    .       .    .       .         .   .    .
. .   ..    .   ..  .. . .. ..      .       .     .   ..  .. ...           .       ...
. .        ....  .  .      .  .       .   . . . .. .  .  .      ..  .             .  .
.    .  ..   ..  . . .  ...      . ..    .  . .         .     .   .     . .       . ..
....          .  .  .   ..  ....    .   ...  .   .  .   .   . ..  .  ..   ..  .      .
.  .    .. .          .  .   ...   .    .  ..           .  .           .  .    . .   .
...   ... .   .           .    ..    . . . ..  .         .   .  .  .    .   .......  .
..    .    ..  .....   .  .     .. .  .      . . .    . ...   ..    . .  .  . .  .....
.    .   .     ..      ..        ...    .         . .  ...    .       .. . . .  . .  .
.        .  ....   .              ..    .      .  .  ..  .     ..   . .. . .    .    .
... . .. . ..    .           .  .  .     .  . .    .   .  ..   ...   . . ..  .  .   ..
. .     .. .   .    .    . .....    .  .  ..      .    . .    . .  ..         ..  .. .
.     ..  . ..   . . .     . ..  .  . .  .        .  . .   . . .. .  . .. .  ...  .  .
. ..                 . ..  . .            ...            .. ..  ... .. .             .
.     .      .  . .     ....   ..  .. .. . ..    .. .. .     ...  . .    .  . . . .. .
.     ...   .      .. ..    .  .  .     .      . ...  .    .   ...     .   . . .     .
..   ..     .   .                  . ...      ..     . .  .      .  ... .  .   . .. ..
.      .     .  ..     . ..   .. ..  .....  . ..    . ..    ....   ...   . .     . . .
. .      . .    .            .     ....   . . .. .  . .. .  .  . ... .  .  .  .    . .
.   ..    ..      . .   . ..  ...     ...         .     .          .          .... ...
. .    .  .          ..    .   . .. ..  . .   . ..  . . .           .         .   .  .
.     . ..    ..  .   .   .       . .  .  ..        .   .     .    .  .       ..     .
. .   . . ... .  . ..   .     .   ..  ...  .. . .   .  .  ..  ...     .   . ..    .  .
. ..    .       . .      .      .    .. . .. .    .    .    .  ..  . . .       .. .  .
..    ..        . ..  ...  .  .. .. .  . ..     .... .. .  .                 .. .    .
... . . ..  .   .      .  ..  .       .  .           ....   ..      .  .       ..  . .
.        .       .   ...     .   .    .        .. .    ... .      . . .   .  . . .   .
.           .  .. .   ..   . .   ......     .. .    . ..     .  ..   . . ..  ..      .
.                  .     .  .           .    .        .. .  . . .  . . .             .
.   . X   ..  ..           .  ..  .       .    .  . .     .    . ..  ..  .. .  . .   .
.    . ..   .   .  ..    .     .   ..  .  . .. .   . .        .     .    .           .
.     . ...     .  .  ..     .      .. ..    .     . .                             . .
. . ..     ... . .    .   .   .    .. .    .  . .  .. . . .  .. ..  .   .  ..  .    ..
.    ..  .  .    .   .  . . .. .  . ..    ..   .   . .         . .. . . ... .   ..   .
.       .  . .       . . .   ..        .. . .       .    .   .  .  ..    .  .     . ..
..  .   ...     ....         ... .    ..    .    .   ..  ...    .    .. ...   ..    ..
..  .     . ..  .  .  ..    .  .   ..  ..         .   .. .. . .     .      .   .     .
.   .            .          . ....  .. .  .    .   .   .   . .  . .  ..   ....   . . .
..  .. .  ..            ..   .  . ..     ..    .        .   .   .....  . .  ..    .. .
.  .   .       .  .  .           .      .     ...     . .     .                   .  .
..     . . .    .  . .  .. ..        .     . .  .  . .          .  .   . ..        ...
.   ..        .        .. ..            ... ... .. .. .   ......  .             ..  ..
.  .       .   .   . ..                   ...   .  .... .    ..     .   .  .  . . .  .
. .  .. .   .  .      .            .   ..  .   .  .  . ..       .. .  .  ..   ..  .  .
.  .     .   . ...  . ....           . .       . . .      .. .   .  ..   .....    .  .
.  .   ..   .  ...  . .  ..   . . ... .     . . .   . . . .  .   ..    . .  .  .  . ..
.    .   .. ... ...  .  ..     .         ..     ..  . .   .   .    . .  .   .  .  .. .
.   .    .   .   . .  ..  . .   ..     .  .    ...       .           .    .        . .
. .  .  . .   ..       .   ..   .        .      . .  .       .  .   .   .         .  .
..     .       .  . .  . .    .    . .   ..  ... . . . .   . .  . .     .   ..      ..
.. ..  .  . ..   .      .           . .  ...    ..       .   . . .     .      . . .. .
. ..   .    .  .        .  . .   . .  . .....    .  .   .. . .. .      .       .  .  .
.   . ..           .           . .. .      .     ..  . .      ..  . ..    ... . .    .
..   .  .  . .. . .     .    .  .  ..  .      ..      . .   .   .  .. .    .  .  .   .
..               .     . .    .     .    .    .     .   . .   . . . .     ..  .      .
.   .  . .  . .    .  .           ..        .  .      .   .. . ..   . .  ..    .. . ..
.    .   .   .   .. ..    .        . .  .      ..    . . . .  .       .. .   .      ..
....     .   . ..     .  . . ....      . .   .      ..  ..      .. .. ...  .    ..   .
......................................................................................
