.......................................................................................
..    .  ..  .       . .  .   . .   ...  . ..  .  .  . .  . .    ..       .  .  .  .  .
...       ...      .        .. .  .    .  .  . .       .       .  . ..            .   .
. .. .....     .           . ..      .  .. .   . ..     .      .     .  ...      . .  .
. ..   .  . .       . . . . ..  .    .      . . ..        ..  .  .  .   .. .. .   ..  .
.     .  .     ...  .   . . ..     .   .  . ..        .  .. .     .  . .           . ..
. .. .  . . .... ..  .   .     .      .       .. .    . ..     ..        ..    .  .  ..
. ..      .     ....X   .      .   . . . ..   .            .  .          . .        . .
. ...       . ..   .     .. ...  ..  ....  . .  .     . .   .       ..    .  .    . . .
. .         .      .   .. ..         .. . .  .....  . . . .   ..   .. .         ....  .
.  .          .        .       .  .        .     .    ...   .  .     . .          . ...
. .   .     .   .   ..    .         .   .       .    .   . . .. .       .          .  .
. .  .           ..        . .   . ..     .  . .   .   .          .  .     .    .     .
..      ..  .    .  .  .    ..       .   .. . .  .   .   .   ..   . . .      . .  .   .
..             . ....   .  ..     .          . .   ...  ..  ..             . .  .. .. .
.        .   ..... .  .  . .  .  .   ..   .   . .    ..  .     . . .  .       .      ..
...           .    .        ..       ..   . .    .       ..     .     . .    ...      .
.  .        . .       ...     .         . .   .    . . ..  .     . . . .       . .    .
. ...     . .. ...             .  .. .  .      . .    . .   .    ..      . .    ..    .
..  .   .   .       . .  ..       .           ..  .        . ....         .  . . . . ..
.  .      ..      . .       .        .   .              . .       . . . .      .      .
.  .  .  .               .    .   ...   .    . .   ..  .  .. ..  .. .   . .    ..    ..
. .  .          ..   .     ...     .  .   ...   .  ..     .   .  .    .  . .. .     ...
. . .       .     ..     . .     .  .               .  .. ..          .  . . ..  .  . .
.       ..   ..      . ..  . .     . ...    .  ..    . . .  . .   .  .  . .    ...    .
.   .  .. .   ..       ...   . .. .   ..     ..  . .  ..  . .      . .. .  .....  .   .
.    . .  .  .          . .  .  .      ...  .  .  ... . .     .  .     .          .. ..
.   .       . . . .      . .... ..   . .  . ..... .     . .  ..      .   .       .    .
. .   . ..    . .         .     .                ..      .  .    .    .........  .... .
.   .    ..   ... ..    .  ..     .    .......   . ...   .  .. .    ...  ...   .   .  .
.   ..  ..     .    .    ..   .   .  .   ..   .. ..  .  . .          . .  ...  ..    ..
..     . .     . .   . .         .. .    .   . ..      .  . .       .. .     .   ...  .
.  . .  .   .    .  .         . .   ..    .  . ... .    . . .   . ..      ..          .
.. . .. . .. .. .   .    ...  ....   .. . .  .   .    . .                  .         ..
.  .    .  ..  .    .  . . ..   ...  .  ..     .     . .         . .     . .       .. .
..   ..    .        .    . ...  .  .   . ...   .. .. .    .     ..    ..    .     .. ..
. .        .    . .  .           ..   ....     ....  . .  .   .      .. .     .    ....
.       .            . .       .   .. ..  .  . ...    .  ..  .   .  . .    .      ..  .
. .  ..        . . ....      ..        .  .   .          ..   .  .     . . . .        .
.   .  ..  .. .   . .. ..   . . .    .    ......    . .         .    . .   .    ..    .
.   . .    . .. . . .. . ..   .      ..     ... .. . .    ..   . .     .  ...       . .
...         .    ..          .     .     ...  .   ....   ..    .   .     .  .  . . .  .
.      .    ....  .  .. .   .       . ......     .  .  . ..  ... . .   .  ..         ..
.   ..     ..       . ... . . .   .  . .  .   .        .    .  ..           .  .   .  .
.       . .. .   .. .    .  .. ...    .  .   . .. ..   .   ..      .   .        .. ....
. ..  . . .    .    ..    . .  . ..      ....    . . . .. .    .           . . .      .
.       . ...   .          .   .           .  ..  .  .  . . . . .  .     .     .      .
....  .  . .   ....        .      . .. . ...    ..      .  . .   .  .....     .  . ....
. .          .    . . .. .... . .  . .    .    ..  .       .  .    .      .. .   . ....
.  .   .   ..       ....         . .         ..            ..         .. .   . ..  .  .
.. ....    .   . ..    .          .  ..      ..  .. . .      . .  ....     . .   ..   .
...   . .    ...    ....  .  ..       . ..       .. .          ..  .. .      ....  .  .
.   .           ...     ...  .    ... . ....   .    ..   ..   .    ..   ..    .   .   .
.. .      .  .  .              . .  .   .   . .  .       .     .  .. .   .     ..   . .
.    ..    .     ... .     .. .  ..    ..  . .       .      .   .  .  .  .     . ...  .
.  .   .  . ..   . .  . .      . . .  .... .   . ... ..  .    .   .    .  . .  .    . .
...         ..      .       . .. .      ..   . .  .  .        .....         ..    .  ..
. .   ..    . ..       . .  .  . ... ..        .    .  .     .        .  . . ..       .
..      .    ..  .       . .   ..      .   . .         .                  . ..    .   .
.   ..     .   .   .  . .   .. . ...   .. . . .  . .    ...     ..        ...       . .
... .      ..  ...   ..  .  .   .  ...   .   .  .   .        .   ...    .   .    .  . .
.       .       .. ..   .  .     ... .   ..   .  .    ..    . .  ... . ..       .. .  .
.    .   .       ..     . .... .   .            .        . .       ..  . .    .   ..  .
.. ..    .  . .     .   ..   .  ....     ..   .     . .    .  ..  .        .  . .     .
. ..     ... .  .   .        .     . . .  ..  .      .    .     .      .       . .    .
. ..   .  .     . .   ..     .      .                .   .  . . .  .. .      ..  .    .
.. .        ..     .    . . .  .  .    . .  .. .....           .. ..     ..      .. . .
.. . . .  .  .. . .      ..   ..      . .  .        .   .  .  .  ..        .          .
. .  ... . . .   . .  ...          .. .   .  .  . .               .   . .. .   .    ...
.  ... . .   .. .  . ... .. .  . . .   .   ..   ..      .       .     ..   ...        .
...                . . . .  .     .  ... .     .. .       ..  ..         .  ..     .  .
.     .             ...    .    .    .. .       .   .  . .   .    .      ..   .  .   ..
. ..   .. .   . ...   ..   .      ....      .  . .   .  .        .     .. .  .. ..    .
. .   . .   . .      .        . .    .    ...      .     ..       .     .    ..   .   .
.. . .         ..            .     . .       .. ..   .  .. . .  . ...   ..    ..   ....
.. . . .    .  . ..  ..      . .    . . .   .   ..   .    . ..     . . .  . . .  .. ...
.  .       . .  .      ..    .       . .   ....  .    ...  .... .   . ...    .     .. .
...  . .  .    .    . . .....   . ..   .           .   ...  .    ..     .  .    .  .  .
.     .. ..   ...   . ....     .   .    .   . . .  .     ..      . . . .           .  .
... ... ..   .    .    . . ...     .. ..     ..                   .   .  . .     .   ..
.     .    ..      .    . . .  . .  .                ..       ... ..         .    .   .
... .   .   .        .. .   . . .. .  .. . .  ..    .  ..    .     ...       .  .   . .
.            .  .. .  .    .        .. ..          .       ..  ..     . .. .     .   ..
.. ... .. . .   .. .  .  ...  .   .....  .. .  .   .   . .    . ..... .. . .    .    ..
..    .. r   .   .   .               .   .. . .     . ..  .... ...      .          .  .
. .           . .. . ... .  .               .      .   .      ..   ..      ..  ..  .  .
.......................................................................................
