........................................................................................
.. .  .       .  .. .   .  ..     .         .        .   . .      . .     . ... .      .
.        .    .   .       .            ..  ..        .. . .  . .   ..   ... .   .  .. ..
..  .      .. .   ..            .   .. .   .   .   .       .  .  .  .         ...  . . .
..    ..  ..   . . .. . . . . ... ..  ..   . .   ..  ...     ..   .        .  .. .     .
.   .     .       .  . . .  .         ..     ... ....    .     ...      .   ..  .  .   .
..      ..  ... .. ..   . .    .       .    .    ..   .             .  .   .   . . .. ..
. .  .  . .       .  . ...    ..            .  .     ..      ..  .   .  .    .  .     ..
.      .. . .    . .     .      .. ..  ..  .    . .  .       .    .   ... .    .  . . ..
.   . . .   ...  . . .        .      .   . .  ..        .   ..      .      .  .    . . .
. ..   . .. ...  .  . .   ..      .   ...   . ... . .      .    ..   .     .   .  .   ..
.             .           ..    ..   .  ...  .     . .  .     .  .. .. .. .    ..      .
..  ...    ...    . . .  . ..      .  ..          .   .  .  . . .     .    ..    .  . ..
. .. . .  ....           . ..       . .       .     .         ...     .      ....      .
.  .. . . ..   .     .         .      ..... ...  ..           .       .    . .    . . ..
..  . .  ... . .     .  .. .     . .    .    . .   .     .. .  ... .. .  ..     . .  . .
.     .  .   .   .       .. . .. .  .     ..  ..      .       ..    ...  .        . . ..
. .    .  .          .  .... .  .    .   .      ..    ..           . .. . . .         ..
.. .   .       .       .   . .   ..  .  .  .   .   .    . .           .     .  ..      .
. ...       .    ..            .    ..             .          .         .  . .   . . . .
. ..     .          . ...  . .  . .  .  .             . .   . .   .     .  .  .  .   . .
.  . . .    .    . ..   .     ...       . ..   .     . .. .  .. .. . ..  .  .     .    .
. .    .     .   .     .   .  . ..  .       . . .  .        . ...  . .    .     .  .  ..
.    . . ..  .. .    .      .  .    . .. .  . . .  .  .       .          .  .  .     ...
...    .. .  . .     ... .          .   .  .  .. .  .    .      . ..   .        .   .  .
.  .. . . . . .   .     .     .  . .   .      . .   ..       ..   . .  .  . .  .   .   .
. . . ....  . . . .      .....  .  ...        ..             . .. ..   .  . .....     ..
. . .  .    .    ..      .    .   ...  . .         .  . ..    ..    .     . ...   ... ..
.   .    ......     . .     . ..    ...     . .    ..   .... ... .  .            .   ...
.    .       . . .     .. .   ..    ..      . .   .    . . .  ..              .   ..  ..
..      .    .  ...   . . .   .       .     ..      . .    ...   .    . . .    .       .
.           .   .  .. .  .  . .  ..    .      .        .   .        .    .  ..  ...  . .
.      ..  .     . .            ..   ..  . .. . .            .  .    .  ..   ..  .  .  .
.. ..  .      .   .. ..   .. .. .  .  . . .  .   .       .    . .         .  ..  .... ..
.       .   ... ... . .    .   .   .  . ...        . .     .     .          . ..   .   .
. ..   .  .   .           .  .  ..   .    .         .... .. .       . ..     .    ..   .
..   .   .    . ..   . .     . ..   .  . ..    .         ..            ..   .. .    .  .
.    ...  .      .. . .....     . .    .. .              . .. . .   ...    ... .    .  .
.         .    ..    .  ...      ..    .  .    ...   .  . .      .  .   .     .    ..  .
.  .  .   .           . .    ..      .       .        .            .  . . .. .        ..
.     ..  . ..    .   .  .       .           .      .  ...    ...  ..  .. .    ..     ..
..   .  .  ...     .. ..  . ...      . .  . ..   ..      . .  .   ... . ... .  .  .  ...
.. .           ........     .  ....    ...   ..    ..    .    .   .  .   . . . . .  .  .
.  . .           ..    ...    .        .    .  . . . .       .  . . . .   .  .      .. .
.   ..  .     . ..  .    ..  . .      . .    .      .    .. .   .. . .  .   .  .  ..   .
..        ..      .     . .    ..   .     ...  .. ....    . .    . . .   .     .    .. .
. ..  .   . .. ..    . .  . .       .   .. . ..    .  ...      .    .   ..     ..    . .
.  .. ..   . . ..   .X   . .   . .    ..    .   . . ..  .   .    . . .   .   .  ..   . .
.   .    .   ..   . .  .   ..     . .      ..  ..  . .    . . .      ..  ... ...     . .
.           .    . .    .   ..  .           .     .. ..  ..  .     .   .   . .         .
.    . ... ..    .    ..     ... ..  ...           ...    ..   .         ...           .
...    ..  ..  .. .   .     .   .        .      .      ..         .   . .. .     .    ..
.   ..  . . ..          . .  .     .     .   .  .           . .    ..          .    .  .
.. .     .      .         ..    .. . .  .. ....    ..    .. ..  .  .   . .  . ..  ..   .
.  .  ..      .. ... .   ..  .   .  .              ...      .  . .   . .    .   . .  ...
. . ..   . . .  .    .  . .  ... . ... ...  .    .  . ..      .  . ..            ..   ..
. . ...      .. . . ... .     . ..   .        . .  . .     .. ..   .      .            .
.    . .  . ..  ..     ..           .. . .  .      .      .  . .          .    ... .   .
..  .   . ..   . . .  ...         .      .      .... . ..        . .  . .   .  .       .
.          ..  ..      ..       .   .      .    ...    ..      .  .   . .         . .  .
.   .. .. ...  .   . .  .   ..  .  .   .  ...  .     .. .    .  .       .  ....  ..    .
.    .. . ........  . .        . .    .   . .      . . ..  ...       .      .  .       .
.. .   . .. .      .  .  .  .   .   .       . .  . . ..  ... .. .   . .   ...  ..   .  .
...     .   .    .      .    ..           .      .     .  .    .  .  ..  .  . .  .   ...
.   .. . .    ..        . .  ..  ..     .    ....    .       . .             . .  .   ..
.   . . .    .    .            .          . ...   ..  ...    ...   ... ..... . .  . .  .
. .    .      ..  . ..  .  .      .   . . .       .. ..  . .   . .  .  ..  .         ...
..     .  . .. ..  .  . .     .      .    .               . . .   .      . .     .     .
..                  .        .. ..      .  . ..    .   . .   ..      .      .    .. .  .
.  . ...   .  .  . ...  .       . .. .    ..    ..   .   ....   . .     .  ...  .      .
... ... .. . ..     .. . ..     .    .           . . . .  ..       .  .     .      .  ..
.  . ...        . .    .   ..   .    .   ...  .. . .   .   .      .   .     .   .  .   .
. ....  .   .     . .      .   .  .    .   . .  .      .   . ....   .       .    .   ...
.       .. .     . .  ..   .  ..     .      .  . . .  .      . . ...  . . ...          .
..   .. . .   . . ... .        .         . .  . ...    .   ..   ....  . . . ..  . . . ..
.  .   .    .    . .. .   ..         .. . .    .     ..            .  .    . ...  ......
.        . ...      ..   ... .   .  ..         ..    .. .        ...      .. .    ..   .
. .. ..              .     .   .    .    .  . ..  .    .  ..     ..  ....        ..    .
..             . .    .. . .. .   r    .. .  . .  .    .    ..   . .            .  .  ..
..       ... .       . .         .     .       .  .   ..      .  .     .   ... .  ..   .
. .  ..     . ..      .   ..  . .  ..     .. .  .      ..   ....  .  .     .  ....     .
...   ..    . .  ..           .    ..     .   .. . . .  .  . .          ..... .     .. .
..    .     .    .   .   . .    .         .     .      .  .  .  .   ..   .    ..       .
.   . .  . .   . .    ..  .     ..  .         .   ..     .  .      ...    .   ...   .  .
.     ... . .   . ..   ...      .  ..        . .   ..        .  .          .   . .     .
. .    .      .       . .        .     ...  .      .     .. . .       .   .  .   .  . ..
.  .       .  ...        . .. .   .        ... ..   .. .. .    . .   .   .   .. .  .. ..
........................................................................................
