.........................................................................................
.       .   .   ......    .. .  .  .        ..  ..            .     .   .    .   .   .  .
.   . .  . .           .   r        .   .   .  ..  .  .      .  .     ...  . . .  ..  . .
...   . ..       .      .    . .     .  ..  .         .. . .        .. .      .       . .
.      .   .  .   .    .   .   . .    ... .   . ..      .   . .    ..    . .    . .  ....
.   .      .    .   .  . . .    .    .      .    .     .   ......     .   .  .. .    . ..
.. .  ...     ... ....   .         .    .   ...      . . .  ...      ...  .  ...    .   .
..    ..       . .     .     .      . . .     .     . .  ..   .        ..   .  .. ..    .
.     .. .  ...    .    .  ..  ...   .  .    . .. ...       ..   .   .  ... ..        . .
. .    ..      ..   .      ..   ..   .   .    . ..          .   . . .  .  . . .      .  .
. .    ..     . .. . .       ...                ...  .        ..   .   .  .. .        . .
.  .  .   . ...   .         . .  . ...    ..      .    .   . .       .   . .  .        ..
..      .  .   .. ....  .    .. .  .    .. .   ..           .    .. .       ..  ....  ...
..       . .  .  .  ..    .. .  .  ...      ..... .    ..      . .    .        .  . .   .
..       .. ....  . ...    .......    .    .      .. .  .         .     ...    ..    .  .
.      .     .          . . . .. ..    . ..   .  .    ..       .         . ..       .   .
.  ..        .   .  .   ...   ...   .  .   . .  .    . .   . .  .  . .      ... .    .  .
....      .       .. .  . .   .  ...      .. .     ..   .     .    . . . . .   .  .  ....
.   .  .  .  .. .     .      . ...    .   ....       .       .       .. .             ...
...    .     .... ..  .     ..    ..  ...  . . ..    .     .     .     .. .    . ..   . .
. .    .           ...  ...   . .     ...  .     ..    ..  . .       ..     . . .  .   ..
.  .. .  .  .  .  . . .   . ...    ..   .   .    ..   .            .       .  ..    .   .
.  .   ..             .  .   .               . . .  .   . ..  .. .. . .  .. .  ..      ..
.  .. . .. . .. .   .      .    .  . .          .   .    .    ... .    ..    . . .  .   .
.     ...   .. .  .   .  ..... .       .      .      . ..... .  .. .. .  .  .. ..  .    .
..   .   .  .  .     . .      . ... .      .  . .... . .    . .   .     .     ... .. . ..
..    .   .         .     .    .        . .  ..  ...    ..        ..  .   . ..   .      .
.  . .     .  ..           ... ..     .       . . ..     .   . .     .. . .  . .        .
.. .  .  .   . .  ..  .  .       .     . .. ...     .           .        .           .  .
.  .  .. . .   .  .  .      . .     .  . .   .  ..      . ..  . .  ..     .    ...      .
. . .       ..  .     . .. .. .    ...   .     . .   ...     . ...         .        .   .
.    . .. . .       .   .       .  ..        . .    .. .     .   .. .....    .    . .  ..
.  . . .  ...     .                 .    .       .          . .  .   ..  ...  .         .
. .      .. .    .   . . .  .  ..   .   .  ..     .  ...  ..     .   . . .  .. .      . .
.  ..  .   .    . ..  . ...     .       .  .           .   .      . . .  ...         .  .
... .. .        ..     ....  . .  .        .    . .  ..    . ... ..     .    .   ..     .
.. ..   .  .                .  . ..     .    . ..  .     .....   .   ...  .   .  . .    .
. .        .  . .    ... .  ..         ..     .      ..  .     .. . ..    .  .     .    .
.         . ...  .           .      .      . ..    .      . .   .. . . .      .      . ..
. .  . ...          ..      .   .        ..       . . .    ..        ..   .  .  .   .   .
. .   ...   .    .  .  . .. . .          .  ..   . .  .  .     .  . ..   . ..   .       .
..     .. .  .. .. . .          ...    ...   ..         . ....    .. ..  .     . .     ..
. .   .  ...    .     .. ... .   . . .       .         .  ... .     .  ..  .   .   . .  .
.  . .     . .   . ..       . .   .      .  .       ..  . . . ... .   . .   .  .  .  .  .
.   ...   .    ... . . .  . . .          .       . .     .  ..   .  ..     .      ...   .
. .. . .       .    ..      .  .              . .   .      . . ... .   ....      .      .
..  ... ..   .     .... .  ..      .  . .      .  ..      .       ..  .  ..     .   . . .
.   ..        .       .  ...  . ..     .      . .   .       .   . .    .. .     .       .
.. .   .. .    .    .    . ..      ..  .  ..   ..  .. .  .          ..    .   . ...   . .
..  ..   .   .        . .  ..   .  .. ...     .  .     .  ..        . .  ..      .  .   .
.    .  . .   .      .         . .  .  .         .. ..  .       ....    .      .  .     .
. ..       .    ... .   .       .     .  ..  .   ....  .   .   . .... ...  .. .      .  .
.  .. .     ..  .  .    .   .. . . ... .     .  .   .      ...   . ...  .     . ..      .
..   .     .  . .  . . .          ....  .   .. ..  .   .  ..    ..      .   .  . .  .  ..
.  . . ..  ..  .  .  .       .       .     . . .  .     ..  ...    ..         .    .. ...
. .   .     . .   .. .  . .  ..  .     .   .          .      .    .     .   .         . .
..  .     .    .   ..   . .  ...   .. .  .  .  . ..      ..  ..... .             .... . .
...                                       . . .  . . .           .. ..         ..       .
..    .   .. .   . . .      ...    .    .    ..       ..   .    . ..     .         .   ..
. ..  .   . .     .  ..  .     ..  . . ... .   . .   .   ..        .     . .   ..  ...  .
.  . .   .  .   . ..   .   . .                    ..    . .    .. .. . ... ...   .   .. .
.        .  .  . .   . . ..   .   ...  .   .    ..  ..  .    ..  .    .  ..   .   .  . ..
.  .. .   .. .     .    .    .. . .      .                  .     ..  . . .    ..   .. ..
.... . . .  . . . .      . ..       .    ..  .. ...    .   .   .    .      ...       .  .
.    . .  .   . ... ..        .    .      .   .    ... . ..    . .       ... .  .       .
.  . ..   ... .  . . .  ... .    .   .. . . ..   .  .   .    ..  .   . .   .   . . .   ..
.. . .. . .       ..  ..          .     .        .   .    .                       . ..  .
. .  . . .    . .          .      . .     ... ..   .       . .    .        ..  .      . .
...  .    . .        ..  ..  .    .. .. .        .       .        ...           .   .  ..
.   . .  .  .   . ..   ..      .. . . ..  .. .        .... .   ..     .  ...     ..     .
.          . .. . . .                .      .  ..     ..  .       . .  ..      . .  .   .
.   . .  ... .   .  ..  .       .. .   .. .  . .  ..     .. ..   . .      .  .   . . .  .
.       . .    . .    .     X  ..     .   .  ..  .  . .  .   .      . .         .  .   ..
.     ..  . .       .   . . .... .   .     .    . .       .    ..   .   . . .  .        .
.    .. . . .   . .   . .  .. .     .  .  ..   . .   . . .  .....   . . .  . .  .       .
.  .. . .   .  .      . . .. .             .   .. ..   .  ...        .            .   ...
..           .      ..      .. . ..    .. . . ..      . .   .  ..  .      ...   ..      .
....  . .. . . ...   ....     .   . .   .         . .   ..        .     .       .. .    .
.    . .  ...  .    .    ... . .. .   ..  .     .      .  .. . . ......  ..        .  ...
.   ...       ....    .   ...         . . .. .  . . . .   . ..  .    .      .   .  .  ...
.   .  . . .   .       . ...  .   . ..  . .    ...    ..   . ...    .    .       .      .
.   ..   ..   ..  ...  .          . .  . . . .     .        ...  . .     .. .   ....  . .
.   .. .. .. .     .      . ..     .. .    .       ..    .   . .            .  .   .  . .
.  .            . ...  . . ..      .   . ...   ..    .       .   .       .  . . . .    ..
. . .    ....       .     ... .  ...     .  ..       ...  .. .    .     .      .      . .
.  .       .. .      ..               .  ..    .   ..   .   .     . . .   .     .     . .
....             .  .      .. . .      .      .   .. . .   ..       ..           . .   ..
.       .    ..  .      .  .. ...  ....     . . .       .        .    .       .   ...  ..
.........................................................................................
