........
. X . r.
.      .
.   .  .
.    . .
. . .. .
. . .. .
........
