..........................................................................................
. .   ..   ..        .   ...   ..  ..    . .   ...     ..    .         .         ...   . .
. .       . .... .   .        . ..         .       .        .     ...      .            ..
.    ...           .      .     . ..        . .      ..   .            .   .        .. . .
...     .     .  .  .  . .  ..      .. .   . .  .    .  ..  .      .      .    .   . ..  .
... .    .    .  .      . .    . .  .    ... .     .  . .  .. .    .       . . ..  ..  . .
.  .    .  .           .  . .  .. .         .       .. .     .    ...  .  .       . .    .
.   . .    .   ..  .  . .. . .   .  ... .. .  .   . ...    ..    .   ..  . . .  .     . ..
.      .   .. .   .. .. .  . . . . .   .   .   .        ..    .   . .    .   .   .  . .. .
... .  .     .     .   .          .               .   .         ..          ..  .       ..
.    ..         .          .. .  ..   .    .        ..  ..   .   .  ...     . . ..    .  .
..        . . . ....  ...   .  ...         .     .    .. . .   ..  ..  ..  .    .  .     .
.. .   .   .  .       .. .  ..    .  .         ..  .   .  ..           . .     . .       .
. .      .   .  ..   .        .  ..   ..      .  .   .  ..  .  .. .  .   .     .  .. .. ..
.    ...    .           . .          .    ....       .   . .  . ..  .   ..  .      .    ..
.      ..      .  .        .   ..  .  . . .. .    .  .       ..    .  .  . . .   . ...  ..
.. .  ...   .. ...  .  .    .  .                      . .   . . .   . .   .  . ..   ..   .
....     .. .    .  .         . .      ..    .  .    .  . . .   .. . . .        . . .  . .
..  .    . . .    . ..         .       ...          .  .   .  . . ...     .  . .    .  ...
.    . .  .     .. . .   ..  . ..  .. .    .       .   .   .   .         .        .   . ..
. .  .    .   .      .. .  .    ...   . .. .     . ..   .     ....   .     . .. ...    ...
.   ... ..        . ..   ....     .    .   . .       .. .        .   . .  .  .    ..   . .
..    .. .  .    . ..   .    .   . ...  .     . .    ...  ...  ..       ...     .  ..  . .
.. .      . .         .. ....  .  ..          .. .       .    .   .  .         .  . ..   .
... ..    .  ..   ..  . ..  .      .     . ..          ..    .  . .     . .      ..  . ...
.   .. .  . .   . .       ..     . ..            .   .           .         .       . .....
.   . .. .  .      . . .. .      .  ..    ..   ..  .. ..      .          .  .  .    .    .
.    ..   .    .   .    ... . ..   .    . .. .... . .   ...   ...   . ..  .  . .         .
.      .      .  .    .    .. .  .            .        ..  . . .  .    .   ..    .r.   . .
.    .  .    . .     .      .   ..  ....    .. ..    ... ...    ..  .   .   .     ..    ..
. ....    .. .        .   .  ..     . .. .  .. .  .  ...  .     ..     .       .  .      .
..  .       .        . . .   .           . .. . .      ..            .   .    . . .  ..  .
.  .    .   . .  . ..   .   . .         . .  ...   ....   .  .    .       .      . .     .
.    .   .     .    . .  ..     .  . .  ..  . .   ..        ..     .    .  .   .   . ..  .
.. . . .. . .     . . .. .. .           .  .  . ..     . .. .      ..  .   . ..  . .   . .
..  .  ....    .  .      .      .. .   ...      ....                 ..    .     . . . . .
...    .  ..    .   ...   .. ..  . .   .   .     .    .         . ... .   .. .     .     .
.      .     .  .   .  .    ..        . .. .   .   ....  .   .   ..   .   . .....    .  ..
.  .   .  .  . . .     .       .. ... ...   .. .   .   .    .  .  ...   ..          .. . .
..  . .          .  ..  ... .   . .   .   ...          .   .. . .   ..  . .          .  ..
.    .     ..   .           .   ...  .. .     . .  . .     .    ..     . .           ..  .
... .      .       . .   .   .  . ... ...   .  .   . .   .. . ...  . . .  . .    .       .
.        .  . .       . .        .          .     .    . .. .     .      .      .. .. .. .
.   .  .      ...          .       ...     .    .  .       .  . .. .. . .     ...  ...   .
.      ...     .   .  ..   ...  .         ....     ..       .  .. .     . .. .. .     . ..
.    .  . .   .  .   ..   .  . . ..     .         . . .    .  .      .  ..   .    . .  ...
.   ..   ... ..    .    ...  ..     ..   .   ..     .. .       . ..  ... .      .    .  ..
...     .      .          ..   ..  .  ..   .       .   ..   . .   .       .  .  .  .   . .
.   ..               ..           ... . X  .. ..   ..                  .        .   .    .
.     .    .  .  .           .  ..     .  .   .  .  .    . .  .   .. .      .     .   .. .
.  .  .  .            ..       .   .      ..   .......        .  .. .    . . . .       ...
...  . ..   .    . .       .... .       . ..  . .    .        ..  ..   ..       . .   .. .
. .     .. .  .   .    .     . . .    .   .    . .....     .       . .... ... ..  . . . ..
. ...     .  .   .  .   .       .    . .     ..  ..   .. .                .. ....      ...
. .  .   ..        .   .        ....  . .  ..  . .  .  .                .. .   ....      .
.   . . ...  .  .  ... . .        .    .     ..   .    .      . . .     .  .      .. .  ..
. ......     . . .   .     .     .. .   . .      .  .   .   .   .   .... .. ...   .     ..
.       .   . ..  ..    .   ......   ..    .  .   ..   . .. . . ..    .    . .   ... .   .
.. .         ... . .  ..       .  .  .  . .   .     ..      .... ....          . .     . .
. .      ..      . .    .  .    .    . . .   .   .   . .   ...  . .  . .. .   .. . ...   .
.      . ..    .     . .     . ..  . .  .  ..      .  .     .    . . .  ..  .  .. ..     .
.. .  .       ..  .    .. ..  ..             .      .  .   ..   .    .      . .     .. . .
..  .. .   .   .   .             .  .  .  .. .  .. .   ..  .. ..  .   . .   .        .   .
..    .    ..         .   ... . . .  ..  .  . ..   .     .. .  .    . .     .   ..    . ..
..   .    ..  . . .    . . .     ..    . .   . . ...  .  . . .   .  . .. ...    .  ..    .
.     .   .       . . .   ..    .       .          .  ..    .   . .  .      ...        . .
..  ..   . ..    .     .. .      .              ..   .   .  . .   . .    .  .  ..       ..
..      .   .   ..  ..   .    .  . . .  ..    . .  . .    .. ..   .   .            ....  .
.  .    . . .  ....   .                    .  .... ..  .             ...  .       . .   ..
.       ... ..      .  .   .. ..      .          . ..       ..   .  ..             .   . .
.  ...  .   .         . ... ..    .  ..      ...      . ..   .  .  .  ..  ....        .. .
.    . . ..  .                 .  .  .  ..  . .. ....      .   . .   .   . .. ..   .    ..
.       .   .  .       ..  .     .  ..  ..  .   .         . .              . .  .    ..  .
.  .       . ..   .       ..      .  . . ..     ..      . . ....  .   ..  ..    .. .     .
.  ..     .       .        .    . .  ..   ..      .. ..   .. .. .     .    .   .  .   .. .
.. ..  .   ..        .  . .         ...            . .    .    .. .       . . .        . .
. .   . .. ..  ..   .  .     .  . . . .    ..    ...             .. . .      .     .. .  .
.  .  . .       .        .      ....          .   .   . .     .     ... ...  .     ..    .
. .      .     ..    .  .    ....  ..  . .    .   . .         . . .. . .   . .   .       .
.  .       ..   ..       ..         .       .  .  . . .      .      .   ..   .     .  . ..
. . ..  . .    .   .   .    .  ....  .. ...    . .  ....      . ....  ...     ..   . .. ..
.       . ..  .    . ..    .   ..  . . .      . ..        .   .           . . .. .   .   .
.   .. .   ..    . . .     . ...      .              ..    .. ..         ... ....  ..   ..
... .        . .   ...    .  .  . ..  .    .          .  .  .     .       ..  ..     ..  .
...     .    .   .   ..   .          .  .  .   .  .           .   .  . . .. .   . ...  ...
.       .. ..    .    ..        .  . ...      .   .       .   ..   . . ..   . .  .   ..  .
..  ..  ...      .    .. .  .       ..      .        . . . .   .  ..  .    . . .      . ..
..    ...  .. .  ..     .. .   .     ..         ..     .  ..     .    .   . .    ....  . .
. . . ...      ..   . .     .    ..   . . . . ..  .  .   .. ..  .    .   .   . .  ..     .
..........................................................................................
