...........................................................................................
. .        .   .       .  ..       .           . ..                .   .   .. . .  .      .
..     .  .   . .  .   ...  .  .   .    .     .        ..    .   .  ..           .. . .  ..
.  .    .   .. .   .       ..  .                .. . ..             .. .  . ..  .  . . .  .
.    .. . .       .    . .. .   ..         .     .   . .  . .  ... .. . .  ..       .     .
.         .     .    .  . . .       . . .    . .. .   . .   .     . .       .  .  .... .  .
.  ..      .   .     .    ..      ..    .      . .  ...  ..    .   ..   ..  .  .    .     .
.     .  ..   .    .          .. .. .  ..             . . ....      .   .    .       ...  .
..   ..   .. . .        .       . ..    .       .  . .  .       .    .     ...   . .      .
...     .. . .  ...    .     . .. .  ..     . .      . .       . .. ...       .  .  ..   ..
...  .. .  .     ..     .. . .    .   .  .      .  .. ...   . . ...     . .  . ..   .     .
. . .  .     ...     . .  .. .              .  .  ....      . .       .           .  .   ..
.  . ... . .    . .        .       ...  .    .   . .      .  .    .     .. .      .... .  .
. . .      .   .      .    .  . .  .. .    .   ..    .       .      .    . .    .         .
.   ..  .    .  .   ..   .          ..                 . .. ..   .    . ....     .  .. . ..
. .    .            .     .     .. .  .   .... .  . .  .  .. .            .. . ....       .
...   ..  .      .    . .  . . ..    . .  .    .          . .     .  .   ...     .. . .  ..
... .         .  .  . .       . .    .     .   .     . ..  . ..     ..   .            .   .
..    .  ...   .  .  . . . .       .       .            .     .     .. .. ..     . .      .
. .....  .  . ..                  .  .     ... . . .   .         .   .        .   ..  .  ..
.   ..  .       . .  .   .   ..     .       ..    .. ..  .  . .   ... .        . . . .  . .
.. .               ..  ..  . .   . .     ....     .. . ..  .   .  .  . .  .       ..      .
..     . .. .  . .  .. .   .  .      .. .      . . ..      .. ..           .   . .. . r.  .
.    ..  .. .. ...            .     . .   .     ..       .  ...   . .. .   . .. .  .      .
. .   .  .  .     ...       .  .          .    . .   .  . .    .....  .  .  .  ... .     ..
.  .      .     ...            .    .. . ..  . . .. .   .  ... . .   .. ..   ...          .
.  .     .       .      .    .   .   .  .        .    . .    .. .         .  .    .   .   .
.  ..   ...  ..  ...  .  .   ..  . ...   . .      .        .    .   .   .   .    . . . .  .
. ..     .   ... .   ..     . ...  .  . .     .   .            . . .     .  .   .   ...   .
.  ..     ..   .     .  .   ..    .                  .     .      .  .  .. .  . .. .      .
. . .   ..   ..    . .  ..  . .   .     .. .  X .   ..  ...   .    .  .   .  . .   .   ....
..            .  . ....    .       .  ...    .      . ..   .  .    .    ..    ..  ..    . .
. .. .  .    ...   . ... . .. ....   .   .  .  .  ..  .  . .... .   .         ...         .
..    .   ..  ..     ..     ...    .  . .       ..  .    .       .          ...    ..  .. .
. ..      .   . .    ...          ..  .         . .   ...      .  .  . .... .. .    . ..  .
..    ..  .          .  .     ... .    .. .       .   . .    . ..  . .    ..  . ..        .
.    ..  .  .   .           .     . .          . . ... .  .  . ...  .   .  .     ...  . . .
..       .       ... .. .   ..    ..     ... .  ... .     .    .     . ...  .   .       ...
.  ..  ...       .  ....  .    .  .. .  .  .     .     .. .     ...       .. .      .    ..
. ..     ..  . ... ...  .      ... .   .  ..   .     .     . .       ....    . .   .  ..  .
.    .       .   .. .    ..   .  ...  ..    ....  .     .      .  .   ..       .      .   .
..  ...  .      .   .      ..    ..   .  .. . .         . . .     . . . .  ...    .  .    .
...   .  .. . ..  .  . .  . .  .. ... .. .      .. .   .... ..   .   .              . .. ..
. .. .    .  .  ... . . .  . .   ...    ..          .   . .   . .   .. .   .     .   .    .
.     .      .     .         .     .  .   .  .  ..          .  .. .   ...   .    .        .
.  . ..         .   .            .. . .        .  .    . ...       ..  .                ...
.     ..    . .   ..       . . .      .        .   ....           .      .   .  .  .      .
.   .         . .         .  .....   .         . ...        .  . .       .     .   . . .  .
.   .     .....    .  .              . . ... .     ..  . .  . . .  .    ..  ... .   . .....
.   .   .    .. ..   ..     .     ..      .    .    ..       ..      ..   .    .    .  .. .
.  ..    . ..  . ..  . ..  .     ..   . .   .    . ... . . . . .   .  .  .    .  ...      .
.  ...  .   .     . .    .    ..   . . . .    .  .  ..   ...    .   .  .. ..  ... .   ..  .
.  .  . . .      .    . ..    .  . .   ..    . ....     . .         ...  .        .    ....
. ...    .          ..   . .... . .  . . ... .     .     . .           ..     .... .    ...
.   ..   ..   .    .  . .    .  .. .  ..     . .  .        . . .      .  .             .. .
.      .     ...      ....  .   . . .        .. ..      .. ... . .  .  . .    ..  .    .. .
. ..  .      . .       . . ..  .  ... .       .      .      .. .  .    . .  . .   .    .. .
.      . .   ..     .              .  .      . . ...    .           .  . .    .  .  ...   .
..  ..   . . .           ..   ... .     . ..  . ..    .      .   ...          ..  ...  . ..
.  .   ..  ..  ... .  . .. ..  ... . .. .  ..    .    ..    .        .  .  ....     .    ..
.   .    .    . .               . .    ..  ..           .  ..  ..  . .   ... .   .  .   . .
. .  .. .   .   . ..        . .   .    .     .       . .. .   .       . .  . .. ..    .  ..
.   .  . .  ..  .      .. . .  .. ...     .   .  . ....       ...    ...  .  .  .     . . .
. ..  .. . .      .. ..   .        ..     .  .   .  ....     .      ..    . . . .... . .  .
. . .. ... ..   .  . ..  ...  ..  .   . .  .  ...  .  ...     .  .   .    .  . .          .
..  .    ....    .. .       ..       .  . .      .      .     .        .   ..  .          .
.  ..  . ..                 .    .   .     .  ....    .   . . . .    .  . . .   .  .      .
.    ..  .. . .   .   ..     .   .  .    .   .       ..    .. .   ...      .   .      .   .
. .      .    .....  ..    .. .    ..   .  . .    .  .     .       .   . .     ...  . .  ..
.      .  .        .. .  .     .         .   .      . . .         .     .   . .    .  .   .
.           .    .. .   .  ...  ..      .  .      .   . . .   .      ..    .. .     ....  .
..        .      ..    .. . .    .. .    .     ..    .  .. .     ... . .   ..  .      . . .
...    . ..   . ...  .  . . .        .. .  .    .     ..      .  ...     .         ..     .
.  .    .. . . .   .  .    ... .       ..     .    .. .. ...  ..    ..      .     .  .    .
..  .    .     ..  .       .. .   ...  .  . .  .   .      .     .  . ..    ...       .   ..
.  .      .  .               .          ... ..     .  .    . .  .. . ..   .   .    .    . .
.      .          .    .     . .... .    .      .   ...    .. ..   .  . .   .      ..     .
.         .... .  . .       . .. ...      . ..     .  .      . ..  .. .      .  .  .      .
.  .. .       ... ...    .        . .    .        .   .    ..   .    . .   .   . .        .
.       ..  ...  .         . .      .  .    . .. .  ...       .  . ..  . ..        .      .
..  .   ... .  .    ...         . .   .    .    .  ..   .        . .... .            .  ...
. ...   ..    . .    .  .        .      .    .  . . . . . .    . ... .        .    .    . .
...    ..     .    .    .    .       ..          .  .  . . .               .   . .. .   . .
..   .        ..        .     . .... .  . ..   . ...     ....  .  ..    .    .      ..  . .
. ..    .    .   .     .    .   . .   . .       . .  ...     ..         .. ..   ..  .  . ..
. .. .    ..   .    .. . ......   .     . .        .   .     .     .  .    .  .    . .   ..
.               .   . ..   . ...   ..    . .. .  .  .     ... . .    . . . ...  .  ..     .
...                  ..  .      ..      .   .  .. . .. .      .   .             .     .   .
. ..        .. ....          ...  .. ...            ...  .   . . .. . .  ..   ....  ....  .
.       .. .. . ... ..     ..  .  .     ...        .       ... ..   .      .   .     .    .
...........................................................................................
