............................................................................................
.   .  .        .  .. .....      . . .. .      ..  .    . . .  . ...    .     .   .    . ...
.    .        .  ..      ..      .... .. .      ..     ..   . .  ..   .   ....    .      ...
. .             .. .  .    .  .. ....    .  .  .  .  ... . .   ..  . . .     .           ...
. ...  .       ... .    ..     ..  .      ..  . . . .  . ..... .      .        .  .     .  .
.. .  .            .  .       . .         .       .   ..   .    .... . . .  . .    ..   . ..
...   ... .     .      ...     .. . ... ...   . ...    .     .      ....   .   . . .  .  ...
.   ... . .      ...  .. . ..    . ...     .    ... .      .  .        ..   ....   ..      .
.    . .  ...     .    .      .   . ..    . .     ....     ..   ..        ...  .   .     . .
. .                    .  ...  .  ..   .      ....   .  .   .       .   . .   .    .   .   .
.      ..  ...... . .  .  .  ... .    .         .  ..  . . . . .     ..    .            .  .
...                . .    .   . .    .   .. . .    .       ..      . .    . .      . ..   ..
.   .  .      .  .  .    . .   .  .      . .    .    .  .      .  .        .     .     .   .
.  .  .. .. ....  . .        ..    .    .   .    .      .     ..   .     .  . .          . .
. .         . .    ..  .      ..    . .   ..  .  .         .   ... . .   ...  .. .   .     .
...           .. .       . .      .. . .     . ..    .  .. ..    .. .     ....     .   ..  .
.     .  .     .   . .               .. .        ...   ..  ..   .   .    .      ..    ..   .
. ...    .                     .  .. .      .  .   .  .       .    . . . ..    ...    .    .
.....  . .    .    .  .   . .  .  .   ...    .. .     . .   . .    .     .        ..    . ..
.       .. .    ....  . .  .  . . . ..      ..     .  . .  .    .            .. . ..   . . .
. .     .     .  . . . . . .  ...             .      .   .  .    . .         ... ..       ..
...  ..    .        . .   . .  ....  . . .    . ......    .       .  .       .     . ...   .
..    ..... .   . .    .. . . . .          .   ..  .  . ...    .            ..       ...   .
.       ...        ..     .     .. . ..          .  .   . .  .    ..         ....     .    .
.  ...    .    . . .  .  ..   . .  ..  .   .      ..   ..      .     . ..  .      ..     . .
.   .   . .  . . ...      .   ... . .  . . .   .  .   .    .     ..       .     .   .      .
...  . .. .  . .    .      .      . ..    ..           . ... . .    . .. ..  . ..  .   .  ..
..     .      .     .  .  .   .       ..   .  .               .  ....    .  .      .    .  .
.   . .  .    .   .  .         .  .    .    .           .    .  .  .      .   .     ..  .. .
. . .              . . .. .  .   .     . .    . .           .   ..     .  . .              .
.  ..   .     ..        . ..  .     .. ...        . .    . .  .  ..     .       . .  .   . .
. .  .       .       ..   . . .. .        .. .   .   .. . .   .  ..            .. .    .  ..
..     ...   .  .    .   .        ...   .   . .  .  .  ..   .  .    .      .     .     .  ..
.  .   . .. ..  . .. ..  .     .         .      .  .   . . ...       .  ..      .   .  . ...
..  .  .   .   .. ..   . .   . .  .....     .   ... .  . .. ....                  ..... .  .
.         . . .. .   ...   . . .  . ...     . .       .   ..   ...   ..       . .. ..      .
. .   .       .     .   . . ..         .          .   ..       .     .  .     .   . .      .
.       ..   . ..    .. . .      .       ..            ..    ..... . .  . .  .    .. ..    .
..   .      .. .    .    . . .... . ... .   .         .    .  .   .    ..  .    . .        .
...  . .        . .   .  .     r.... .   .. .        . ..    .. ...   .   ..  . .          .
.  ..    . ..  . .              .     .  . .    .    . .    .      .   ..       . ..  .   ..
.  . . ..  .          ..  . .          .   .  .    ..       ...         ..    .  ..    . . .
.       ...     .  ..          ..  . ... .    ..   .   ..  .       . .. .    .          ....
. .. . .  .   .  ..     .  .      .    ...   ...       ..    .    . .  ..     .  .  .  .  ..
. .. .. ..     ..        .         .   . ..  . .      .   ..    .  . .  .. ... .  ..       .
.  ..           .  .    .. . .   ..    ..   .    ...      .  .  .  ..    .       ..   .. ...
.. .      .     . .......  ..  ... .  . .   ...       . .. .  .  ..  ..  .     ...  .   ....
..   ..  . .    . .  .   .   .     .    . ..   ..    . .  ...    . . .  . . . .    ..   .  .
.....    .    .. .  .        .  .         .  .   . .      .. .. ..   ...    .  .  .   .   ..
.   . .     . ..    . .  .  .  .  ... .  . ..  .      . .  . . .  . .    .  .    .      .  .
..            ..     .      .   .  .     .     .. .. .    . .      ..   .   .. .     .. .  .
..    . ...       .   . . .. .. . .  .     .     ....   .  .   ... .     ..    ....   .   ..
..            . .           . ..     . . .     .  . . . .     . ..              .    .   ...
. .. .          .    .  . ....        .        . . ...   .     .    ..   .   . .          ..
....    ..  ...    .   ..   .. .  . .      . .   .  .       .    ...  ..   .  .    .     . .
. .      .            ..  . . .    . . . . .     ..  .      .          ....   ..  . .  ... .
. ...... ..               .    .       .  . ..  .  . .  . . .  ..   . .  ..    . .      .  .
.       . ....         .. .   .. ..  ..    .      .   .  . .  .   .           .    . ...  ..
.  ....     ....            .  . ....... .  . .    .     .     .     .       . .     .   . .
.    ..   .  ..       .          .      ..   .. ..  .          .         .  .    .  . . .  .
.   ..     ..       .       .  .   .      . . .   .... .      .    .  .     .   .          .
..     . .  ..  .  .. ..   . ..  .  .... .    . . ..  .    .  .  . .   .  .   ..  ..  .. ...
...  . .   ...  ...     ..   .   .  .       ..      ..  ..  ..        .. .. .    . . . .   .
.     .  ...  . ....          .   .. .  .. . ..   .. .  ..     .  .   ..      ..  .   .    .
. .. ... . .       .. .. ..  . . .. ..  ..  . . .   .. .   .  .  .    .            .    .. .
...            .. .   .  .        ...       .  .. .   . . ..  .        .   . .  .   .. . . .
. .      .   .     ..     .... .    . .         .    . .     . ..       ... .        ..  . .
. ..  .  ..               .         .      . . .   ..   . .  .. . .               .  .   . .
. .  . ..  .    . . ..       .. ..    .  ..  .  .. ..   .   .  .. .    ....       .      . .
.      .    . .    ..  .  ..  . .        .   . .   .. .   .       ..  ..  .  ...    .. ... .
.. .   .    .  .    ..  ...       . . . ..  .  ..             .    . .      . .      .    ..
. .   ...  .   .   .  .  .. . . . ... . .     .  ...    .        ...           .     .  . ..
.      .  .                ... .   .  .        . .     .      .  .       .          . .   ..
. .  .     .    .. . ..     .   .   ..           . .. . .. .. ...   ..     .   .           .
. .    .   ..        .          ..    .   . .   ..... .      .   .    .    .  .   .  .    ..
.    .  .    ..   .        .        . ..      ..   ..  .        . . ..       ..  . . .... ..
.    ..  .    .     ..  .       .         .    ...   .        . .    .  .    ..            .
. .  .. X. .    .  . ...   .      . ..  .  .  . ..      . .   ..    . ..    .            . .
.      .                . ..  .     ......  .   .     .   .     ..    .   . .    .        ..
. ..  .         .    .   .  .. . .  .     .....   .        . ..   .           .   .   .    .
.. .      ..  . .  ..    ..    .. .             .      .. ..  ..     ..    ..    ..  .     .
.   .   . . . .   ..      .   .  . .. .   . . .    .        . .  . . . .       .. .        .
..      .      .. .        .  .   . .  .     .   .. .   ..   ... .          .     ...    . .
.       .     . . .  .    .. .   .   ...  .  ..       .    .     ..    ..   ...    ...   ...
.   .  .       ..           .  . ..  .  .   .    ...  ..                ..  . ..   .   ..  .
.           ..     . .  ..   . .        .  .   .   ...     ..        ... .. ..     .  .   ..
.   ...  . ..  ..  .   .   . . . . . .          . . . ..      .   .       .. .    .   .   ..
.     ..      .          .....   .           . . .. .  ..    . . . ..   . .. . ...  ..    ..
. .... .     . ..  .      .              .  .  ..   .  .           . .  ..    .     .. . . .
.   .  .            .  ..   .   .  ..  .     .   .       .  .     .  ..  ... .     .. ..  ..
..  .. ..  .. .  .  .   ...     .  .   ..   .  . .  .   ...     . . . ...      . .   .  .  .
............................................................................................
