.............................................................................................
.   .    ..       .    ..       . ..  ..      .    .  .       .  .  .  ....   .     . . .  ..
. .         .   ..  . . .  .. .    .  .     ... .. ..  .  ...  . .      . .  .   . . . ..   .
. .     .      .    . .. ..      ...      .  .....  . .   . ..  ..  .  .   . .   .  .       .
.    .  .         .  .        ..   ... .    .   ..  .  . ...     .  . .    .    .     . .  ..
..  .      ....     .    .  ..  . .    ..    ...     .    ..   . . .      .    . .       .. .
....  .. .  .    ..              . .  ..       .  .  .   .   .  . .           .       .  .  .
.       . .      ..  .       ..  .  . .  . .   .  .  .   .      ....            . . .    .  .
.      .. .  .       .        .     .  . .. . .          .. .. .. . . .. .    . . .  .  . ...
..   ..       . ..    .   .  .  .  . .. .      . .  .  ..   .     . . .  ...   .       . .  .
.  .. .   ...        .   .      .   . ... .   .  . .              .        .  .. .   .      .
.    . . .        ..  .     ... ..   . .      .   .. .     . .     ..  .   . .    . . .. .  .
...   .      .  .      .    ..    ...  .  ...   .. .. . .   .... .   .    .     .    .   .  .
.  . .  .  .     ...    ... .   ....       .   .  . .  .      .  .    .  .   .              .
.  .  . ..   .    . .. ...    .. .. ..  .... .    .  .  .  ..    .. .   ...       .   .  . ..
.    ..    .   . . ..  .   .. .    .  .   .        . ..   .    . .     ..      .      .  .  .
.       .. .  ..   .       . ..  .         .  ..  .     .     .   .       ..     .. .. ..  ..
.......  .     ..    ..    . . .        . ..   .  .     .   .  . .  .... .      .  .  . ..  .
...  .        .    ..  .    .   .  . .  .   ....      .    . .    . .    .   . . ...  ... . .
.    .   . .   .     ..      ..  .    .  .  ..    .    .. . ..            ..            .   .
. .  ..   ..    .. .   .      ... .. .        ..  . .     ....  . .   .    . .  ..   .    ...
. . . . . .  .... . .      . .     . .  . .      .   .  .      . ..        . .      ...     .
..  .  .   ...   .  . .     .      .              . .  .  .  .    ....     ...   . ..    .. .
.  .. .    .   ..          . ..           ..           . .    .  .  .  ..   .   ...   .  . ..
.          . .  .     .    ..  . .           . .    ..    . . . .     . .    ...   .      . .
.   .      .  .   .       ...         . .. .      . .. ..  .       ..  .    . .    .      ...
.       .   .         .. .  ..  .. . .       . . ... ....   ......         .      . . ....  .
.       ..   .   ..... X  . . ..    .  .  .    ... .  .     .   . .   ..  .        .   .... .
.       ..        .     . .     . .    .  .  ..  . ..  . ..   ..         .    ..... .       .
. .    .       .  . .   .   .     .   .   .        .       . .    . .  ...   .  .      .   ..
.    .  .    . .          . .   ...     ...            .         .   .   .        .  ....   .
. ..   . ..   .    .       .  .          . .       .  .      .  .       .     .  . ..      ..
.. .      .         .       .     .  .  . . .        ..      . .. . . .. .  . ..  .         .
.   . .   .   ..   . .  .   ..  .. .. .   .     .     .    ..  ...      .   .  .      .     .
.. .   .    . .  .   .       .        .   .  .    .       ..   .   .    .       .    ..  . ..
.  .  ..   . ... . .   .    . .  .  .     .          ..    .          .  .  .  ..   . .   . .
. .   . ..   . . ..   .. .    .      ..    ..    .  .  .   ..     .   ... .  ...  ..  ..   ..
.   ..    .   . . . . ..      .  .                 .   .  .     .   . . .       .           .
..   ..          .   .. ..    . . .        .. . ..  .      . . .  .  . ..        .  .  .    .
.     .    .   . .        .      .   . .   .       ... .  . .     . ... .. .   . .     ......
..   .  ..  .   ..    ...  .. .   ..    ..... . . ..     .     .  .  ... .   .. .        .  .
.. .     ..  ..... . .   ..   ..   .       .  . .     .      .   ..      . .. .         .  ..
.       .          .  . .. .. ..    ... .    .      . .  . .  ..  .  .    .   .   .  .  .  ..
.      . .  .  .  ..       ...    . .. .     .     .   . .. . ........ . ....  ..  .     . ..
.  ..  .....   .    .      . ... . .     .   .         . .  ..      . .. .      .        .  .
..  .           . .  .       .   . .  . .  .  .   .  . .    .    .     . .   .    . . . .. ..
..    ...  .   .   .  . .  .  .. ..    ..   .. .    .  . ..           .      ..     .      ..
..    .. .      ...  .   ..     .   . .   ..    .  ..            ...    .   .   .   .. ..   .
.      .     .  . . . ..    ..      ....     .           .. .     . .   .      .       .    .
..  . .      .       .  .  .  ..       .    . .      .  . .  . .  . ..   .   .. ..    ...   .
.. .. .. .. .   ... .   .       .     . . ....  ..      ..   .    .          . ...    . .   .
..   .. ..   .  . .... . .   .  .       .       ..... ..   . .  ...   . . .     .        .  .
.      .....       . .     .  . . . . .  .     .  ... ..   .. .  .   .     . .  ...   .  .. .
. ..    .    ..  .   .                        .    .   . .  ... ..      ..  ..  . .      . ..
.     ..            ... .   ..  . ..  .  .   .   .  ..    . .  .   . .     .  .        .    .
.  .  . .    . . . ..    . .   .. .  .  . .         ...  .        ...   . . .. . . . .  ..  .
. .. .    .   .     .     .  ..  ..    ..  ..  .   .  .     ..  . . .            .... ...  ..
.    .   ..   ..  .   ..   .  .         ..           .   . . .    .    .       ..  . ..   . .
..   .   . .   ..       .   .   ...        .  .  ...    .     . .       . ..    . .    .    .
. .  .  . ...  .    . .   .    .  . . .  .  .. .. ..   .    .     .   .    . .  ..... . ..  .
.  .   . .     ..  . .   ....  . .. . . .. . . ..    .    .   ...   . ...     .  .  .. ...  .
...  .  ..            ..  ..    ..  .         . .          .              ..   ...         ..
.      .            ..    . ..  .  . . .    . .  ..    . .       .           .. ...      . ..
.  ..               .  .   .      .         ..     .  . .   . .    .      .  ..   .     ..  .
.  .  . .   .    .    .   . .  .  .     .. .  ..  .     ..   .      .  .  .  ... .  .     . .
.        .    .. .      ..       .     . ..    .    . .    .           ..  .  ..  .  .  .. ..
.  . . ..  ..          .     ..   .         .     ..  .  . ...              ..  .  ... .   ..
.  .     .  .. ..       .      . ..  . . .      ...         . .   .  .     .....    ..      .
.          .      .   .. .. .       ..  .   .   . ...          .   ..    .  .       ... .   .
. ..    .        ..    .. .            . . .         . .   . .     .  ...    . . .  ....   ..
.     .          .     .  .     .  .  .   . ... . . ..      .. ...   . .       . .    .  .  .
..   . ..  .     .  . ..  . .     .      .        . . .  . .    .  .      .           .  .. .
.    ..   ..  ..  ..          .    .    .    . . .  .      .         ..    . .            . .
.  . .     . .            .  .  . . .... .         ...     .      .     . ..        . .    ..
..  .  . .        . .. ...       .          ...   ..    . . ... .  . .. .     . .  .  .    ..
.. . .     .    .. ..                   .    .     .. . .     .. .      .  .. ..         .  .
.  .   ..      .        ...   ...     ..          .  .                 .  .  .              .
.    ..  ..  .  ..   . ..  .   .      ...  .....        . . . .   . .     ..  . .  .        .
. .     .           ..          .      . .  ..  .    . . .    ..  .  ....   .   . ....    . .
...   .  ... .  .       .   .  . .    .              .             . ..  .   . .  . ... .   .
....     ..        .    ...     .  .  ..     .  .    .     ..     . .. .  .    .    .   ..  .
.    ....   .    ..... .. . . . .     .. . .    ...     .  .. . ..   .  .. . ..   .  .. . ...
..       . ...    .   .  .  . .  . ..           . .  .. .. .            . .   ..     . .    .
. . .  . .    .   .       .       .   . .   .   ...    .   .  ..    .   ..  .  .         .. .
.    .     .    ..  .      . .  .   ..  . ..... . .      .       .    ..  .  ..    .    . . .
.      .  . .   ...     .. .  .   . .           .     ..  ...  . ...     ..       ...  .    .
.       .     ... ..  .    .    .   . ...  ..      .     . .   . ...  .  ....  .       .. . .
.     .   .    .  .  .  .  .           . .   .  .  ..    . ..  ..  ..            .        . .
. .  .  . .  ....  .  .    r       ... .   ...   .   .        .     .  . .        .. .    . .
.  .  .. .  .         .   .     .  . ..        .. . .  ..       .       .. .. .     .      ..
.. .       .      .  ..  .   .  . ....      .  .. .. . .   ..      .          .    ...  . . .
.  ...     ....    ...     . .  .      . .  . .   .      ..      .  .  .  .         .. .. . .
.............................................................................................
