..............................................................................................
.     .   .. .        .    .   .          . ....  ..     .   .  .  .    . .          .  ..   .
.        . .. . . ..   .      .    .     .   . ...   .. .  . .          .    . . .  ..  .... .
. .. .    .    . .  .      .      . .  .. .  ...                 . .  ...   .. ..    ..     ..
. ..  .     . .     .  .   .  .  .   .   .  .      .      . .  .. ...     ..    ...  ... . ...
...  ..    .  . .     .  .  . .  .   .     . .  . .   .   ..  .   .   .     ...     ..    .  .
..  ....  .    .    . .  .   .      .    .   .  ..          . ... .   ..    .    .     . . . .
.   ..   .   .      . ....    .  .    .   .. ....    .      .   ..... .     ....          .  .
.. .    .  .... . .        ..      ...   .  .    .  .    .  .  .. .         .   .    . . .  ..
.  .     .  ....   . .  .     .         . ..  .  .  .     . .   .   . ..      .         .  ...
..  ..  . .     . . ..      ..  .  ...  .. . . .  .    .   .   .   ......          .   ..  ...
.    .         .      . .  .  ..   ..  . ...  ..      .   ...    ... .    .     .    ..    ...
. .... . .           . .  .     . .  ..      .  .  .  ..   .         ..    . .  .  . . . .   .
. .  .  ..      ...   .        ...   .     .. ..  .   ..       .    .  .        . ..         .
.  . .       .        .  .      .   .     ..  .   ...... .    .   ..  .  .    .  .. .      . .
.  ... ..   .  ..  .     .   .               ..  .     . .     .  .  .     .     . .  .      .
. . .         . ..  .   . .            . . ..      ...      .      ..         ..  ..      .. .
. .       ..  .    .. .... .      . .  . .. .. .    .      .       .   ....          .  ...  .
...... .       .. ..    .    ..   .  .   ..        .      . .             .   ..  .     .    .
..  .                 . .   ..   ..    . .  . ...  .    . ..   . . ...          .  .. .. . . .
. ..  .      .   ..      . ...    ..      ..  ..  .       .  .    .  . .             ...  .  .
..    .  .   ...    ...  .   ..       .    .      .      ..   .       . .     .            ...
. . .  .     . . ..      ...     . . . ...  . .    .. . . . . .   .    .      . .         .  .
.   .          ..       . . .       . ...     .        ..  ..   . ...  .  . .     ...   ..   .
. .  ..       . ..  ..     ...   .  .     .    .     . ...    ..   .. ..           .  .   .. .
..   ..      . ..    ..    ..  .   .         .  .      .  .   ..  ..  . .        ......      .
...    .    .     .   ...      ...  ..       ..  .   ..     .   .  .    ..  .          ...  ..
.  .        .    .   .     . .             ..   .    .      .  ..   ..  .       .    .    .  .
. .             ..        .   .   ..  .              .     .           .   . ..  .  .. .. ....
.    .    .     .     .        .   ..  .. .      ..          .  .  ..  . . .  .   .   .  .   .
.   ..               ... ...   ....    .        .  .     .    .     . ..   . .       . .    ..
.  .   ..   .  ...       .  .  .    ....   .       ...   ..    .  ..   ..     .           . ..
.   . . ... .          .   .. ...  .   .              .      . ..   ..        ..  .         ..
. .  ...    . . .  . . . ..   ...             ..   .   .  .  . .  .  ..    .       .     .   .
...        ..  .    .  .           ..  .      ....    .    ..            .  ..     .... .    .
. ..        . ..  .      . . ..  .     . .. .       ...         .   .        .  ...   ... .  .
.. .  .           .    ..    .    . .   ..     .     .       .   .      ..  .    ..  . .     .
.  .         .     .   .. .. .   ..        .     .     . ..  ... . .      ...                .
.       . .  ..  .   ..  .     .   .    . . .  ..    . .   .   .  .  .   ...     .    .     ..
...  .       .. ..    .   . .    .    .      .   .        ..       .   . . .   .    .   ..  ..
.   ..       .          .               . ....  . .   .   . .   .    .       . .        .  . .
..        .   .   .   .        . . . .  ..           .    .  .  . .  . .. .  .     ..    ... .
.. ...    .  .  . ..   . .       ...  . .      .   ... .   . .  .    . .   .  .       .      .
.X     . . ......  .     ... .    .       ..  . ..  .        .       .  .   .    .. .   .  . .
. .   ..   .   .   .     .  ..             .   .. ... .      ..   ..      ..          .   . ..
..    .  .     ..  .  ..   .   .      . .    .   .. ..  ..   .    . .              .   .    ..
.        ..   .  . .  ..   .  .     ..  .  .       .      ..   .    .....           . .    ...
. .  .  .  .     . ..  .  ..  .        . ...    .   . .. .     .  .. .. ..  .     .. .       .
.  .   ..  ...   .     .   .   .         .    . .        .  ..       .     ...       ..      .
.            . .      . . .   ..   .  . .    .   ... ...    .. . .      ...   .    ... .  . ..
.  .    . ...   ..  ....  . ....  .  .    .             .. .    ...    .          .. .   . . .
.   .  .   .  . ...... .    .   .   ..  .   .. .  . .  .             .    .. . ..  ..  .. . ..
. .  ..      ...  .. .     .    .   .   .. .. .  . .  .       ...   .   .    . .  . ..   ..  .
.          .. .. .     .  ...   .      . . . . .. .                  ...   . . . .    . .    .
. . .  .     .    .    .... .          .     .   . .        ...     ..  ....        .     .  .
.   . ..  ..    ....    .   .. ....  ..     .     ..  .   ... ..     .     ..           .  . .
....  . .  .       ..    .  .    .           .. ..       . . . ..        .   . . ...   . . ...
. .    .  .   ... .. . .. . . .. .      .  .  . .   .  .. .  . .    .  ..          . .  .    .
..      . . ..  . . . ...    . .       ..  ....  .... .   .  .       ..    . . . . .  .. ..  .
.   .. .   ..  ..   .   . ..   ..  .         .  .     .  .  . .   .    .. .    .  . . .  .   .
..  .  .    .   .        .       . . .      ..   . .  .  ..  .. .  .  .     .   .. . .... .  .
. ..  .  .        .   .   . . .         . ...  .. ..   .  . .  ..      ..  .. ..   .. ..  .. .
. .     . .            ... . .        .  . .  .  .   . ..  ...      ..     .. .  . .      . ..
..        .  . .   .       .. .      ..  .  .    .   .   . .     ..    .   .    .         .  .
...    . ..      . . .. .      . . .   .. ... .    .   ... .  . . .    .. .         ..   . . .
. .  .  .  .         .  ..                     .   ...           . .  .    . .    ..  . . .  .
. .   .  . ..  . .. .     ..  .. .    . ..    .  .        .. .      ..           .  .      ...
.   .      ....       .    .. .      ..   .    ... . .               . .. .         ..    .  .
..  .    .  ..     .  .    .   .    . .  ...      .. .   .  . .  . . ..    .    ..        . ..
.   ..   ..   .   ..        . .  .    ....  ..     .                .   . .    ..   .   ..  ..
..     . ..  . .  ..  ..         .. .   .  ..  .   .   .  .                 .            . . .
. ..             ..   .. ..    . . . ..  .   .  ..   ..       . ..   ...  ...  .       .   . .
. .   ...   .   .. .  ..      . .  .  .  . ...         .   .      .           ..   . ..  .  ..
..  . ...   .    . ...      . .    .  ...     .     . .  .   .... .   .. . .    .     .  .   .
.  . .  .     .     . ..   ...    .   .  . .. . .. .. .  .      .  .     .  .  .  .   . .    .
.     . .   .. .    .  ..      . .         ..    . . . .  . .   .   . ..   .  . .       .    .
. .  .        .  . ..      .    .     . .   ...      .. . .  .        . .  ...     . . . .. ..
....  .  .. .  . ..    ..      .  .   ..  . .   .    .. ... .. ...  ..      .     .... .   ...
. .  . .      . .  .    .   .   .     ..   ..   .  .    .     . ...    . . . . ....   ....  ..
.  .. .      .   . ..    .. ... ..  . .. .        .      ...  ..    ..  . . .      .   .  .  .
..       .    .  . ...      . ..   .     .. .    .   . .         ..   .    . .     . .   . . .
...   .  . . .          .         .        . ..    ..            .    ..  . .   .  ..  .. . ..
.    . .     . . .      .  ...         .  ..   . ....   ..        .r . .    . . . .      . . .
....      .    .   ...                  . .    . . . .   . .. . .. . .  .  .  .    . .      ..
.  . .  .     .    .  .    .     .       . .  .  ..  .  ...       .      .     .  . . .  .   .
.   .    . . . ....        . .       .. .  .     ..        .    . .    .        . .  .   . . .
....    .    ..  . .  ..   .   .    ..     .  . ..  ..  .     .  . .    . ..   .. .  .       .
.  .     .     . ..  .       . . . ...       .  .   ...   . .. .  ... . .  . .. .      ... . .
.  .      .   .     . ..        ...      .   .. .          .        .    . ..   .. . .  .  . .
. .. .. .  .  .   .          .  .    .   .. . .     ... .  .. ..    . .    . .   ...      .. .
..    .      .         . .  .   .    .              .     .  ...  . .  .    ...  .  .    . . .
.       ...   .       ..        .  .         .. .   .      .       .    .      .  ..     . . .
.    .         .   . ..      . .  . .  . .        .  . .    .  .. .  ...  ...     . .        .
..............................................................................................
