...............................................................................................
...  .   .     ..   .. .. . . .. .       ...           .. .    .   .   . . ..       .        ..
..    ..    .. .   . ...  ...   . .    .. .   .....  ..     .. .       ..  ..  . .   .      ...
.. ..   .    . ... .      .   . .    . .   ..        ..     ..  . .   .           ... .     . .
..   ... .     .     .   ...       ..   .    .   ..   .  .  .  .  .... .   .. .. ..  ..    .. .
.. .  .. .           .        .     . .  ..       ..   . ..   .     .   . .      .. .   ....  .
...              ..        .      . ..         ..       .         .  . ..   .    . ...     .  .
. .  ..  . ..    .. .  .  .     . .   . .   . .    .   ...    .. .      ..  .  . .   .   . .  .
.. ...    ..    ..    .   .. ...  . .   .    . .  .          . ..    . .  . .     . ..  .  . ..
.    .   .     .     .     .    . ...  .       . . .   . .    ..  . . . .  .     .    .       .
. .  .     .     ..  .   . .  . ..  . ..  .  .          . .  .   .  .. .      .    .          .
.  .   .. ..      ..        .        . ..      .   .   .   ..  .       .      . .  ...  .  .  .
.. ...      . .. .     .    .   . ..   .....   .       . .  ..                  .  .    .  .  .
. .. . . ..      .  .  .   .    .   .  .   .  .   . . .   ...       . .. .      .. .    ..  . .
. .           . ..         .    ...          . . .      ..         ...  . ..          .   . ...
..  .   ..  . .  . .      . ..  .    .  ...    .   . .        .     ..   ..      ..  ..       .
..  .   .    .           .    .    .    .  .  ...                  .     .   .   ..   .   .   .
.   . ......    .    . .  .  .    .              .    ....   .     .  . .    .    .    . . .  .
.     ...  .  ... ..  ...         .  .  . .     ..         .       . .    .     .          .  .
.     . . .   . .. .        . ...    ..  . ..      . .     .    ..       .  ...  .. . .  .  . .
.         .    . .       . . .    . ..   .        .  .  . ..           .  .     .   .. . .... .
.        .   .      .  .   .         .        ..  ....     ..     .   .  ..    . . .  ...    ..
.... .    .. ..  .  .  . .    .   .  . . ..    . .         .  .   . .    .    ..    .       ...
. ..  ..   .      .   .  . . ...    .   . ....   .          ..   ..    ..           .  .  ..  .
. . .   .    ..    .   .  ..  ..  .      .  .    ..         . .   . .. .  ...   ..      .  .. .
.  ..  .   ..   .. . .   . .   . . . .. ..    .  .      . .     ..         .     .     .   .. .
. .. ...   .    . . ...     .         .. ..   .   .  .  .  . .      .. ....    .        .. . ..
.   .  .    . ..    .. .. .       .. . ..          ..        ...  .   .   . . ..  . .  ..    ..
..        . .       ...   .  .   .   . ..   ..           ..           ..    .    .      .   . .
..                      .     . .  ..               .       .            ..  .. .   ...  .    .
.      . ....             . .. .      .       .  ..  ...  . . ..   ...     .   .  .   . .     .
.         .      .    . . ..   .. .       ... . ...  . .   . .    .      ..      .      . .   .
.      .     . .    .  ...    .        .         . ..   .    .       ..   .... . .   .... . . .
..  .     . .    .  . ..   .    .     ...... .  .  .  .  .  .  .   .  .    .    .. . .   .    .
. .  .     ... .. .  .  . ..      .  .      ..  .   .       .  .   . . ..   .  ..      .    . .
. . .  .  .  . .    ...  ..  .  . .    ..                 .  ...  ...        ..        ..     .
.            .  .       .   . .  .   .     .    ..   ..     .           . .  ..    . .  . . . .
..   ... ..    .  .  .    .  .   .             .. . .   ...  . .    .. . .   . .        .  . ..
. ..   .      .  .. . . ..  . .   ..  ..     ..  ..     . . .   ..  .    ..  .   .    .       .
.     .       . . . ..   .  . ..  . . .       .       .      ..  .   .  . .       ..      .   .
.        .     .  ... .   .          ..     ..         .         ....     .   .  .   . . .  . .
. .     .  .   .  .     .    .   ..      ..  .     . .   .            .   .   .     . . .. ....
..  . ... . .   .. .. . .       .   ..   ..      ...   .      .   .... .... . ...  ..        ..
. . .      . ..       . .     .   ....             . . .    .  .   .    .   ..    . ...      ..
. .  ...   ...    .. .  .  .       .      . . .    . ..    . .  .    .       .           . .  .
..  .    .  .   .. .      ..          ...      .  .      . .        .   . ..         . .  ..  .
.     ..  .  . .   .  . .        .     ..       .. .     .      . ..  .   .  . .   .. .  .    .
. .  .  .    .     ..      .  . .  .    . ..     . .       ..    .....   .  ..  . .  ... ..  ..
.     ...     .   .      . .    . ..       .      .    .     .              .     ..   .. .   .
...  ...  . .   .      .  .   . . .  .          .   . ..   .   .    .       ..  ..   ..   .  ..
. . .     .  .    .. ..     .  .       .   ..  . ..     .  ..   .    ..         ..  .       . .
. .      . .  .   ...    .    . .. .         ..     ..  . .     .     .  .  .   .. .  .   . ...
.   .         ..    .   .   . .        . .    ..  .. .      .   . .. .  . ..         ..   .   .
.       ....  . .    . . . . .  . ....   .  .   .. .  .  .   .. ....    . .   ..   ...        .
.     ... ...  .     .   ....  .   .               .     .        .    .  .        .   . ..   .
..   .. .        .                 .       .  . ...        .  .      ...    .   .  ..         .
.  .. ..  .  ..       .    ...  .  .   . .        . ...    .. ..         .    ... .    .      .
..      .   ..     .         .    .      . .. .           .    .          .  . .  ..  . .  . ..
...   ...    ..    ..  .   .   . .    .   . .  .  ..   . . .  ..   .  . .    .  . . . .   .. ..
. .. . ..         .      .   .   .   . .    ..          .   .. .  .     . .   . .   .  . .   ..
..  ..  .  .  .       .. .. . .. .      .         .             . .          .  ...   .       .
.. .    ....    .       ..     . . .   .   .. .    .   .   . r   .    . .    .. .  .  .       .
.  . . .          .         .  .. . .  .  . .   . .      .         .  .   ..    . . .  ..  .  .
.  ..     .  ... .  .    .    .    ..      .  .  .      ..       . .      .. .  ..  . .     . .
.  .      .. .. .   .  .    .. .  .    .     .     .     .      .  . .    . .     .  ..     ...
. .  .   ..   . .   . .    ..  . ..       ..  .  ..       .    .   ..  .. ..    ..       ...  .
.. ...      .    ..  .      .     ...       . .    .   .   .     .  . . ..  . ..      . .  . ..
.    .  . . . .. ...  . .   ..  ..  .      .   . ..     ....     . ..      .             . .. .
....  .  .  .      .    ... .  .      .   ..     . .   ..         ... .   .      ...  .. .  . .
.         ..    ..  .      .. ..   .  . ....       . .    ...    ..      . . .  ... .   ...   .
.   .      .  . . .       . .    .  .   ..   . ..    ..  .       .  .... .     . .   . .  .  ..
. ...... .  ..  . .    .....  ..   ..   .  . ... ..  .. .        ..      ..  .    .     .     .
.     .  ......       .       .    .  .       . .  .  . ..     .   .. ... .       . ..  ... ...
. .      .. ....                   .    .   .. . ...     ..                  . ...    ....    .
.  . . .    .      . . .    ... . . .          .   . .    .  .    .  ..     .     .  ..   . ...
....    .  .   .. . .    .   .      .     .. .    ..    . .      .   ...  .  ... .    .. . . ..
.         ..        .  .. X. .       .    ..  .  . .. ....             ...  ... . . .   . .   .
..  .   .      .   . .  .. ..  .     .    ...  ... . .   . .          . .  .  .       ..      .
..      . .  . .... .    .   .         . ..   . ...            .   .        . .  .            .
.      ..         .    .   ..   ..   .       ..  ..     .   ..  .. ..   . .   ..     .    .   .
.... ..      .  ..    ... . .    .      ....     . .    ..        ... .        ..    ... .    .
.  ...       .   .    . .  . . .. . .  .       . .  .      ..  .    .   .  .  .  .      ...   .
. ...  .   ....  .. .   . . ... . . .   . .   ..    ..      . .   . .    ..      .. .    .    .
.  ..    . .. . ..  ....       .   .      . ..   ..   . .... .   .     .  . .. ..           ...
..   .  .    . .     . . .. . .    .   .         . ..  .   .   ..            .  .   .  ... .  .
. ..   ..     ..... .    .       .  .   .  . . ..  . .    .    .   . .    .  . ..  .     .    .
. .    .  .  .   . .  ....       . .  ..            . . . ...    .    .  .. .     ...  . ..  ..
.. . .     .    .. ..   . .        .. . . .  .             .    .   .  .           ...       ..
. .    .        .   .           ..  ..    . .. .  . .  .  .  .    .   .  ...  .  . . ...   ....
.   .. . .   .   . .      .      .  .   . .         . ..       .        .  .           .  ... .
..  . ....  . .  .         .     .  .     .     .   .. .  . ..  .        . .  ..    .  .   ....
.  ..    .  .  ..   .   .       .    ..   . ... ....     . ..        .  .       .  . ..       .
. ...       . .     .    .    .    . ...   . ..    . .     .     . .   .  . . .  .      .. ....
.           .   .  .       ..  . .         ..      ..  ... .   ..    . .  ...  . ..           .
...............................................................................................
