................................................................................................
. ...   .  . . ..    .  .  ..  .   .   ..   .  ...  .            ..   ...          .   . .  .  .
. .  ..            .    ..  .  . .. .  .   .      . .   ...   .     .   . . .      .   .  .   ..
..  . .    .    .. .  ..   .   ...            .  ....              .       .  . .  .   ....    .
.  .      . ..    .      ..     .    . . . .    .. ..   .   . .   . .   .  .       . .     .   .
....  ..  .  ..  .    .  .     .        ..  .. .      .   .  .    .. . . . ..   ...      . .  ..
.     ..  .   .      .     . . . .   ..       .   . .    .         .  ..    . . ...  . . .. . ..
. .. .   ..  ..     .    ..   .   .  ..   . .   . ..      . .   . ..     .          ... ...    .
.     .  ...   .  .         ..   . . ..        .     . ...    .    ..   ...   ....  .      .  ..
.... . .  ..    . .      .          ..       ..  ..       ..   .     ...   ..      .. . ..     .
..  ... ... .. ..  .  . .         .. .  .          .... . .. ..   .. .       .  ..  . ..   . ...
....   . .     .. ..  ...    . ..    . ...  ...      .             .. .    . ..        . .   ...
. .   .  .  ..... . .      .. .      .  .  . ..   ..   .      .     .      .                   .
.. .. ..       ..  .  .     .       ...  .  .           ..      . ..      ...    ...  .        .
.  .     .   .     ..   .  . .      .  ..  . .  .   .    .            . .. . .   ..     ..   . .
..  .     .    . .  ..   .  . ..   . ..  .     .    . ..   . .  .  . .      .   .  . .. ..     .
. .    . . ..   .  ...  .      .  . .   ....   .    .. . . ..   . . . .  ...  . .      ...    ..
.  .   .        ..      .    .   ...   . . . .   ..    .  . ..  ..   . .     .  .  ...    .    .
.  .  . .    .  . .  ... .    .   .  . .   .    .  .  ..        ..  ....       .. ..    .      .
.     .   . ...   .     .    . . .    . ..       ..     .   ..  .      ..     ..       .    .  .
...      ...       ..    ..         .   .    . . . .  .         .  .    . .   .  ... .      .  .
.. ..  ...   .     .    ...  .  ..          .      . .  .... . .   .      . .  .          .    .
. .          .   .   .   .   .  ...  . ..  .   .   .. .   ..    .      .  ..          . . .   ..
..      .   . .   .      .. .   .  ...  .. .  .     .  .    .   .  .     .  .         .      . .
.         ... ..   .. .  . ..     ..  ..   .. .    . . ..  ... . .. . .   .   .      .    .   ..
...           . . .. ..  .. .        .     .       .          . ...   . . ...   . . . .  ...   .
..    ..     . ..   . .. .       .. . ...  .   .           .    .     .       .         . ...  .
..         .   ..  .   .  .     .. .   .  .     ... .   .. .     . .        . ......   ...   . .
. ... .    .  . . .    .   .    . .             ....      ..  .   ..         ..     .      ..  .
. .   .... ... .  . .      .    ..   ...  .  ..    .    . ... ...    .      ..    .     . .    .
. .   .       .   .     .  ... .     ...   .  ..   .           . .  .  ..           .   ...   ..
. . .. ..   ...     .              .  .        ..     . .  .         .  . . .    ..  ..        .
.  ....      .  .   .  ..     .  .    .  . ..   . . . .    .. ..         .     .    ...      . .
.  . . .  ..    ..  .         .... ..  .     . .  .  .  . . .  .    .    .  .    . .  .  .     .
.  . . ....        .. ..  ..        . .     .  . .   .     ...   .. ..   ..       .  .  ... .  .
..      . ..       .   .     ..  ..  .  .... .   . ....   .   . .    .   .    . .  . .      .. .
..  . . .  ..  ... . .   . ..   .   .    ...     . ... ...  .   .. . .. ...     ..   .      .  .
.     .      .      . .    .   . . ..   .     . .    ..    . .  ...    .     .     .    ..     .
.. .    . .    . .. .         .       .    .. .    .   .     ....   .   .        .     ....   ..
.. .  ..          .    .       .  .. .   .. . .. ....   . .  .  .      . ...      .        .   .
.   .r        .  .   ..   .    ..   ..   . .    .     ..    . .       .       ...    . .  .    .
. ..  . ..         ..   . .      .. .    .      .    .     .   ..     .        .      .        .
. ... .    .   .    ..       . ... ..      . .. .  ....   ...  .    .  ..   .   .     . . .. . .
.      .           .   ...       .. .  ... .    .        ..     . .   ..      ..   . ..  .  ....
.             .  .   .   .   .    . . ...       .          ..     . ..   .         .. ...   . ..
.        .  ..   .  . . .   . .  .    .       .   .        . ..  .       .  .   .    .  ..     .
.   ..     .          .     .  .     .      .. . ..   ..   .   .. . .     .   .  . .   .  . . ..
.         .   ..    .     . .  ...  .     ..         ..  . .        .    .        .   .   ... ..
.   .   .  .   .         . ..   .   ....      . .. ...    ...   .  .   .  . . .  .           . .
.. .       ...  .        ..   .      .   .   .  .....   ..     . . .. . ..        .  ..    .   .
...    . .. .    .   ..   .   .. .  .   . .   .     ... . .  .  .    .    .    ..  .         . .
.  .   . .  .       ..     ..  .       .          ..  ...   ...  . .      . .. .    .. .. .  . .
.        . .. .    . .  ... .   .. . .     .   ..          ..  .. .   .  . .    .  ......   .. .
. . ... .. .          .  . . .      .      .    .   .    . .   ..           .     .       . .  .
..  .  . .. .        .   . .          .    ...  .    ... ..        .          .   ..           .
. .      .. .  ......    . .   . .        .        .  . .         .    .      .           .. . .
. ... .    ..          .  ..       ..  ..    .  .       .  ...      .   ..   .    .        .  ..
. . .    ...  .  .  ...  ..   .. .. ..        ... . .     ..  ..       ..  ..     ..   . ..   ..
..     .  .    .       . .     .          ..  .       .. .   .  .  ..  .  ... .. .        .    .
.  .  ..        .  .               . .. ... .   ...  .        ..   .  . .   .  . . . .       . .
.   . .. .   .         ...    ..  .     .  . ..    .  .   .   .   . ..        . . .  ... .   . .
. .  .                .  . .. .  .    ... ..           . .       ..    .        .       ..     .
. ..   .  ..   ....      .. .      .   . .  . ..  .      .    .    . ..       .   .     ..     .
.    .  .. ..     . ...    .      ..   ..   . .   ..  .     .       ...      . .  .    . .  ....
.       . .  .  ...  .       ...  .  . .  . .       ..    .     ...   .. .. . ... . . .    .   .
. ..   .      .  ..   ..  ..      .   .   .   ... ... .. .     .  .   ...   .     . .          .
...   .       ...   .. ..     .... . .     .     . .         ..    . .      .      .   .       .
.    .   .  .. .. . .. ... .  .   ...          ..   . .       ...  .   . .. . ... . .  . .. .. .
. .  .      .      .   . .  .    ..         .    . .           .   .      .. ... .   .  .  ..  .
.    ..   .    .    .    .  .. .    .    . . .       .    . . .    .       . .  .  .  ..    .  .
.   ..        .        ... ..  .      . .     ..     ..  . .   . ... ..  .     .  .     ..     .
.   .  ... .      . .     .  ..         .    . . .    .      . .  .                . ...     ...
.   ..  .   . . ....  . .. ..         .  .     .  . .. ...               ...           ..      .
. .  . .   . .. . .   .   .. .  .  ...       ..         . ... .  .     . .  . .   .. ..    .   .
.     .. ....     ..      .   ..        .X      . .   .    .       . .            .  .   .     .
. .            .    .      .        . ..      .  .. .   . .       ...     . ..      .   .... . .
.      . . .  . .       ..        . . ...   .  . .       . .  .        . .      .    ..     .. .
.  .      ...    . .    .. .        . .   .. .     .    . . .   .. .     . .    .    .    . .  .
.     .. . ..    ....     .  ..       ..  .      .  .      ... .    . .. .           ..  . . . .
..   .     . .    ..      .  .   .    .    .. .. . . .  .  . ... . .  .     .  . . .    ..   . .
.   . .       . .   ..    ...   ..   .  .  ..    .     .  .     .        ..       .       ..   .
. . . .         .  ... . .    .  ...     . .   .  .   .   .   .     ..        ..  .. ..    .   .
. .    .   .. .      .  .   .     .  ..    ..     . .  ..  .      .    .  .   ... .    .. .    .
. ..         .... .  .  .   .. .         .....    .       ..  . .. . .     . . ..          . . .
..   ..   . . .. ..  .            .    .   .  .  ..  ..  .   . .   ..    .  .  .        .  . . .
.          . ..   ..        .    .     .. ..  .    .   ..   .       . .   ...  . .  ...  .. . ..
.   .  ..   .  .          .. ..    . ..   .    ... ..  .. . ..        .  .      . . .         ..
.  . .         . .    . .      ... .            .  .   .        .    ...  ...          .     . .
..  .     ..       .   . .        . .. .  .        ..  .     .  .   .        .     .  .      ...
.    ...       ..   .  ..      . .      .      . .      ...  .       .  . .    .   .   .      ..
.         ..      .           .. . .    . . ...           . .     . . . . .  ..     . ....   ...
.    .  . .  ..     .. .   . ...   .    ..    . .    . .        . .      . ...            ..   .
.     ..   .  . ..  .      ...      . ...      .              . .    . . . . .      .   .    . .
.  .    ..  ..  .  .                        . . .  . . .  .          .    ... .  .    .   .   ..
...      .        .      ..        .. .       .....   .    .     .. .. .  .     .  . . ..    . .
................................................................................................
