.................................................................................................
.   ....  .     ..    .  ... . .  .        .    .  ..        . .   .      .  . ....       .     .
..  .     ..  .    ..         .   .    .  .  . . . .        . ..   ..   . . . .  .     .  ..    .
.       .           .     .              .           .  .   . .    .        ..  ..  .     .  .  .
.    .      . .   . ...       ..  .      ..  ...    . . .. ..     ...  ... .. ....         ...  .
.   .   .              ...  .     .   .     .   .                      ...    ..          .  .  .
..  .. ..    .    . .  .     ..      .           .. .. .  ..           .   . .    ...  .   .   ..
.  ...     .     .  . ..    .    .   ..  .  ..   .  . .    . .   ..  ..   . ..   .        .   . .
. .  . ...    . . ...  ...      .  .  .        .    .     . .    .     . .  . .   .  .   .  ... .
.  ..    .   ..  .    ..        .. .  ...  ..   .    . ..  .             ..   . ..  ... .       .
.  .  .         .. ..     . .      .   .       .  .  .. .   .   .      ..  .  ..  ...   .       .
. ..  .      . .      . .. .     .   .  .   .     .    .   .. ..  ..   ..  .  .    .  . .  .    .
. ..          . .  .  .     . .     . . .       .  ..     .   ...   .. .....  .     .. . . ..  ..
.   .   .  .          .         . .. .  ...           ...        ....   ..   . ..       .. .    .
. .  ..            .   . .  ... .       .           .    .  .  . .   ..     .   .       .  .. ...
.   .   . ..  .  . .. .  .     . .   .  .      .   . .. ...     .  .   . . . .      .    .  .  ..
.. .      .     ...    ..  .      ..  .  ...     ..       .       .   .     ..    . . .      .. .
.   ..   ..  .           . . .              . .  . .     . .         .     .   .     ..   .. .. .
..    ..    .        .   ..    .       .  .           .  .                ... ....    .    . .. .
.   ..  ..      . .    . .  . . .  . .    .   ..          .    . .     ... .    . ..  .  ..   ...
.   . ....  .    .  .  ....    .            .  ..    ..               .             . . .  .    .
..  .   ... .   . ..        . .. ..    .. .... ... .. ..  .. ... .  . .  .  ...   ..         . ..
. .        ....     ..  ...   . .         .. ... ...  . . . . . . .     ... .     .    .    . ...
.. .  .           .  .  .  .  . .       .    ... .... ...     .   .  .       .  . .   ....  . . .
. .         .    .  ..     ...     ..    . .   . . .. .. . .  ... ..  ..      . .         . . ...
.    ..  . .        . .    .   ..  ... ..    .   ..     .  .   ..      ..  . ...   .   ..   .   .
.   ...  . .    ...    .. . .  .. .    .  . .    .  .    .. . .    .  ...    .  ..    .    .  . .
. .. .   .      .             ..  ....      .   ...             .. ..    ....    ..     . .  .  .
. .. .      ..... .     . .. .    .... . . . . ..   .   . . .    .  .  ...    .    . .  .      ..
.    .. .  .   .      .  .    ...  ...  . . .      . . . .  .   . .      ..    .. .        .. . .
.  .  . ..  .  .   . .      .   .   .  ..        . .   ..    .   . .       .   .   ..  .. .   . .
... .    .    . . ...     .      ... .          .      .  .    . .         .  .  . .    .   .   .
. .. ..   .    ..    .  .. . .      . .. .   .  .  . . ..   ..      .   .    .  .  .. .   .  . ..
.   .  ...  . .. .. . .   .       . .     ..       .   ....  .    .         ..  ..   ....   . ...
..       ....     .. .    .  .       . ...   . .              ..   .          ...      ..  .   ..
.           . ..  .  .   .               .        . .       . . .....           .... . .    .   .
.. .  . ... .  ..    .. ..     .      . .    ...    ..  . ......       .    .     .   .  ... . ..
.     .   .     .  .  . .  .    .    ..            .    . .    .   .          .. .  ...     .   .
.     .       .    .   . ..   .  .   . ... .  .    ... .        ..  . ..    .. . .  .   .      ..
...  .  . .  ..      . .    ...   .        .. .    .. ..     .  . .  .   ..   ..    .          ..
. .   ...     . .        ..   .     ..    ...   .     ..  .      ..  .  ...      ...        . . .
.    .    .    .        . . .  . . .... ..      .... ..   r .       . . .  . .   .    .  .  .   .
.  . .      .     .   . .               .  ... . .             ...     .     .             .    .
. .. . . . .    .       .          ...   ..  .  .  . . ..  . .   .      . .... . . . ....    . ..
..            .....  .  .           . .   .                   . ..  .   .   .    . .  .        ..
.  . .   .. .           ..       .     .. .   . .. .    .     . .  .  .. .  .  . .   .. ..     ..
.  . ...  .   .     .      ..  ..            .        ...            .    .  ...      . .   X.  .
....               .   .      ...     . . . . .   .    .       ..        . . .            . .. ..
..    .  .. .  .  . ..       .    . .    .. ..  . ...  ...    .       . .  . ..   .  . . ... ....
.    . .... ..      .    .  .. .  .   .    ..  . . .  . .     . ..    .... ..             . . ...
.          ...  ... ..     . . .    . .    . ..     .   ...    ..  .    . .. . .       ..       .
. . .   .            .  ..      ... .  . . .  ..        . ..   ...       .   .  ..    .  ..     .
..    .  .   . . . .  ..... ..     .         .  .  .  .    .  .       ..                  .  . ..
. .  .          .  ..      .  . . . .   .   .       .  .. ...     .    .     .          .. . .  .
.        .  .    .         ..      .   .  .     ..  ..       .  .  .. . .       . ..  .  ... .. .
.  .                 .  .   .  ...      .   ...   ..     .. .    ...       .       . .   .      .
.  .     .    ..  ..   ..   .       .   . . ..  . .. .. . .. .       .      ..  .         .. .  .
. ..  .   . ... . .   . . . .. . .               .     .    .      ..             .  .  .  .    .
.  ... .   ... .      . . .. .         .   .. .      . .              .   . .    . ..     .. .. .
. ..       ..    . .     .      .     ..    ..   ........    ..         .       ... . . ... . . .
. ..       ..  . .            . .   .   .      ..   .  ..     .. .  .       .        . . ..   ...
.  ..     .. .    ..     .  ..       ..        . .  .       ..     .   .  .  .   .   .  .   .  ..
.                .   . .   ...   .   .  .  .             .  ..      .  .   ..  .  .   .  .     ..
... .    .       ....   .    .   .. .    .  .. .      .  ....  .    ...   .    .   .          . .
...   ..   .    ..  ... ... .          .     .       ..   .     .. ... . .  .    ....   .  .   ..
.   .   .        .   .  .  .     .     .     .    . .     .  .       ..    .      .      .   .. .
. ..  .. .     ..   .    ..    .    .. .. . .. ....  .     .    . ..    .      .        . .   . .
. .        ..      . . ..  .. .   . .         . . .   ..       .         .       ..      . ..   .
...     . .  .     .       ..    . ....     .    .. .      .  .   .  . .     ..  . .. ..  .     .
. .     .   . .  .  .   ..  ..  .     ...    ..   ...   . ...          ..     .  .  .  . ..    ..
..  .  .         .   .       .. .    .  .  ..   .   .   .  .  .    .     ..    . . .... .. ...  .
.  .            ..    ..       ...       ... .         ... ..  .          .  .. ..  .  . . .    .
. .      .     ..    .  .    . .  .  . .      ... .      .     . .  ..   . . .        ... .     .
. .      .  .. .  .    . .    .        .   .  .   . .. .    .      .  .   ...          .......  .
.  .. .    .   ..      . . . .  . . ...  ..  .   .  ... . .        ..   .    .         ..    ....
.       ... . .    ..  ..   ..    .     . . . .. ..   .     .  ..      ...     .     .   .  .  ..
..     .      .  ..      .       .   ..  .     .. ...   .   .       ..  .      . .. ..       .. .
.         . . ... ....    .  .  .  . .. ..          . .   .  ..    .        .      ..           .
... .    .  .   .      . . .. .    .   .    ..     ..  .    ...   . .    .  .. ..  . ...   .    .
. .     . . .. ..        .   .. ..  .. . . .  .      . ..    .      ... .   .   .       ..      .
.           .....   .   .  ..     .        .     ..      ..     ..    .   .                . ....
.  .. .   ...             . .    .  ...     . . .     .     .     .     .      ... .    ..     ..
.       .  .   . .     .    . .      .    .     .     ...       . . .  .    .  .     .  .   . ...
..    .  ..      .. .  .  . ..    . .  . . ..  .    .   .           ..           .      . ..   ..
..   . .  .. ..    ...  .. .         ....       . . .   .. ...  .   .    ...         ..  .   .  .
. . .      .. ...  ..    .        .  .  .    ....     .    .   .   .   .. . .    ... .      . . .
. .   ..   .   .. .           ..  . .    .. . ... .        .  .      .              .           .
...  .    .    .           .      ... . .       ..      . ..    ..  .   .. .   .  . .... ..     .
. . ..      . .      .  . . .. .  . . . . .   .. .       ..  . ..    .  .    .   .    .   .  .  .
. .     .  . ... . . ..  .      .. .  .     .  . . ...   ... ..      .  . .   ..      .     .  ..
.  .   ...   .  .  .    .....  ..        ....    ...   .         ..      ..   .    .        .. ..
.    ..               .  .  .     .               . .  .     .    .     .. ..    . ..          ..
.  ....      .   ...   .     . ..   .  .  . .       . .. .  .      . .    .. ..  . .            .
. ... . .. .      .  .    .  .     .        ..              ..   .         .   ....  ... .. .   .
..       ..   .. .   ..  .  ..        .  .  .     .. .  .   .    .      .   .   .      .  .   . .
.  .  .    ..   .   ... .          . .      .   .  ..    ..         .... .          . .      ....
.................................................................................................
