..................................................................................................
.  .... ..  . .  .    . ..   ..   ...     . .  .  .      . ..  .   .   .  .    .   .  . . . .    .
.    ... . . ..    .    .     ...     . ..         ... .      . . . .       .      . . .  .  . . .
.. ..      ...  .  .      ..        ..     ..  ..      .   .  .     .  . . .    . .. ..  .  ..   .
. ..        .. .   ...      .   ..         ...  .. ..   .    . ..   ...  .. .           . .     ..
.   .  .    .    . .    . .. .    .   . .   .       .  .          .    .     .  ...          .   .
..     .. .   . .            .          .             . .    .   .   .        .      .     .     .
. ..  ...  .  ..               .            .           .       .. .. . ...    .         . . . . .
. .. .  .  .. . .      .          ... .    .     .... .   .          . .  ..     ..  .    .    . .
. ..        .. . .      .     ...   .       .   .   ..   . . .   .  .     .  .   ......    . ..  .
.     .  .     .     .   . ..  .    .  ..     .     .   ...      .   .     . .     ..   .     .  .
.  .     . ....  ..  .  .   .... . .     ..   ...  .     . .   ..   .    .  . .. .  .         . ..
.   .  .  . .    .    .  ..          . .    .  ...    . ..  ..            .. .      .         ....
.. ..     ..  .       . . .  .   .  .     . ..   .                . .       .   . .     ...     ..
.    ..  .   ..     ..      .  .  ..            .   .....   . .. .   .. .         .      ...    ..
.   .. . .              .     .   .  .     .         .  ..            ..  .   .  .         .    ..
..    . . . . ..          .     .    ...       .    .   ... ..  .    ..   .. . .  ..   .    ...  .
.      .  ..    .  .     ...      . . .  .       . .             ..  .      .    .  . . .  .     .
. .   . ..     . .   .. .  ....      .   .  .        .  . . . ...  .     .         .  ..   .  .  .
. ...           ..     .  . .  .   .   .     .  .   .. ..     . . ...       .    .   ..  ..   ....
.. .      .      .  ....   ..   .    .   . .       ..   .. ..  .            ..   .      ... .    .
. .  .... .   .     . .    ....    .  . .. .. . . .          .      . .  ..           . .     .  .
.       .          .     .. ... ..      ..  .    ..  .    . .    . .     . .      .  ..    .   . .
.         .     .   .     .  . .    .       .            .    .  .   .. .  . .     ..    ..   .  .
.. . ..  .      .   .   ...    .   ..  ..  .   .  .....      .. .  .  . ..    ..              .  .
.  . ... .      .       ..  . .        .      .  .  .  . .        ... ...    .  ..   .  .. .  .. .
.. .         . . .. .  .    .. . . .    .   . . .   .  . .   ..  ..  ..            ..  .  .      .
.  . .. ..  .  .   .  .. .. .  .  .     .    .  .. ... .   ..    .  ..     .  ...   . .     . .  .
. .       .     .  ...           . .   .           .    .   .      . .     ...  ..     ...   ..  .
. .  . ..       .   .    ..  ...  ... .       .    .     .. .   . . . .  .  .       ...   .   .  .
.                .      ..     .   . .   .           .   .       .    . . .   .   . .     .  . . .
...  . ..      . . ...    .   .   .  .. ..  .  ...      ..  ..       .     . .   .    .  ..   .. .
.            ...    .    .    .   ..  . ..   .     .   . .      ..     ... ..               ...  .
.. . .     ..      . .. ..   .   .          .  .    .. ..    .   .        . ..          ..    .. .
. ..    .   . . . ... .  .  .       . .    ..        .  . .        .   . .         ..  . ...     .
. .  ...    . .  . ..... ....    . .  . . .   .   .. .    ..     .  .  ......         .  . ..    .
.    .         .  ..      .   .    .   .      .   .       ..    .    . .      .     .  .  .  .  ..
..           . .  .   .  .         .  .. ..  .           . .      ..  .  .     .   ..   .   .. . .
.      .    ... .   .    .  ...  ..         ...  .      .   .  .    ..  ..             .     .   .
. ..     . .... ..     .. .     .  .   ..      ...      .   .   . .  .      .. .  ... . .       ..
.  ..   .         ....    .     .     ..   ..   . .     .      .  .      .  . .        .  ..  .  .
..   .  ..  .. .  .       .       ... . .. .  .....    .     .    .  .        .   ..      ..   ...
.. .  .    .   .. .  .     . .. . .. .     .      .. ....      . ... ....    ..  .     .      .. .
.  .        .      .        .    ..  .   . .     . ..   . ...       ....     .   .        .      .
.. . .. .. .  .   .  .       .   .               ..    .. ...      .        .  .   .  .. ....   ..
.      .   . .  .     .   . . .. . ...  .     .. ..     . .             .     .    ... .        ..
. .      . ..   ...   ..   .   . . ... .  . ..   .    ..    . ....       . .  .. .       .....  ..
.      . .  .          .        .      . .                 . .  ..    .    ..    .        . ..  ..
....  .. .  .    .      . .. ..    . . . .  . .   ....          .  .   .  ... .  .  ..    .      .
.         .  .. .. .  . . .   ... ..   ..   .         .   ..    . .  ...    .. .   .    .     .  .
..   .   ..    .  .   . ..     . .     .     .    . .. .. .  .  .      .   .    . ..  .  .  .    .
..  ..       .     . . ..       .   .  .   ..      .         .   .    .    . .     .  ..        ..
..        . .    .  .  .  . .         . .   .    ..       .    ... .....       . ..   ... .  .. ..
. .     .. .. .           . . .    .    .... .   .         .   .     ..  .     .  . .    .   ... .
.  .  .        ...  .   ..  .   . ...   ....   ...  .    ..           ...  ..     .. . .   ..  . .
. .   .      .   .      ..   . ........ .     . ..  .. ..    .    .     .    .   .   .  .  . . . .
. .  ..   .      ..             . ...   .   .  . ..        .  .  .  .... ..                  . . .
.   . .    .  .. . . .     . ..   .     ...    .       .    .       .     ...     .  ..  . .. .  .
.     .  .   ..    .  .   .    ...         . .      . .        .  .   .  ...          .  .  . .  .
.              .    .  .  ..   . .   .  .    .   .       .        .        ..  ... .         .   .
. .     .  .  .  . .. ..   . ..   ..   . . ..  ...    ..... ..    .. . .  .   . .  .     ...    ..
.. ...  .   ...  .   ..   . .. .. . . ..        ..  ..   .    .  .  .       .  ... .   .         .
.   .     . ..  .        .   .  .  .    .  ...         .   .   ..               . ... . .     ....
.    . .      .  .   ....      .       . .      .    .. . . .   ..  .               . .   .   .  .
.    .     .       ...   .   ... . ..     .  .       .  . .  .   .       .  .       . . .   .   ..
. ......        .      .     .  .             ..   . .        ....  ..     .. . .   .  .  ... .. .
...     ...  .. . . .         ..        .  .    . ...          .    .  .. .  .. .   .X.   .  .   .
. .   ..      . .  . ... . .      .  .     ..    .  . .      .     .          . .  .      .  .  ..
..     .   ..          . . .  . . . ...   .    .   ..   ..  .         .        .   ..       .  . .
.        .      ..  . .           .. .. .     . .      .  . . .     . .   .  . ...  . ...  ..  . .
. . ..   . .  .   .      .  .   ... .     .. .  .  .    .   .    .   .   .  ...  .  .  . .. . .  .
.   . .  . .  ..     .   .    ... . .   . .   .    . .    . ..   ....  ..       ... . ..  .      .
. .   ...    .. ..        . .  .  .. .. . .......   ..  ..        . .. .  .    ...      ..       .
.. .  .        .. ..      .   ..    .  .         ..  .    ..      ..  . .      .   .  .        . .
.    . .   ...    ..               .          . .      . ...        .  .     ..  . . ... ..  .  ..
.  .. . .  . .    .      .     .. .   . ...      .    ..       .    .   . ...        ...   .   ...
.  .  .  .  ..     .  .                  . .  . ..        .  .     .     .    .   ..  .      .  ..
.  .. .  ... .  .  .. .   ...  .         .      .. .     ..      . .... .    .. . .  ...    .    .
..         ..    . ..  .  . .        .     ...    ...    ..    . .. ..  .       . ..   .    ..   .
.  .    .  ...        .. .          .  .   .. .       . ..    . . .      ..  . .     .  .      ...
. .    . .  .   .  ...   .    .  .        .. .  .       .    .   ...   . .       ..     . .  .   .
.    ... .  .    . ...  ..     . .  ..  ..  ..  . .   .    .  .. .   .   .         .  .    ... . .
.   .   .  . .   ...         . .      . ..  . ..  ...    .            . ..    . .    .   .      ..
..  . .        .  .   ..          .     .  .      ..    ..... .   .    . .   .  . ... .   ..  .  .
.     .  ..      . .   . ..   .  .  ..... .     .     . ...    . ..  .      ..    .   ..  ... ....
...      ..      .   .     .    .      . ..  ...        .. .         .   . . .       . .   . . . .
.  .  .   .  . . .  .         .   .  ..    .  ..  .  . .    . ..      ...      . . .. . ..    .  .
.     . .        .  ..... .  . .   .  .  ..    .     .  ..  ..  .   .   ..        . . .   .. . . .
.      ..   . . .  .            .    .           . . .      .    .  ...   .       .    .  ..... ..
... .  .       .   . ..   ..  . ...  .  .   .  . . .      ..  ....     .      .     ...   .      .
... . ..  .     .   .   .        .           .....  .   ....        .         .  . .. . .    . ...
.      ..       .        .   . .   . ...    ..   .   .  ..       .       ...   .  .           . ..
.. .    ....    .     ... . .   ..  . .    .       . .    . .        ... . ..         . .  .   . .
. .. .     ..     . ...   .  . ... . ...  .       . .    ...  .   . ....  .   . .  .       . ..  .
.  .   ...   . .   .. ..   .                 ..     . . . .  .   ...            ..     ...  .   ..
. . .         .    .. .. .  .     .  ..  .     .   .. . . .  .. .  .       ..     .    . .   .   .
.    .          .  .  . .       .       .    r.   ...   .  ...   .. .   . .. . . ... .  . . .   ..
..................................................................................................
