...................................................................................................
.. .        .    .   . . .             .    .  . .    . . . . .. ...  .     . .. . .      .   .. ..
.      ....... .   .  . .  . .    .  .   . .    .    . .         . .   .   . .      .  . . .    ...
.   .. .   .    .  .   .          .     .    .       . . .              .. . ...    .    . ....  ..
. .       . .     .             .  .. ..     . . .     .     ..      ...    .  .                  .
... .           . .            .  ..     .              ..     .  . .. . .       .    .       .  ..
..              .  .. .    .   .   ...    . .....  . .. .  .    .    .      .       .. ..   .  .  .
..  ..     .. . .. ..  ..   ..   ..  ...  .  .     .   . .    .. .  .     .   . .  ..   .     ..  .
. ....       .  .. .      .    ..   . . .  .   ..       .         . .   .       . .. ..    .   .  .
..            .    .     .   ...  . . .  .  . .. .  ..          .       . .  . ..  ..    . .  ..  .
. ...   ...   .   . . .         ...... . . . .     ..  .     .  ..  . . ..    .             . .  ..
.  ..  .   .  .  ..         . . .. ..             . .   .      .     . .        .  . . ...  . .  ..
.   ... ..   ..   .   .        . .. ....   . . ..     .     ...   ... . ..  .    . .    . ..      .
.       .  . .   ... .  .... .     ....     .. .          .          .  . .          .  .  . ...  .
..         .    . ..  ... ...  ..      .   .   ..      .          .   .  ..   . .. ...       ...  .
. . ..    ....       .    .    . .    ... ..  .   ..    . .    .  . .. .  .. . . .   . . ..  . .. .
.  . .  .. .   ... .   .  .        ..     ..        . .  ..      . . .  ..            .     .  .. .
.  . .  ..   .  ..   .   .  .. .      .   .  ...  .. . .       .    .  .   . .   .     .       .  .
.     .      .   . . . .  . .     .    ..   .   .      .  .   .. .     .   .. .     .   ...    .  .
. ..  .  .   .   .  . ..     . ..      . .   .  .  .  . .   .    .           .     .    ...    .  .
.    .     .     ..  .    . . .   .     . .     . .     ...    ...  ..  ..   . .  . .       ...  ..
.            .  .  ...                   .      .    .        . .   .   .   ..                  . .
.   ..     .     .     .    ..       . ..   .  .  .. ..     .    ..  . ..     . ...  .    ..   ....
....       .        ..       .   .. . ..      .           .     .. .. ...    .  . .   .      . .  .
. . .. .      . .   .      .   . ..   . .    . .    .         . . . . . . ....    . ..  .   .     .
.  .  . . ..      ..   .       .  .  . .    .      .    . .      .    .  .  ..   .     ... .  . . .
.      . . .  . . .   .   .  .              .. .  .. .    .  ..    ...  .  .          .          ..
.      .  .    .    ...  .....                        .   . .. .    .. .    .  . .  . . .    .  ...
. .. ....     . ..   . . .  .   .       .. ... .     . .     .      .       ..           .     .  .
.        . .         .  .            .       .. ..   ..  ..   .          .  ..    . .   .....     .
..       ...       .   .        . . . .   ...   ... .    .   .  .. . .    .           .      .    .
.   .      .  . .     . ..    .  . .   ..  .....                 . . .         . .  . .      . . ..
.  .    . .   .       .   . ... .          ..   .      ...  .  .  . . .       . .   . .      .  ...
.. .  . .  ...  .  .. ..   .      .                .   .        ... . .   .. ... .         ..   . .
.     . . .      .     ..          ..  .  .. . .    . .. ..     .  . .  .. . .        ..       . ..
.. .  r. ....  .  .  . . .  . .   .      ..   ..         .  .  .  .  ..  ..     ...          ..   .
.    .   .. .  .    .    .     .   .  .  . .       .   .  .    . .      .        ..  .    ..  ..  .
.   .   ..    .. .    .  .        . .   .         . .     .  ..   .   .   . . ... .      .        .
... .   ....   .     ...  .  .    .            .     ..         .   .. .       ..... . . . .  ..  .
. . .    . .  .        .   . .   .. .        .         .  .   .         . .. .     .....     .  . .
..  .  . .      ..     . .    ..          .  .             .      .   .   . .   .  .        .     .
.  .  .    .  ..    . ..   .   .   .             .. ..    . .   ..      ..      . .     ..   ...  .
..   .. ...  . .    .  . .   .. ..     .         ..      .   ..   ..      . .      .  . .    . ....
. . .       .   . .   ..    ...        . .        ..   ..  . . .      ..      .     . . . .   . . .
.              .    .      .    . .           .    .   .      .. ..        .    ..          .  .. .
.     ..             ...    ..  .  .   .     ..   ... ..       .     ..            . . . .     . ..
.   . .    .   .    .           .    ..   . ..    .    . ..   .. . .  .. .    .  .  .  ..    .. ...
.   ...    .    .   .       .  .. .  .      .  ...    .         .  .  ..     ..        . .   .   ..
. .. .  .         . .. .  .       .      .  .  .  . ..  . ..  . ..  . . .        .    .  .        .
..       ..  . .    .    ..    .  .         .        ... .    .   .        .  . .     ..    . . . .
.        .          ...   .   .       ..  ...     .   . ..        .    ..   ..  . ..    .  ... . ..
. . .  .  . .. .  .          .   .    .   .   .  .       . ...   .       .  . ..  .  .    .    .  .
.   .     .    .. .  .   ...  . . . ..    ...                  ....     ..  ..       ..   .  .    .
.  ..    ..  . ..  . . ..  .. ... .          .  . . ..  .. .    .  . .     .       .. . ..  ...  ..
. . .      .   ..    .   .  . . . .   .  .  ... .    .   .     . . .  .. ....   .. .. . ..    . . .
.   .    ..  ... ..      .. ...  .   ..    .. .... .. . . ..  ...     ..    ..  .   .. .      .....
..     .      .     .  .         . . ..     .. .   .    .     ..   ..  .  .   . .... .  ..      ...
.. ..    .    . ...   .          .     .  .  .   .. X .   . .. .     .  . ..   .  . .     ..  .   .
..   . ..      .   .. .....       .    .       .   .  . .  .        .   .. .  . ..  .    .  . .   .
..  .. ... . .    .  ..   .    . .     . . . .  .     .  .. .  .    . ....   .  .. .   .   . .  . .
...   .     .          ..                 .   .      .   ..   .. ..  .. .  .  . ..  ..   .   .    .
.             .   .  . .. ..    .  .  .   .......      .. .    .    . .     .         .   ..    ...
..     .       .. ..   . .    .      ... ..   .  ..  . .  .           .  .               . ..   ...
. .    .... .     . . ..    .. .. .  .   .  . . ...      .. .      .   . .       .. . .    .    . .
.   . .     ..  ..   . ..  ... .  ..... . . .  ...    . .   ..     ..                 .     .     .
. ..   .  . ... ..     . ..         .   .     . . ..  . .      . ... .      .    .        ... ..  .
.    .  .                     .  .   .  ..  . .. .  .     .  . .        .  .  .. .  ..      . .   .
. ....    . .    .    .. . .      . .    .   .    . .      ..         . ..   .      .   ..    ..  .
.  ..        . . .  .   .      .        .. ... .. .  .       .. .  ..       .  . .           .    .
..   . .   .  . .   .      . . . .  .  ...     .    .              .  .    .  . ..  .. .. .       .
. ..    .   ...  .    .  .           .     .   . ..   .     ..     .         . ..    .    ..    . .
. ..      . .                ...         .  .    .      .   .. ..  ..    ..  ....  ..  .  .   . . .
.    .... .    ...  .. .    . .  .    .  .. .       .    .. .   ..  ..     .     .  .  .. ..      .
.     .. ..    ..      .     ..    .    .    .        .                . ..    .         . ....   .
.. .. . ..     .             . .        .  . .    .          .      ...   .      .  ...   ..   .. .
.  .  .....   ...  .      . . .  .    . ...    .    .     ..         ..    ..  .  .. .          . .
.  .           ... .    . ..      ... . .    .. .   .... .  . .   .. . .     .     . ..           .
.  .  .   ... .  ..    .    .  ...    .        .   . . .      .   ..  .     .. .. .   ...       ...
... ......... . .  . . . .   .   .... ..  .     .  . .      . ..         .      .  ...     .      .
.. . ..           .    . . ..      .       .. .  ...    .        .       .. .   .   .   .         .
..  ...    . . .    .   ..   .      ..    ... . . . .   .   .    ..    .    ..     ..     ...     .
.     .  . . .        .    .  . .   ..  .     .    .        . . .  .    .  .. .   .     .   .  .  .
...  . .        . . .  . .     ..   .  . ....   .  .   . .     .  . .    .    ..   ...    . .    ..
.   .   ...               .   ..    ..   .    . .     .    .  . .   ..     .    .   ...   ..     ..
..   . .    .   . .       .          .   .     .  .. ..    . .      .   . .  ..   .. .        .   .
.     .    . ..   ...        .. .....    ..       .   .  . .  .  .   .  ...  . .    .        ..   .
.    .  .     .    .. . .  .    .   .. .    .     ...  .   ..  ..  .  .     .  .   .    . .  .. ...
. . .. ....   .....     ..   .     .     .  . ...     ..       .  ..        . ..   ..  .. .. . . ..
..    ....  .    .  ......  ..    ..     .      .        . .. . .   .   .   .. ..   .   ...   . ...
.     .   ..     .   ..    .      ...  .     .    ...   ..   .  .  .            .     . .. .      .
.  .     .   .  ...  . . .  .       .   .     .  .  .   .    .        . ...      ..  .   ... . .  .
... . .  .   ..        .      ..     .     ..   . ..      .. .       .       .  .       . . ....  .
.  .   ..  ..  .      . . .    .    .  .   . ..  .....  ...   .  . .   .. .     .    .  .    .    .
.....    . .      .    . .    .  . .. ..   .... . ..  .. ...        ..   ..  . . .      ... ..   ..
.   .      ...    . . .    ...      .    ..    . ..      . .....  . ..     .     . . .. .  .. . . .
. . ..    .           .  .    . .    . .   .. ..  .. . .  . .  .   .   .  .     . .   .. .   .. . .
..          .         .     .      . . .   . .  ..        ....       ..       ..  . .....    .... .
.    .             . .. .      .     .       .   . .        ..                .         .  .  . . .
...................................................................................................
