.........
.X  . ...
..   .  .
.      r.
.  .    .
. . .  ..
.    .  .
....    .
.........
